home_team,away_team,home_score,away_score,tournament,difference
England,Scotland,4,2,Friendly,2
Scotland,England,3,0,Friendly,3
Scotland,Wales,4,0,Friendly,4
England,Scotland,1,3,Friendly,2
Wales,Scotland,0,2,Friendly,2
Scotland,England,7,2,Friendly,5
Scotland,Wales,9,0,Friendly,9
Wales,Scotland,0,3,Friendly,3
Scotland,Wales,5,1,Friendly,4
England,Scotland,1,6,Friendly,5
Wales,Scotland,1,5,Friendly,4
Northern Ireland,England,0,13,Friendly,13
Wales,Northern Ireland,7,1,Friendly,6
Scotland,England,5,1,Friendly,4
Wales,England,5,3,Friendly,2
Scotland,Wales,5,0,Friendly,5
England,Wales,5,0,Friendly,5
England,Northern Ireland,7,0,Friendly,7
Wales,Scotland,0,3,Friendly,3
Northern Ireland,Scotland,0,5,British Home Championship,5
Wales,Northern Ireland,6,0,British Home Championship,6
Northern Ireland,England,1,8,British Home Championship,7
Wales,England,0,4,British Home Championship,4
Scotland,Wales,4,1,British Home Championship,3
England,Northern Ireland,4,0,British Home Championship,4
Scotland,Northern Ireland,8,2,British Home Championship,6
Wales,Scotland,1,8,British Home Championship,7
Northern Ireland,Wales,2,8,British Home Championship,6
Wales,Northern Ireland,5,0,British Home Championship,5
Northern Ireland,England,1,6,British Home Championship,5
Northern Ireland,Scotland,2,7,British Home Championship,5
Wales,England,1,3,British Home Championship,2
Scotland,Wales,4,1,British Home Championship,3
England,Northern Ireland,7,0,British Home Championship,7
Scotland,Northern Ireland,4,1,British Home Championship,3
England,Wales,4,0,British Home Championship,4
Northern Ireland,Wales,4,1,British Home Championship,3
Wales,Scotland,0,2,British Home Championship,2
England,Wales,5,1,British Home Championship,4
Wales,Northern Ireland,11,0,British Home Championship,11
Scotland,Wales,5,1,British Home Championship,4
Scotland,England,0,5,British Home Championship,5
Northern Ireland,Scotland,2,10,British Home Championship,8
Northern Ireland,England,1,5,British Home Championship,4
Scotland,Canada,4,0,Friendly,4
England,Wales,4,1,British Home Championship,3
England,Northern Ireland,6,1,British Home Championship,5
Scotland,Northern Ireland,7,0,British Home Championship,7
Northern Ireland,Wales,1,3,British Home Championship,2
Wales,Northern Ireland,5,2,British Home Championship,3
Northern Ireland,England,1,9,British Home Championship,8
Wales,England,1,3,British Home Championship,2
Scotland,Wales,5,0,British Home Championship,5
Northern Ireland,Scotland,1,4,British Home Championship,3
Northern Ireland,Wales,7,2,British Home Championship,5
England,Wales,4,1,British Home Championship,3
England,Northern Ireland,6,1,British Home Championship,5
Northern Ireland,England,0,2,British Home Championship,2
Wales,England,0,2,British Home Championship,2
Scotland,Wales,6,1,British Home Championship,5
Scotland,England,1,4,British Home Championship,3
England,Northern Ireland,6,1,British Home Championship,5
England,Wales,6,0,British Home Championship,6
Wales,Scotland,0,8,British Home Championship,8
Scotland,Northern Ireland,6,1,British Home Championship,5
England,Scotland,5,2,British Home Championship,3
Wales,Northern Ireland,4,1,British Home Championship,3
Wales,England,1,5,British Home Championship,4
Scotland,Wales,5,2,British Home Championship,3
England,Northern Ireland,9,0,British Home Championship,9
Scotland,Northern Ireland,3,1,British Home Championship,2
England,Scotland,3,0,British Home Championship,3
Wales,Northern Ireland,6,1,British Home Championship,5
Northern Ireland,England,0,2,British Home Championship,2
Wales,England,1,9,British Home Championship,8
Scotland,Wales,4,0,British Home Championship,4
England,Northern Ireland,6,0,British Home Championship,6
Scotland,Northern Ireland,5,1,British Home Championship,4
England,Wales,4,0,British Home Championship,4
Scotland,Wales,5,2,British Home Championship,3
Northern Ireland,Scotland,0,3,British Home Championship,3
Wales,England,0,3,British Home Championship,3
Scotland,England,1,3,British Home Championship,2
England,Northern Ireland,13,2,British Home Championship,11
Wales,Scotland,0,6,British Home Championship,6
England,Wales,4,0,British Home Championship,4
Scotland,Northern Ireland,9,1,British Home Championship,8
Scotland,Wales,5,2,British Home Championship,3
Wales,Northern Ireland,2,0,British Home Championship,2
Northern Ireland,Scotland,0,3,British Home Championship,3
Northern Ireland,England,0,2,British Home Championship,2
Scotland,England,4,1,British Home Championship,3
Scotland,Northern Ireland,11,0,British Home Championship,11
England,Northern Ireland,3,0,British Home Championship,3
England,Wales,6,0,British Home Championship,6
Wales,Northern Ireland,0,3,British Home Championship,3
Northern Ireland,Scotland,1,5,British Home Championship,4
Scotland,Wales,5,1,British Home Championship,4
Uruguay,Argentina,0,6,Friendly,6
Austria,Hungary,5,0,Friendly,5
England,Northern Ireland,4,0,British Home Championship,4
Scotland,Northern Ireland,0,2,British Home Championship,2
Northern Ireland,Wales,2,0,British Home Championship,2
Austria,Hungary,4,2,Friendly,2
Northern Ireland,England,1,3,British Home Championship,2
Hungary,Austria,3,0,Friendly,3
Wales,Scotland,3,1,British Home Championship,2
Scotland,Northern Ireland,4,0,British Home Championship,4
England,Wales,3,1,British Home Championship,2
Belgium,Netherlands,1,4,Friendly,3
Belgium,France,7,0,Friendly,7
Netherlands,Belgium,4,0,Friendly,4
Northern Ireland,England,0,5,British Home Championship,5
Scotland,Wales,0,2,British Home Championship,2
France,Belgium,0,5,Friendly,5
Belgium,Netherlands,5,0,Friendly,5
Uruguay,Argentina,0,2,Copa Lipton,2
Hungary,Austria,3,1,Friendly,2
Scotland,Northern Ireland,3,0,British Home Championship,3
Hungary,Czechoslovakia,5,2,Friendly,3
Belgium,Netherlands,1,3,Friendly,2
Austria,Hungary,3,1,Friendly,2
Czechoslovakia,Hungary,5,3,Friendly,2
Hungary,Austria,4,1,Friendly,3
Northern Ireland,England,1,3,British Home Championship,2
Northern Ireland,Scotland,0,5,British Home Championship,5
Wales,England,1,7,British Home Championship,6
Belgium,Netherlands,1,4,Friendly,3
Hungary,Czechoslovakia,5,2,Friendly,3
Switzerland,Germany,5,3,Friendly,2
Netherlands,Belgium,3,1,Friendly,2
Austria,Hungary,4,0,Friendly,4
Netherlands,France,4,1,Friendly,3
Austria,England,1,6,Friendly,5
Austria,England,1,11,Friendly,10
Hungary,England,0,7,Friendly,7
Czechoslovakia,England,0,4,Friendly,4
Sweden,Norway,11,3,Friendly,8
Netherlands,Sweden,5,3,Friendly,2
Hungary,Austria,5,3,Friendly,2
England,Northern Ireland,4,0,British Home Championship,4
England,Wales,2,0,British Home Championship,2
Scotland,Northern Ireland,5,0,British Home Championship,5
Belgium,Netherlands,1,4,Friendly,3
England,Scotland,2,0,British Home Championship,2
Netherlands,Belgium,4,1,Friendly,3
Belgium,France,5,2,Friendly,3
Hungary,England,2,4,Friendly,2
Hungary,England,2,8,Friendly,6
Austria,England,1,8,Friendly,7
Argentina,Uruguay,3,1,Copa Premio Honor Argentino,2
Scotland,England,2,0,British Home Championship,2
France,Belgium,0,4,Friendly,4
Netherlands,Belgium,7,0,Friendly,7
Wales,Northern Ireland,4,1,British Home Championship,3
Netherlands,Germany,4,2,Friendly,2
Italy,France,6,2,Friendly,4
Germany,Belgium,0,3,Friendly,3
Hungary,Italy,6,1,Friendly,5
Argentina,Chile,3,1,Friendly,2
Chile,Uruguay,0,3,Friendly,3
Argentina,Chile,5,1,Friendly,4
Argentina,Uruguay,4,1,Friendly,3
Uruguay,Argentina,3,1,Copa Lipton,2
Chile,Argentina,0,3,Friendly,3
Norway,Sweden,0,4,Friendly,4
Hungary,Austria,3,0,Friendly,3
Argentina,Uruguay,2,6,Copa Premio Honor Argentino,4
France,Hungary,0,3,Friendly,3
Switzerland,Hungary,2,0,Friendly,2
England,Wales,3,0,British Home Championship,3
Scotland,Northern Ireland,2,0,British Home Championship,2
Belgium,Netherlands,1,5,Friendly,4
Germany,Switzerland,6,2,Friendly,4
Netherlands,Belgium,3,1,Friendly,2
Switzerland,France,5,2,Friendly,3
Belgium,France,7,1,Friendly,6
Austria,Hungary,3,1,Friendly,2
Switzerland,Italy,3,0,Friendly,3
Sweden,Germany,2,4,Friendly,2
Argentina,Uruguay,0,2,Copa Lipton,2
Sweden,Norway,4,1,Friendly,3
Argentina,Uruguay,2,0,Copa Premio Honor Argentino,2
Finland,Sweden,2,5,Friendly,3
Germany,Sweden,1,3,Friendly,2
Hungary,Switzerland,9,0,Friendly,9
Luxembourg,France,1,4,Friendly,3
Uruguay,Argentina,3,0,Copa Premio Honor Uruguayo,3
Hungary,Austria,2,0,Friendly,2
Germany,Hungary,1,4,Friendly,3
Northern Ireland,England,1,6,British Home Championship,5
France,Catalonia,7,0,Friendly,7
France,Switzerland,4,1,Friendly,3
Belgium,Switzerland,9,2,Friendly,7
Wales,England,0,2,British Home Championship,2
Northern Ireland,Scotland,1,4,British Home Championship,3
Norway,Hungary,0,6,Friendly,6
Sweden,Finland,7,1,Friendly,6
Austria,Italy,5,1,Friendly,4
Hungary,Austria,3,0,Friendly,3
Netherlands,Austria,3,1,Friendly,2
Russia,Hungary,0,9,Friendly,9
Russia,Hungary,0,12,Friendly,12
Uruguay,Argentina,2,0,Copa Lipton,2
Uruguay,Argentina,3,0,Copa Premio Honor Uruguayo,3
Denmark,Germany,3,1,Friendly,2
Hungary,Austria,4,0,Friendly,4
Sweden,Norway,4,2,Friendly,2
Uruguay,Argentina,1,3,Friendly,2
Italy,Austria,1,3,Friendly,2
Belgium,France,3,0,Friendly,3
Switzerland,France,1,4,Friendly,3
France,Luxembourg,8,0,Friendly,8
Netherlands,Belgium,2,4,Friendly,2
Austria,Hungary,1,4,Friendly,3
Russia,Sweden,1,4,Friendly,3
Hungary,Sweden,2,0,Friendly,2
Denmark,Sweden,8,0,Friendly,8
Sweden,Norway,9,0,Friendly,9
Austria,Italy,2,0,Friendly,2
Argentina,Uruguay,4,0,Copa Lipton,4
Argentina,Uruguay,2,0,Copa Premio Honor Argentino,2
Chile,Argentina,0,2,Friendly,2
Sweden,Denmark,0,10,Friendly,10
Germany,Denmark,1,4,Friendly,3
Belgium,Switzerland,2,0,Friendly,2
Belgium,Germany,6,2,Friendly,4
England,Northern Ireland,0,3,British Home Championship,3
Belgium,Netherlands,2,4,Friendly,2
Wales,England,0,2,British Home Championship,2
Italy,France,2,0,Friendly,2
Scotland,England,3,1,British Home Championship,2
Netherlands,Belgium,4,2,Friendly,2
Austria,Hungary,2,0,Friendly,2
Hungary,France,5,1,Friendly,4
Argentina,Brazil,3,0,Friendly,3
Sweden,Norway,7,0,Friendly,7
Basque Country,Catalonia,6,1,Friendly,5
Italy,Switzerland,3,1,Friendly,2
Hungary,Austria,2,5,Friendly,3
Denmark,Sweden,2,0,Friendly,2
Uruguay,Argentina,2,0,Copa Newton,2
Denmark,Norway,8,1,Friendly,7
Austria,Hungary,4,2,Friendly,2
Sweden,Norway,5,2,Friendly,3
Sweden,Denmark,0,2,Friendly,2
Hungary,Austria,6,2,Friendly,4
Austria,Hungary,3,1,Friendly,2
Catalonia,Basque Country,1,3,Friendly,2
Denmark,Sweden,2,0,Friendly,2
Basque Country,Catalonia,5,0,Friendly,5
Norway,Denmark,0,2,Friendly,2
Chile,Uruguay,0,4,Copa América,4
Sweden,Norway,6,0,Friendly,6
Argentina,Chile,6,1,Copa América,5
Uruguay,Chile,4,1,Friendly,3
Argentina,Uruguay,3,1,Copa Newton,2
Argentina,Uruguay,7,2,Friendly,5
Sweden,Denmark,4,0,Friendly,4
Denmark,Norway,8,0,Friendly,8
Uruguay,Argentina,3,1,Friendly,2
Japan,Philippines,2,15,Friendly,13
Hungary,Austria,6,2,Friendly,4
Austria,Hungary,1,4,Friendly,3
Uruguay,Argentina,0,2,Copa Premio Honor Uruguayo,2
Norway,Sweden,0,2,Friendly,2
Uruguay,Chile,4,0,Copa América,4
Argentina,Brazil,4,2,Copa América,2
Denmark,Norway,12,0,Friendly,12
Uruguay,Brazil,4,0,Copa América,4
Brazil,Chile,5,0,Copa América,5
Uruguay,Brazil,3,1,Friendly,2
Hungary,Austria,2,0,Friendly,2
Austria,Switzerland,5,1,Friendly,4
Sweden,Norway,2,0,Friendly,2
Austria,Hungary,0,2,Friendly,2
Denmark,Sweden,3,0,Friendly,3
Norway,Denmark,3,1,Friendly,2
Uruguay,Argentina,3,1,Copa Premio Honor Uruguayo,2
Argentina,Uruguay,2,0,Copa Newton,2
Austria,Hungary,0,3,Friendly,3
Denmark,Norway,4,0,Friendly,4
Brazil,Chile,6,0,Copa América,6
Paraguay,Argentina,1,5,Friendly,4
Paraguay,Argentina,0,3,Friendly,3
Chile,Uruguay,0,2,Copa América,2
Brazil,Argentina,3,1,Copa América,2
Argentina,Chile,4,1,Copa América,3
Denmark,Sweden,3,0,Friendly,3
Netherlands,Sweden,3,1,Friendly,2
Denmark,Norway,5,1,Friendly,4
Uruguay,Argentina,4,1,Copa Premio Honor Uruguayo,3
Sweden,Netherlands,4,1,Friendly,3
Sweden,Norway,1,5,Friendly,4
Austria,Hungary,2,0,Friendly,2
Sweden,Denmark,3,0,Friendly,3
Argentina,Uruguay,6,1,Copa Premio Honor Argentino,5
Uruguay,Argentina,4,2,Friendly,2
Italy,France,9,4,Friendly,5
Switzerland,France,0,2,Friendly,2
Scotland,Northern Ireland,3,0,British Home Championship,3
Switzerland,Italy,3,0,Friendly,3
Netherlands,Denmark,2,0,Friendly,2
Sweden,Finland,4,0,Friendly,4
Norway,Sweden,0,3,Friendly,3
Switzerland,Germany,4,1,Friendly,3
Uruguay,Argentina,2,0,Copa Premio Honor Uruguayo,2
Argentina,Uruguay,1,3,Copa Newton,2
Brazil,Uruguay,0,6,Copa América,6
Argentina,Brazil,2,0,Copa América,2
Sweden,Denmark,0,2,Friendly,2
Finland,Estonia,6,0,Friendly,6
England,Northern Ireland,2,0,British Home Championship,2
Northern Ireland,Scotland,0,2,British Home Championship,2
Belgium,France,3,1,Friendly,2
Catalonia,Provence,4,0,Friendly,4
Paraguay,Argentina,3,1,Friendly,2
Scotland,England,3,0,British Home Championship,3
Austria,Hungary,4,1,Friendly,3
Belgium,England,0,2,Friendly,2
Sweden,Finland,0,3,Friendly,3
Japan,Philippines,0,3,Friendly,3
Hungary,Germany,3,0,Friendly,3
Norway,Sweden,3,1,Friendly,2
Sweden,Austria,1,3,Friendly,2
Estonia,Finland,0,3,Friendly,3
Costa Rica,El Salvador,7,0,Friendly,7
Guatemala,Costa Rica,0,6,Friendly,6
Sweden,Norway,0,3,Friendly,3
Denmark,Norway,3,1,Friendly,2
Brazil,Paraguay,3,0,Copa América,3
Argentina,Paraguay,3,0,Copa América,3
Czechoslovakia,Yugoslavia,6,1,Friendly,5
Uruguay,Paraguay,4,2,Friendly,2
Hungary,Sweden,4,2,Friendly,2
France,Netherlands,0,5,Friendly,5
Spain,Portugal,3,1,Friendly,2
Belgium,Netherlands,4,0,Friendly,4
Netherlands,Denmark,2,0,Friendly,2
Austria,Germany,0,2,Friendly,2
France,Spain,0,4,Friendly,4
Poland,Hungary,0,3,Friendly,3
Italy,Belgium,4,2,Friendly,2
Finland,Sweden,1,4,Friendly,3
Austria,Switzerland,7,1,Friendly,6
Denmark,Czechoslovakia,0,3,Friendly,3
Norway,France,7,0,Friendly,7
New Zealand,Australia,3,1,Friendly,2
New Zealand,Australia,3,1,Friendly,2
Finland,Hungary,1,5,Friendly,4
Finland,Estonia,10,2,Friendly,8
Sweden,Czechoslovakia,0,2,Friendly,2
Finland,Norway,1,3,Friendly,2
Chile,Uruguay,0,2,Copa América,2
Norway,Sweden,0,5,Friendly,5
Argentina,Chile,4,0,Copa América,4
Yugoslavia,Poland,1,3,Friendly,2
Chile,Paraguay,0,3,Copa América,3
Brazil,Argentina,2,0,Copa América,2
Argentina,Paraguay,2,0,Copa América,2
England,Northern Ireland,2,0,British Home Championship,2
Brazil,Paraguay,3,0,Copa América,3
Brazil,Paraguay,3,1,Friendly,2
Switzerland,Netherlands,5,0,Friendly,5
Galicia,Central Spain,4,1,Friendly,3
Italy,Germany,3,1,Friendly,2
Guatemala,Mexico,3,1,Friendly,2
Guatemala,Mexico,1,4,Friendly,3
Andalusia,Galicia,1,4,Friendly,3
Switzerland,Austria,2,0,Friendly,2
Spain,France,3,0,Friendly,3
Luxembourg,Brittany,1,4,Friendly,3
Belgium,France,4,1,Friendly,3
Galicia,Asturias,1,3,Friendly,2
Switzerland,Hungary,1,6,Friendly,5
Scotland,Wales,2,0,British Home Championship,2
England,Belgium,6,1,Friendly,5
Netherlands,France,8,1,Friendly,7
Wales,Northern Ireland,0,3,British Home Championship,3
Czechoslovakia,Denmark,2,0,Friendly,2
France,England,1,4,Friendly,3
Argentina,Paraguay,0,2,Copa Chevallier Boutell,2
Sweden,England,2,4,Friendly,2
China PR,Philippines,3,0,Friendly,3
Japan,China PR,1,5,Friendly,4
Sweden,England,1,3,Friendly,2
Czechoslovakia,Italy,5,1,Friendly,4
Sweden,Austria,4,2,Friendly,2
Norway,Finland,3,0,Friendly,3
Lithuania,Estonia,0,5,Friendly,5
Australia,New Zealand,1,4,Friendly,3
Romania,Czechoslovakia,0,6,Friendly,6
Hungary,Finland,3,1,Friendly,2
Estonia,Russia,2,4,Friendly,2
Finland,Poland,5,3,Friendly,2
Hungary,Austria,2,0,Friendly,2
Estonia,Poland,1,4,Friendly,3
Uruguay,Argentina,0,2,Copa Premio Honor Uruguayo,2
Sweden,Denmark,1,3,Friendly,2
France,Norway,0,2,Friendly,2
Brittany,Norway,1,5,Friendly,4
Uruguay,Paraguay,2,0,Copa América,2
Brazil,Paraguay,2,0,Friendly,2
Netherlands,Switzerland,4,1,Friendly,3
Argentina,Brazil,0,2,Friendly,2
Uruguay,Argentina,2,0,Copa América,2
Argentina,Brazil,2,0,Copa Roca,2
Mexico,Guatemala,2,0,Friendly,2
Spain,Portugal,3,0,Friendly,3
France,Belgium,2,0,Friendly,2
Italy,Austria,0,4,Friendly,4
Yugoslavia,Austria,1,4,Friendly,3
Wales,Scotland,2,0,British Home Championship,2
Scotland,Northern Ireland,2,0,British Home Championship,2
Catalonia,Spain,0,7,Friendly,7
Switzerland,France,3,0,Friendly,3
Aruba,Curaçao,0,4,Friendly,4
Hungary,Italy,7,1,Friendly,6
Switzerland,Denmark,2,0,Friendly,2
Paraguay,Argentina,1,3,Copa Chevallier Boutell,2
France,England,1,3,Friendly,2
Sweden,Poland,5,1,Friendly,4
Switzerland,Hungary,4,2,Friendly,2
Austria,Romania,4,1,Friendly,3
Austria,Bulgaria,6,0,Friendly,6
Argentina,Uruguay,4,0,Copa Newton,4
Uruguay,Argentina,2,0,Copa Lipton,2
Egypt,Lithuania,10,0,Friendly,10
Norway,Germany,0,2,Friendly,2
Finland,Turkey,2,4,Friendly,2
Estonia,Turkey,1,4,Friendly,3
Austria,Egypt,3,1,Friendly,2
Latvia,Turkey,1,3,Friendly,2
Australia,Canada,4,1,Friendly,3
Poland,Turkey,2,0,Friendly,2
Sweden,Egypt,5,0,Friendly,5
Australia,Canada,1,4,Friendly,3
Sweden,Estonia,5,2,Friendly,3
Finland,Sweden,5,7,Friendly,2
Latvia,Finland,0,2,Friendly,2
Finland,Norway,2,0,Friendly,2
Czechoslovakia,Romania,4,1,Friendly,3
Germany,Sweden,1,4,Friendly,3
Hungary,Poland,4,0,Friendly,4
Finland,Estonia,4,0,Friendly,4
Norway,Denmark,1,3,Nordic Championship,2
Hungary,Germany,4,1,Friendly,3
Sweden,Norway,6,1,Nordic Championship,5
Yugoslavia,Czechoslovakia,0,2,Friendly,2
Latvia,Estonia,2,0,Friendly,2
Uruguay,Chile,5,0,Copa América,5
England,Northern Ireland,3,1,British Home Championship,2
Argentina,Chile,2,0,Copa América,2
Uruguay,Paraguay,3,1,Copa América,2
Chile,Paraguay,1,3,Copa América,2
Belgium,France,3,0,Friendly,3
Russia,Turkey,3,0,Friendly,3
England,Belgium,4,0,Friendly,4
Scotland,Wales,3,1,British Home Championship,2
Northern Ireland,Scotland,0,3,British Home Championship,3
Austria,Switzerland,2,0,Friendly,2
Italy,France,7,0,Friendly,7
Hungary,Switzerland,5,0,Friendly,5
Haiti,Jamaica,0,3,Friendly,3
Scotland,England,2,0,British Home Championship,2
France,Austria,0,4,Friendly,4
Switzerland,Netherlands,4,1,Friendly,3
Netherlands,Belgium,5,0,Friendly,5
Austria,Hungary,3,1,Friendly,2
China PR,Japan,2,0,Friendly,2
Hungary,Belgium,1,3,Friendly,2
Philippines,China PR,1,5,Friendly,4
Czechoslovakia,Austria,3,1,Friendly,2
Bulgaria,Romania,2,4,Friendly,2
Switzerland,Spain,0,3,Friendly,3
Sweden,Finland,4,0,Friendly,4
Sweden,Denmark,0,2,Nordic Championship,2
Denmark,Norway,5,1,Nordic Championship,4
Finland,Germany,3,5,Friendly,2
Estonia,Finland,2,0,Friendly,2
Sweden,Austria,2,4,Friendly,2
Sweden,Hungary,6,2,Friendly,4
Poland,Hungary,0,2,Friendly,2
Finland,Latvia,3,1,Friendly,2
Norway,Sweden,3,7,Nordic Championship,4
Czechoslovakia,Hungary,2,0,Friendly,2
Netherlands,Denmark,4,2,Friendly,2
Switzerland,Germany,0,4,Friendly,4
Czechoslovakia,Yugoslavia,7,0,Friendly,7
Wales,Scotland,0,3,British Home Championship,3
Poland,Sweden,2,6,Friendly,4
Switzerland,Austria,2,0,Friendly,2
United States,Canada,6,1,Friendly,5
Argentina,Paraguay,2,0,Copa América,2
Brazil,Paraguay,5,2,Copa América,3
Argentina,Brazil,4,1,Copa América,3
Brazil,Paraguay,3,1,Copa América,2
Argentina,Paraguay,3,1,Copa América,2
Italy,Czechoslovakia,3,1,Friendly,2
Northern Ireland,Wales,3,0,British Home Championship,3
Belgium,Hungary,0,2,Friendly,2
Scotland,Northern Ireland,4,0,British Home Championship,4
England,Wales,1,3,British Home Championship,2
Jamaica,Curaçao,2,0,Friendly,2
Austria,Czechoslovakia,2,0,Friendly,2
Italy,Republic of Ireland,3,0,Friendly,3
Netherlands,Switzerland,5,0,Friendly,5
France,Portugal,4,2,Friendly,2
Germany,Netherlands,4,2,Friendly,2
Romania,Bulgaria,6,1,Friendly,5
Hungary,Austria,0,3,Friendly,3
Netherlands,Belgium,1,5,Friendly,4
Turkey,Romania,1,3,Friendly,2
Belgium,England,3,5,Friendly,2
Austria,France,4,1,Friendly,3
Yugoslavia,Bulgaria,3,1,Friendly,2
Finland,Norway,2,5,Friendly,3
Denmark,Netherlands,4,1,Friendly,3
Estonia,Lithuania,3,1,Friendly,2
France,Yugoslavia,4,1,Friendly,3
Yugoslavia,Czechoslovakia,2,6,Friendly,4
Czechoslovakia,Sweden,4,2,Friendly,2
Poland,Estonia,2,0,Friendly,2
Sweden,Italy,5,3,Friendly,2
Latvia,Sweden,4,1,Friendly,3
Estonia,Sweden,1,7,Friendly,6
Poland,Finland,7,1,Friendly,6
Latvia,Finland,1,4,Friendly,3
Hungary,Poland,4,1,Friendly,3
Poland,Turkey,6,1,Friendly,5
Denmark,Sweden,2,0,Nordic Championship,2
Sweden,Poland,3,1,Friendly,2
Austria,Switzerland,7,1,Friendly,6
Chile,Bolivia,7,1,Copa América,6
Argentina,Bolivia,5,0,Copa América,5
Chile,Uruguay,1,3,Copa América,2
Argentina,Paraguay,8,0,Copa América,8
Bolivia,Paraguay,1,6,Copa América,5
Argentina,Uruguay,0,2,Copa América,2
Bolivia,Uruguay,0,6,Copa América,6
Czechoslovakia,Italy,3,1,Friendly,2
Scotland,Wales,3,0,British Home Championship,3
Paraguay,Uruguay,1,6,Copa América,5
Chile,Paraguay,5,1,Copa América,4
United States,Canada,6,2,Friendly,4
Austria,Sweden,3,1,Friendly,2
Hungary,Sweden,3,1,Friendly,2
Jamaica,Haiti,6,0,Friendly,6
Spain,Hungary,4,2,Friendly,2
Switzerland,Italy,1,5,Friendly,4
Northern Ireland,Scotland,0,2,British Home Championship,2
Belgium,Netherlands,2,0,Friendly,2
Portugal,France,4,0,Friendly,4
Austria,Hungary,6,0,Friendly,6
Hungary,Yugoslavia,3,0,Friendly,3
Italy,Portugal,3,1,Friendly,2
Czechoslovakia,Hungary,4,1,Friendly,3
Romania,Yugoslavia,0,3,Friendly,3
Belgium,England,1,9,Friendly,8
Bulgaria,Yugoslavia,0,2,Friendly,2
Luxembourg,England,2,5,Friendly,3
Austria,Belgium,4,1,Friendly,3
France,Spain,1,4,Friendly,3
Czechoslovakia,Belgium,4,0,Friendly,4
France,England,0,6,Friendly,6
Italy,Spain,2,0,Friendly,2
Sweden,Latvia,12,0,Friendly,12
Switzerland,Austria,1,4,Friendly,3
Hungary,France,13,1,Friendly,12
Sweden,Finland,6,2,Friendly,4
Norway,Finland,3,1,Friendly,2
Estonia,Latvia,4,1,Friendly,3
Norway,Sweden,3,5,Nordic Championship,2
Sweden,Estonia,3,1,Friendly,2
New Zealand,Canada,1,4,Friendly,3
Latvia,Lithuania,6,3,Friendly,3
Lithuania,Estonia,0,5,Friendly,5
China PR,Japan,5,1,Friendly,4
China PR,Philippines,3,1,Friendly,2
Sweden,Belgium,7,0,Friendly,7
Finland,Latvia,3,1,Friendly,2
Czechoslovakia,Austria,2,0,Central European International Cup,2
Hungary,Austria,5,3,Central European International Cup,2
Latvia,Estonia,4,1,Friendly,3
Denmark,Germany,3,1,Friendly,2
Turkey,Bulgaria,3,1,Friendly,2
Northern Ireland,England,2,0,British Home Championship,2
Germany,Norway,6,2,Friendly,4
Czechoslovakia,Yugoslavia,5,3,Friendly,2
Argentina,Bolivia,7,1,Copa América,6
Denmark,Norway,3,1,Nordic Championship,2
Peru,Uruguay,0,4,Copa América,4
Bolivia,Uruguay,0,9,Copa América,9
Peru,Argentina,1,5,Copa América,4
Belgium,Republic of Ireland,2,4,Friendly,2
France,Northern Ireland,4,0,Friendly,4
England,Scotland,1,5,British Home Championship,4
Portugal,Italy,4,1,Friendly,3
Romania,Turkey,4,2,Friendly,2
Uganda,Kenya,4,0,Friendly,4
Hungary,Czechoslovakia,2,0,Central European International Cup,2
Netherlands,Denmark,2,0,Friendly,2
Austria,Yugoslavia,3,0,Friendly,3
Yugoslavia,Romania,3,1,Friendly,2
France,Czechoslovakia,0,2,Friendly,2
France,England,1,5,Friendly,4
Belgium,England,1,3,Friendly,2
Finland,Norway,0,6,Friendly,6
Sweden,Norway,6,1,Nordic Championship,5
Latvia,Sweden,0,4,Friendly,4
Latvia,Lithuania,3,0,Baltic Cup,3
Estonia,Lithuania,6,0,Baltic Cup,6
Paraguay,Uruguay,3,1,Friendly,2
Belarus,Switzerland,6,3,Friendly,3
Belarus,Ukraine,2,6,Friendly,4
Czechoslovakia,Hungary,6,1,Friendly,5
Norway,Germany,0,2,Friendly,2
Sweden,Germany,2,0,Friendly,2
Austria,Hungary,5,1,Central European International Cup,4
Denmark,Sweden,3,1,Nordic Championship,2
Scotland,Wales,4,2,British Home Championship,2
Austria,Switzerland,2,0,Central European International Cup,2
Czechoslovakia,Yugoslavia,7,1,Friendly,6
Hungary,Switzerland,3,1,Central European International Cup,2
El Salvador,Honduras,5,0,Friendly,5
Germany,Switzerland,7,1,Friendly,6
Northern Ireland,Scotland,3,7,British Home Championship,4
France,Hungary,3,0,Friendly,3
Italy,Czechoslovakia,4,2,Central European International Cup,2
Spain,Portugal,5,0,Friendly,5
France,Portugal,2,0,Friendly,2
Austria,Italy,3,0,Central European International Cup,3
Spain,France,8,1,Friendly,7
Barbados,Trinidad and Tobago,3,0,Friendly,3
Romania,Bulgaria,3,0,Friendly,3
Barbados,Trinidad and Tobago,2,0,Friendly,2
Republic of Ireland,Belgium,4,0,Friendly,4
El Salvador,Nicaragua,9,0,Friendly,9
Belgium,Netherlands,3,1,Friendly,2
Switzerland,Czechoslovakia,1,4,Central European International Cup,3
France,England,1,4,Friendly,3
Belgium,England,1,5,Friendly,4
Kenya,Uganda,3,5,Friendly,2
France,Yugoslavia,1,3,Friendly,2
Belgium,France,4,1,Friendly,3
Norway,Scotland,3,7,Friendly,4
Netherlands,Scotland,0,2,Friendly,2
Sweden,Netherlands,6,2,Friendly,4
Sweden,Finland,3,1,Nordic Championship,2
Argentina,Uruguay,2,0,Friendly,2
Norway,Finland,4,0,Nordic Championship,4
Denmark,Norway,2,5,Nordic Championship,3
Germany,Sweden,3,0,Friendly,3
Sweden,Estonia,4,1,Friendly,3
Sweden,Latvia,10,0,Friendly,10
Latvia,Lithuania,3,1,Baltic Cup,2
Estonia,Lithuania,5,2,Baltic Cup,3
Finland,Latvia,3,1,Friendly,2
Estonia,Latvia,4,1,Friendly,3
Czechoslovakia,Switzerland,5,0,Central European International Cup,5
Denmark,Finland,8,0,Nordic Championship,8
Northern Ireland,England,0,3,British Home Championship,3
Germany,Finland,4,0,Friendly,4
Wales,Scotland,2,4,British Home Championship,2
Switzerland,Austria,1,3,Central European International Cup,2
Paraguay,Uruguay,3,0,Copa América,3
Argentina,Peru,3,0,Copa América,3
Netherlands,Norway,1,4,Friendly,3
Trinidad and Tobago,Guyana,3,1,Friendly,2
Argentina,Paraguay,4,1,Copa América,3
Peru,Uruguay,1,4,Copa América,3
Paraguay,Peru,5,0,Copa América,5
Argentina,Uruguay,2,0,Copa América,2
England,Wales,6,0,British Home Championship,6
Italy,Portugal,6,1,Friendly,5
Northern Ireland,Wales,7,0,British Home Championship,7
Italy,Switzerland,4,2,Friendly,2
Scotland,Northern Ireland,3,1,British Home Championship,2
Portugal,France,2,0,Friendly,2
Germany,Italy,0,2,Friendly,2
England,Scotland,5,2,British Home Championship,3
France,Belgium,1,6,Friendly,5
Yugoslavia,Bulgaria,6,1,Friendly,5
Uganda,Kenya,5,0,Friendly,5
Switzerland,Germany,0,5,Friendly,5
Belgium,Republic of Ireland,1,3,Friendly,2
Hungary,Italy,0,5,Central European International Cup,5
Belgium,Netherlands,3,1,Friendly,2
France,Scotland,0,2,Friendly,2
Romania,Greece,8,1,Balkan Cup,7
China PR,Philippines,5,0,Friendly,5
Norway,Finland,6,2,Nordic Championship,4
Hungary,Netherlands,6,2,Friendly,4
Czechoslovakia,Spain,2,0,Friendly,2
Finland,Denmark,1,6,Nordic Championship,5
Norway,Switzerland,3,0,Friendly,3
Denmark,Sweden,6,1,Nordic Championship,5
Sweden,Norway,6,3,Nordic Championship,3
Belgium,United States,0,3,FIFA World Cup,3
France,Mexico,4,1,FIFA World Cup,3
Peru,Romania,1,3,FIFA World Cup,2
Chile,Mexico,3,0,FIFA World Cup,3
Bolivia,Yugoslavia,0,4,FIFA World Cup,4
Paraguay,United States,0,3,FIFA World Cup,3
Estonia,Sweden,1,5,Friendly,4
Argentina,Mexico,6,3,FIFA World Cup,3
Bolivia,Brazil,0,4,FIFA World Cup,4
Uruguay,Romania,4,0,FIFA World Cup,4
Argentina,Chile,3,1,FIFA World Cup,2
Latvia,Sweden,0,5,Friendly,5
Argentina,United States,6,1,FIFA World Cup,5
Uruguay,Yugoslavia,6,1,FIFA World Cup,5
Uruguay,Argentina,4,2,FIFA World Cup,2
Argentina,Yugoslavia,3,1,Friendly,2
Latvia,Finland,3,0,Friendly,3
Estonia,Finland,4,0,Friendly,4
Brazil,Yugoslavia,4,1,Friendly,3
Denmark,Germany,6,3,Friendly,3
Lithuania,Estonia,4,0,Friendly,4
Germany,Hungary,5,3,Friendly,2
Sweden,Poland,0,3,Friendly,3
Bulgaria,Romania,5,3,Balkan Cup,2
England,Northern Ireland,5,1,British Home Championship,4
Poland,Latvia,6,0,Friendly,6
Switzerland,Netherlands,6,3,Friendly,3
Austria,Sweden,4,1,Friendly,3
Bulgaria,Yugoslavia,0,3,Balkan Cup,3
Wales,England,0,4,British Home Championship,4
Greece,Bulgaria,6,1,Balkan Cup,5
Italy,France,5,0,Friendly,5
Barbados,Trinidad and Tobago,1,5,Friendly,4
Guyana,Trinidad and Tobago,0,2,Friendly,2
Barbados,Trinidad and Tobago,1,7,Friendly,6
Guyana,Barbados,9,0,Friendly,9
Guyana,Barbados,7,0,Friendly,7
Yugoslavia,Greece,4,1,Balkan Cup,3
Scotland,England,2,0,British Home Championship,2
Hungary,Switzerland,6,2,Central European International Cup,4
Portugal,Italy,0,2,Friendly,2
Belgium,Netherlands,4,2,Friendly,2
Romania,Bulgaria,5,2,Balkan Cup,3
France,England,5,2,Friendly,3
Austria,Scotland,5,0,Friendly,5
Belgium,England,1,4,Friendly,3
Italy,Scotland,3,0,Friendly,3
Germany,Austria,0,6,Friendly,6
Denmark,Norway,3,1,Nordic Championship,2
Estonia,Lithuania,4,1,Friendly,3
Czechoslovakia,Switzerland,7,3,Central European International Cup,4
Denmark,Netherlands,0,2,Friendly,2
Poland,Czechoslovakia,0,4,Friendly,4
Austria,Switzerland,2,0,Friendly,2
Finland,Estonia,3,1,Friendly,2
Sweden,Denmark,3,1,Nordic Championship,2
Yugoslavia,Romania,2,4,Balkan Cup,2
Latvia,Lithuania,5,2,Friendly,3
Sweden,Finland,8,2,Nordic Championship,6
Sweden,Estonia,3,1,Friendly,2
Argentina,Paraguay,3,1,Copa Chevallier Boutell,2
Sweden,Latvia,6,0,Friendly,6
Finland,Latvia,4,0,Friendly,4
Lithuania,Romania,2,4,Friendly,2
Estonia,Lithuania,2,0,Baltic Cup,2
Estonia,Latvia,3,1,Baltic Cup,2
Brazil,Uruguay,2,0,Copa Rio Branco,2
Austria,Germany,5,0,Friendly,5
Scotland,Northern Ireland,3,1,British Home Championship,2
Hungary,Czechoslovakia,3,0,Friendly,3
Bulgaria,Turkey,5,1,Balkan Cup,4
Germany,Denmark,4,2,Friendly,2
Turkey,Yugoslavia,2,0,Balkan Cup,2
Northern Ireland,England,2,6,British Home Championship,4
Poland,Yugoslavia,6,3,Friendly,3
Hungary,Sweden,3,1,Friendly,2
England,Wales,3,1,British Home Championship,2
Greece,Romania,2,4,Balkan Cup,2
Switzerland,Austria,1,8,Central European International Cup,7
Northern Ireland,Wales,4,0,British Home Championship,4
England,Spain,7,1,Friendly,6
Republic of Ireland,Spain,0,5,Friendly,5
Italy,Switzerland,3,0,Central European International Cup,3
Germany,Switzerland,2,0,Friendly,2
Haiti,Jamaica,4,1,Friendly,3
Belgium,Netherlands,1,4,Friendly,3
Czechoslovakia,Hungary,1,3,Friendly,2
England,Scotland,3,0,British Home Championship,3
Switzerland,Czechoslovakia,5,1,Central European International Cup,4
Austria,Hungary,8,2,Friendly,6
Barbados,Trinidad and Tobago,1,3,Friendly,2
Belgium,France,5,2,Friendly,3
France,Scotland,1,3,Friendly,2
Netherlands,Republic of Ireland,0,2,Friendly,2
Argentina,Uruguay,2,0,Friendly,2
Sweden,Finland,7,1,Friendly,6
Yugoslavia,Poland,0,3,Friendly,3
Estonia,Latvia,3,0,Friendly,3
Norway,Estonia,3,0,Friendly,3
Bulgaria,France,3,5,Friendly,2
Finland,Sweden,1,3,Nordic Championship,2
Romania,France,6,3,Friendly,3
Sweden,Belgium,3,1,Friendly,2
Denmark,Sweden,3,1,Nordic Championship,2
Switzerland,Hungary,3,1,Central European International Cup,2
Bulgaria,Romania,2,0,Balkan Cup,2
Yugoslavia,Greece,7,1,Balkan Cup,6
Greece,Romania,0,3,Balkan Cup,3
Finland,Germany,1,4,Friendly,3
Sweden,Norway,1,4,Nordic Championship,3
Bulgaria,Greece,2,0,Balkan Cup,2
Yugoslavia,Romania,3,1,Balkan Cup,2
Poland,Sweden,2,0,Friendly,2
Estonia,Sweden,1,3,Friendly,2
Estonia,Finland,0,3,Friendly,3
Uganda,Kenya,13,1,Friendly,12
Latvia,Lithuania,4,1,Baltic Cup,3
Finland,Denmark,4,2,Nordic Championship,2
Northern Ireland,Scotland,0,4,British Home Championship,4
Sweden,Lithuania,8,1,Friendly,7
Romania,Poland,0,5,Friendly,5
Austria,Switzerland,3,1,Central European International Cup,2
Scotland,Wales,2,5,British Home Championship,3
Italy,Hungary,4,2,Friendly,2
Germany,Netherlands,0,2,Friendly,2
Wales,Northern Ireland,4,1,British Home Championship,3
Belgium,Austria,1,6,Friendly,5
Italy,Germany,3,1,Friendly,2
Netherlands,Switzerland,0,2,Friendly,2
Argentina,Uruguay,4,1,Friendly,3
France,Austria,0,4,Friendly,4
Hungary,Czechoslovakia,2,0,Friendly,2
France,Belgium,3,0,Friendly,3
Spain,Portugal,3,0,Friendly,3
Switzerland,Italy,0,3,Central European International Cup,3
Belgium,Netherlands,1,3,Friendly,2
Italy,Czechoslovakia,2,0,Central European International Cup,2
Switzerland,Yugoslavia,4,1,Friendly,3
Switzerland,England,0,4,Friendly,4
Spain,Bulgaria,13,0,Friendly,13
Latvia,Estonia,2,0,Friendly,2
Greece,Yugoslavia,3,5,Balkan Cup,2
Romania,Bulgaria,7,0,Balkan Cup,7
Australia,New Zealand,4,2,Friendly,2
Bulgaria,Yugoslavia,0,4,Balkan Cup,4
Bulgaria,Greece,2,0,Balkan Cup,2
Czechoslovakia,France,4,0,Friendly,4
Austria,Belgium,4,1,Friendly,3
Romania,Yugoslavia,5,0,Balkan Cup,5
Sweden,Estonia,6,2,FIFA World Cup qualification,4
Latvia,Lithuania,6,2,Friendly,4
Australia,New Zealand,6,4,Friendly,2
Australia,New Zealand,4,2,Friendly,2
Lithuania,Sweden,0,2,FIFA World Cup qualification,2
Sweden,Hungary,5,2,Friendly,3
Sweden,Finland,2,0,Nordic Championship,2
Finland,Lithuania,9,2,Friendly,7
Finland,Norway,1,5,Nordic Championship,4
Lithuania,Estonia,0,5,Friendly,5
Hungary,Switzerland,3,0,Central European International Cup,3
Aruba,Curaçao,1,3,Friendly,2
Denmark,Finland,2,0,Nordic Championship,2
Aruba,Curaçao,0,2,Friendly,2
Northern Ireland,England,0,3,British Home Championship,3
Germany,Belgium,8,1,Friendly,7
Trinidad and Tobago,Barbados,8,4,Friendly,4
Trinidad and Tobago,Guyana,2,0,Friendly,2
Barbados,Guyana,0,2,Friendly,2
Trinidad and Tobago,Barbados,3,1,Friendly,2
Barbados,Guyana,2,5,Friendly,3
Trinidad and Tobago,Barbados,6,0,Friendly,6
Switzerland,Germany,0,2,Friendly,2
Italy,Switzerland,5,2,Central European International Cup,3
England,France,4,1,Friendly,3
Germany,Hungary,3,1,Friendly,2
Haiti,Cuba,1,3,FIFA World Cup qualification,2
Catalonia,Spain,0,2,Friendly,2
Haiti,Cuba,0,6,FIFA World Cup qualification,6
Italy,Austria,2,4,Central European International Cup,2
Luxembourg,Germany,1,9,FIFA World Cup qualification,8
Mexico,Cuba,5,0,FIFA World Cup qualification,5
Netherlands,Belgium,9,3,Friendly,6
Spain,Portugal,9,0,FIFA World Cup qualification,9
Guadeloupe,Martinique,0,6,Friendly,6
Egypt,Israel,7,1,FIFA World Cup qualification,6
Mexico,Cuba,4,1,FIFA World Cup qualification,3
Bulgaria,Hungary,1,4,FIFA World Cup qualification,3
Italy,Greece,4,0,FIFA World Cup qualification,4
Israel,Egypt,1,4,FIFA World Cup qualification,3
Netherlands,Republic of Ireland,5,2,FIFA World Cup qualification,3
England,Scotland,3,0,British Home Championship,3
Austria,Hungary,5,2,Friendly,3
Luxembourg,France,1,6,FIFA World Cup qualification,5
Austria,Bulgaria,6,1,FIFA World Cup qualification,5
Hungary,Bulgaria,4,1,FIFA World Cup qualification,3
Belgium,Netherlands,2,4,FIFA World Cup qualification,2
Philippines,China PR,0,2,Friendly,2
Japan,Indonesia,1,7,Friendly,6
China PR,Indonesia,2,0,Friendly,2
Denmark,Poland,4,2,Friendly,2
Sweden,Poland,4,2,Friendly,2
Mexico,United States,2,4,FIFA World Cup qualification,2
Belgium,Germany,2,5,FIFA World Cup,3
Brazil,Spain,1,3,FIFA World Cup,2
Egypt,Hungary,2,4,FIFA World Cup,2
Italy,United States,7,1,FIFA World Cup,6
Czechoslovakia,Germany,3,1,FIFA World Cup,2
Yugoslavia,Brazil,8,4,Friendly,4
Lithuania,Latvia,2,0,Friendly,2
Denmark,Sweden,3,5,Nordic Championship,2
Curaçao,Suriname,3,1,Friendly,2
Yugoslavia,Poland,4,1,Friendly,3
Czechoslovakia,Yugoslavia,3,1,Friendly,2
Norway,Finland,4,2,Nordic Championship,2
Latvia,Lithuania,1,3,Friendly,2
Poland,Germany,2,5,Friendly,3
Norway,Denmark,3,1,Nordic Championship,2
Sweden,Latvia,3,1,Friendly,2
Wales,England,0,4,British Home Championship,4
Denmark,Germany,2,5,Friendly,3
Hungary,Austria,3,1,Central European International Cup,2
Latvia,Poland,2,6,Friendly,4
Switzerland,Netherlands,2,4,Friendly,2
Austria,Switzerland,3,0,Central European International Cup,3
Italy,Hungary,4,2,Friendly,2
Republic of Ireland,Hungary,2,4,Friendly,2
Romania,Yugoslavia,0,4,Balkan Cup,4
Argentina,Chile,4,1,Copa América,3
Peru,Argentina,1,4,Copa América,3
Spain,France,2,0,Friendly,2
Argentina,Uruguay,0,3,Copa América,3
Germany,Switzerland,4,0,Friendly,4
Uganda,Kenya,5,1,Friendly,4
Czechoslovakia,Switzerland,3,1,Central European International Cup,2
France,Germany,1,3,Friendly,2
Curaçao,Aruba,2,0,Friendly,2
Austria,Italy,0,2,Central European International Cup,2
Curaçao,Aruba,4,0,Friendly,4
Wales,Northern Ireland,3,1,British Home Championship,2
Netherlands,Belgium,4,2,Friendly,2
Scotland,England,2,0,British Home Championship,2
Switzerland,Hungary,6,2,Central European International Cup,4
Belgium,Germany,1,6,Friendly,5
Germany,Republic of Ireland,3,1,Friendly,2
Kenya,Uganda,1,3,Friendly,2
Austria,Poland,5,2,Friendly,3
Belgium,Netherlands,0,2,Friendly,2
Hungary,Austria,6,3,Friendly,3
France,Hungary,2,0,Friendly,2
United States,Scotland,1,5,Friendly,4
Suriname,Curaçao,4,1,Friendly,3
Latvia,Lithuania,6,1,Friendly,5
United States,Scotland,1,4,Friendly,3
Bulgaria,Greece,5,2,Balkan Cup,3
Sweden,Denmark,3,1,Nordic Championship,2
Romania,Yugoslavia,0,2,Balkan Cup,2
Bulgaria,Romania,4,0,Balkan Cup,4
Greece,Yugoslavia,1,6,Balkan Cup,5
Sweden,Germany,3,1,Friendly,2
Latvia,Sweden,0,3,Friendly,3
Suriname,Trinidad and Tobago,0,3,Friendly,3
Argentina,Uruguay,3,0,Friendly,3
Germany,Finland,6,0,Friendly,6
Germany,Romania,4,2,Friendly,2
Sweden,Romania,7,1,Friendly,6
Finland,Norway,1,5,Nordic Championship,4
Germany,Estonia,5,0,Friendly,5
Norway,Sweden,0,2,Nordic Championship,2
Denmark,Finland,5,1,Nordic Championship,4
Germany,Latvia,3,0,Friendly,3
Northern Ireland,England,1,3,British Home Championship,2
Germany,Bulgaria,4,2,Friendly,2
Netherlands,Denmark,3,0,Friendly,3
Romania,Poland,4,1,Friendly,3
Switzerland,Norway,2,0,Friendly,2
France,Sweden,2,0,Friendly,2
Hungary,Switzerland,6,1,Friendly,5
Belgium,Sweden,5,1,Friendly,4
England,Germany,3,0,Friendly,3
Republic of Ireland,Netherlands,3,5,Friendly,2
Curaçao,Trinidad and Tobago,3,1,Friendly,2
French Guiana,Suriname,1,3,Friendly,2
France,Netherlands,1,6,Friendly,5
Curaçao,Trinidad and Tobago,4,2,Friendly,2
France,Czechoslovakia,0,3,Friendly,3
Belgium,Poland,0,2,Friendly,2
Trinidad and Tobago,Curaçao,3,0,Friendly,3
Portugal,Germany,1,3,Friendly,2
France,Belgium,3,0,Friendly,3
Netherlands,Belgium,8,0,Friendly,8
Austria,Hungary,3,5,Friendly,2
Switzerland,Spain,0,2,Friendly,2
Luxembourg,Republic of Ireland,1,5,Friendly,4
Romania,Greece,5,2,Balkan Cup,3
Romania,Bulgaria,4,1,Balkan Cup,3
Lithuania,Latvia,1,5,Friendly,4
Egypt,Greece,3,1,Friendly,2
Sweden,Switzerland,5,2,Friendly,3
Finland,Denmark,1,4,Nordic Championship,3
Lithuania,Estonia,2,0,Friendly,2
New Zealand,Australia,1,7,Friendly,6
Sweden,Norway,2,0,Nordic Championship,2
New Zealand,Australia,0,10,Friendly,10
New Zealand,Australia,1,4,Friendly,3
Norway,Finland,0,2,Nordic Championship,2
Yugoslavia,Poland,9,3,Friendly,6
Germany,Luxembourg,7,2,Friendly,5
Hungary,Austria,5,3,Central European International Cup,2
Scotland,Germany,2,0,Friendly,2
Republic of Ireland,Germany,5,2,Friendly,3
Czechoslovakia,Hungary,5,2,Central European International Cup,3
Italy,Switzerland,4,2,Central European International Cup,2
Northern Ireland,Scotland,1,3,British Home Championship,2
Switzerland,Austria,1,3,Central European International Cup,2
England,Northern Ireland,3,1,British Home Championship,2
England,Hungary,6,2,Friendly,4
Italy,Czechoslovakia,2,0,Friendly,2
Paraguay,Uruguay,4,2,Copa América,2
Brazil,Chile,6,4,Copa América,2
Suriname,Guyana,8,0,Friendly,8
Guyana,Trinidad and Tobago,0,3,Friendly,3
Peru,Uruguay,2,4,Copa América,2
Argentina,Paraguay,6,1,Copa América,5
Chile,Uruguay,3,0,Copa América,3
Brazil,Paraguay,5,0,Copa América,5
Argentina,Brazil,2,0,Copa América,2
Belgium,France,3,1,Friendly,2
Czechoslovakia,Switzerland,5,3,Central European International Cup,2
Wales,Northern Ireland,4,1,British Home Championship,3
Germany,France,4,0,Friendly,4
Switzerland,Hungary,1,5,Central European International Cup,4
Scotland,England,3,1,British Home Championship,2
Italy,Hungary,2,0,Central European International Cup,2
Norway,England,0,6,Friendly,6
Germany,Denmark,8,0,Friendly,8
Sweden,England,0,4,Friendly,4
Uganda,Kenya,9,5,Friendly,4
Finland,England,0,8,Friendly,8
France,Republic of Ireland,0,2,Friendly,2
Norway,Italy,1,3,Friendly,2
Denmark,Norway,5,1,Nordic Championship,4
Sweden,Finland,4,0,FIFA World Cup qualification,4
Sweden,Estonia,7,2,FIFA World Cup qualification,5
Poland,Sweden,3,1,Friendly,2
Latvia,Germany,1,3,Friendly,2
Finland,Germany,0,2,FIFA World Cup qualification,2
Poland,Romania,2,4,Friendly,2
Latvia,Lithuania,4,2,FIFA World Cup qualification,2
Yugoslavia,Turkey,3,1,Friendly,2
Norway,Basque Country,1,3,Friendly,2
Germany,Estonia,4,1,FIFA World Cup qualification,3
Denmark,Basque Country,1,11,Friendly,10
Lithuania,Latvia,1,5,FIFA World Cup qualification,4
Finland,Norway,0,2,Nordic Championship,2
Lithuania,Estonia,0,4,Baltic Cup,4
Estonia,Latvia,0,2,Baltic Cup,2
Mexico,United States,7,2,Friendly,5
Poland,Denmark,3,1,Friendly,2
Hungary,Czechoslovakia,8,3,Central European International Cup,5
Latvia,Estonia,3,1,Friendly,2
Mexico,United States,7,3,Friendly,4
Poland,Yugoslavia,4,0,FIFA World Cup qualification,4
Uruguay,Argentina,0,3,Copa Newton,3
Czechoslovakia,Latvia,4,0,Friendly,4
Northern Ireland,England,1,5,British Home Championship,4
Germany,Norway,3,0,Friendly,3
Argentina,Uruguay,5,1,Copa Lipton,4
Hungary,Switzerland,2,0,Central European International Cup,2
Germany,Sweden,5,0,FIFA World Cup qualification,5
Netherlands,Luxembourg,4,0,FIFA World Cup qualification,4
Mexico,Basque Country,1,4,Friendly,3
Scotland,Czechoslovakia,5,0,Friendly,5
Mexico,Basque Country,0,4,Friendly,4
Dominica,Saint Lucia,4,1,Friendly,3
Portugal,Hungary,4,0,Friendly,4
Mexico,Basque Country,3,1,Friendly,2
Dominica,Saint Lucia,1,3,Friendly,2
Luxembourg,Hungary,0,6,Friendly,6
Israel,Greece,1,3,FIFA World Cup qualification,2
France,Belgium,5,3,Friendly,2
Netherlands,Belgium,7,2,Friendly,5
Haiti,Jamaica,5,2,Friendly,3
Haiti,Jamaica,2,0,Friendly,2
Haiti,Jamaica,2,0,Friendly,2
France,Bulgaria,6,1,Friendly,5
Hungary,Greece,11,1,FIFA World Cup qualification,10
Guyana,Trinidad and Tobago,0,3,Friendly,3
Switzerland,Czechoslovakia,4,0,Central European International Cup,4
Guyana,Trinidad and Tobago,0,2,Friendly,2
Czechoslovakia,Bulgaria,6,0,FIFA World Cup qualification,6
Switzerland,Belgium,0,3,Friendly,3
Germany,England,3,6,Friendly,3
Italy,Belgium,6,1,Friendly,5
Latvia,Lithuania,2,0,Friendly,2
Netherlands,Scotland,1,3,Friendly,2
Italy,Yugoslavia,4,0,Friendly,4
Poland,Republic of Ireland,6,0,Friendly,6
France,England,2,4,Friendly,2
Cuba,Basque Country,0,4,Friendly,4
Czechoslovakia,Netherlands,3,0,FIFA World Cup,3
France,Belgium,3,1,FIFA World Cup,2
Hungary,Indonesia,6,0,FIFA World Cup,6
Germany,Switzerland,2,4,FIFA World Cup,2
Lithuania,Estonia,0,2,Friendly,2
Cuba,Sweden,0,8,FIFA World Cup,8
France,Italy,1,3,FIFA World Cup,2
Hungary,Switzerland,2,0,FIFA World Cup,2
Sweden,Finland,2,0,Friendly,2
Hungary,Sweden,5,1,FIFA World Cup,4
Norway,Finland,9,0,Nordic Championship,9
Brazil,Sweden,4,2,FIFA World Cup,2
Hungary,Italy,2,4,FIFA World Cup,2
Netherlands,Indonesia,9,2,Friendly,7
Finland,Sweden,2,4,Nordic Championship,2
Aruba,Suriname,5,0,Friendly,5
Curaçao,Suriname,4,1,Friendly,3
Suriname,Trinidad and Tobago,3,0,Friendly,3
Estonia,Latvia,0,2,Friendly,2
Sweden,Czechoslovakia,2,6,Friendly,4
Colombia,Peru,2,4,Bolivarian Games,2
Bolivia,Venezuela,3,1,Bolivarian Games,2
Ecuador,Peru,1,9,Bolivarian Games,8
Colombia,Venezuela,2,0,Bolivarian Games,2
Estonia,Finland,1,3,Friendly,2
Saint Kitts and Nevis,Grenada,0,4,Friendly,4
Saint Kitts and Nevis,Grenada,2,4,Friendly,2
Ecuador,Venezuela,5,2,Bolivarian Games,3
Yugoslavia,Czechoslovakia,1,3,Friendly,2
Australia,India,5,3,Friendly,2
Estonia,Lithuania,3,1,Baltic Cup,2
Australia,India,1,4,Friendly,3
Finland,Lithuania,3,1,Friendly,2
Germany,Poland,4,1,Friendly,3
Republic of Ireland,Switzerland,4,0,Friendly,4
Romania,Germany,1,4,Friendly,3
Australia,India,3,1,Friendly,2
Northern Ireland,Scotland,0,2,British Home Championship,2
Kenya,Uganda,1,3,Friendly,2
Mexico,Basque Country,8,4,Friendly,4
Wales,England,4,2,British Home Championship,2
Mexico,Basque Country,2,6,Friendly,4
Mexico,Basque Country,1,3,Friendly,2
England,Norway,4,0,Friendly,4
England,Northern Ireland,7,0,British Home Championship,7
Italy,Switzerland,2,0,Friendly,2
Czechoslovakia,Romania,6,2,Friendly,4
Scotland,Hungary,3,1,Friendly,2
Dominica,Martinique,3,1,Friendly,2
Brazil,Argentina,1,5,Copa Roca,4
Chile,Paraguay,1,5,Copa América,4
Peru,Ecuador,5,2,Copa América,3
Ecuador,Uruguay,0,6,Copa América,6
France,Poland,4,0,Friendly,4
Peru,Chile,3,1,Copa América,2
Belgium,Germany,1,4,Friendly,3
Peru,Paraguay,3,0,Copa América,3
Chile,Ecuador,4,1,Copa América,3
Paraguay,Uruguay,1,3,Copa América,2
Ecuador,Paraguay,1,3,Copa América,2
Portugal,Switzerland,2,4,Friendly,2
Chile,Paraguay,4,1,Friendly,3
Wales,Northern Ireland,3,1,British Home Championship,2
Haiti,Panama,3,0,Friendly,3
Switzerland,Hungary,3,1,Friendly,2
Brittany,Luxembourg,3,1,Friendly,2
Belgium,France,1,3,Friendly,2
Romania,Latvia,4,0,Friendly,4
Bulgaria,Latvia,3,0,Friendly,3
Romania,England,0,2,Friendly,2
Hungary,Italy,1,3,Friendly,2
Sweden,Finland,5,1,Nordic Championship,4
Sweden,Lithuania,7,0,Friendly,7
Denmark,Finland,5,0,Friendly,5
Denmark,Norway,6,3,Friendly,3
Norway,Germany,0,4,Friendly,4
Denmark,Germany,0,2,Friendly,2
Estonia,Germany,0,2,Friendly,2
Finland,Estonia,4,2,Friendly,2
Panama,Cuba,0,4,Friendly,4
Czechoslovakia,Yugoslavia,7,3,Friendly,4
Poland,Hungary,4,2,Friendly,2
Slovakia,Germany,2,0,Friendly,2
China PR,Japan,0,3,Friendly,3
Manchukuo,Japan,0,6,Friendly,6
Denmark,Finland,8,1,Nordic Championship,7
Finland,Latvia,0,3,Friendly,3
Hungary,Germany,5,1,Friendly,4
Sweden,Denmark,4,1,Nordic Championship,3
Yugoslavia,Germany,1,5,Friendly,4
Denmark,Norway,4,1,Nordic Championship,3
Switzerland,Italy,3,1,Friendly,2
Yugoslavia,Hungary,0,2,Friendly,2
Germany,Italy,5,2,Friendly,3
Uganda,Kenya,5,2,Friendly,3
Germany,Slovakia,3,1,Friendly,2
Argentina,Paraguay,3,1,Copa Chevallier Boutell,2
Kenya,Uganda,3,6,Friendly,3
Argentina,Paraguay,4,0,Copa Chevallier Boutell,4
Brazil,Argentina,0,3,Copa Roca,3
Argentina,Chile,4,1,Friendly,3
Argentina,Brazil,6,1,Copa Roca,5
Argentina,Brazil,5,1,Copa Roca,4
Belgium,Netherlands,7,1,Friendly,6
Hungary,Switzerland,3,0,Friendly,3
Croatia,Switzerland,4,0,Friendly,4
Netherlands,Belgium,4,2,Friendly,2
Israel,Lebanon,5,1,Friendly,4
Hungary,Romania,2,0,Friendly,2
Bulgaria,Slovakia,1,4,Friendly,3
Japan,Manchukuo,7,0,Friendly,7
Japan,China PR,6,0,Friendly,6
Germany,Romania,9,3,Friendly,6
Uruguay,Argentina,3,0,Friendly,3
Lithuania,Estonia,2,0,Friendly,2
Argentina,Uruguay,5,0,Friendly,5
Germany,Finland,13,0,Friendly,13
Sweden,Finland,5,0,Friendly,5
Germany,Bulgaria,7,3,Friendly,4
Yugoslavia,Germany,2,0,Friendly,2
Chile,Argentina,2,5,Friendly,3
Curaçao,Aruba,4,0,Friendly,4
Peru,Argentina,0,3,Friendly,3
Chile,Ecuador,5,0,Copa América,5
Ecuador,Uruguay,0,6,Copa América,6
Argentina,Ecuador,6,1,Copa América,5
Chile,Uruguay,0,2,Copa América,2
Ecuador,Peru,0,4,Copa América,4
Peru,Uruguay,0,2,Copa América,2
Germany,Switzerland,4,2,Friendly,2
Spain,Portugal,5,1,Friendly,4
Germany,Hungary,7,0,Friendly,7
Costa Rica,Nicaragua,7,2,CCCF Championship,5
Costa Rica,Panama,7,0,CCCF Championship,7
Costa Rica,Curaçao,6,2,CCCF Championship,4
El Salvador,Nicaragua,8,0,CCCF Championship,8
Curaçao,Nicaragua,9,1,CCCF Championship,8
Costa Rica,El Salvador,3,1,CCCF Championship,2
Nicaragua,Panama,2,5,CCCF Championship,3
Romania,Germany,1,4,Friendly,3
Germany,Croatia,5,1,Friendly,4
Afghanistan,India,1,3,Friendly,2
Martinique,Guadeloupe,5,0,Friendly,5
Croatia,Slovakia,5,2,Friendly,3
Finland,Germany,0,6,Friendly,6
Sweden,Germany,4,2,Friendly,2
Germany,Slovakia,4,0,Friendly,4
Portugal,Switzerland,3,0,Friendly,3
Uruguay,Chile,6,1,Copa América,5
Brazil,Chile,6,1,Copa América,5
Uruguay,Ecuador,7,0,Copa América,7
Croatia,Germany,0,2,Friendly,2
Argentina,Ecuador,12,0,Copa América,12
Chile,Paraguay,0,2,Copa América,2
Argentina,Peru,3,1,Copa América,2
Ecuador,Paraguay,1,3,Copa América,2
Uruguay,Paraguay,3,1,Copa América,2
Brazil,Ecuador,5,1,Copa América,4
Uruguay,Peru,3,0,Copa América,3
France,Switzerland,0,2,Friendly,2
Spain,France,4,0,Friendly,4
Italy,Croatia,4,0,Friendly,4
Italy,Spain,4,0,Friendly,4
Hungary,Germany,3,5,Friendly,2
Argentina,Uruguay,4,1,Copa Newton,3
Denmark,Sweden,0,3,Friendly,3
Bulgaria,Germany,0,3,Friendly,3
Latvia,Estonia,4,0,Friendly,4
China PR,Japan,1,6,Friendly,5
Manchukuo,Japan,0,3,Friendly,3
Japan,Mongolia,12,0,Friendly,12
Germany,Romania,7,0,Friendly,7
Estonia,Latvia,1,8,Friendly,7
Croatia,Slovakia,6,1,Friendly,5
Switzerland,Germany,3,5,Friendly,2
Germany,Croatia,5,1,Friendly,4
Hungary,Switzerland,3,0,Friendly,3
Switzerland,Sweden,3,1,Friendly,2
Slovakia,Germany,2,5,Friendly,3
Switzerland,Hungary,1,3,Friendly,2
Bulgaria,Hungary,2,4,Friendly,2
Paraguay,Argentina,2,5,Copa Chevallier Boutell,3
Finland,Hungary,0,3,Friendly,3
Hungary,Sweden,2,7,Friendly,5
Guyana,Suriname,2,0,Friendly,2
Guyana,Suriname,0,4,Friendly,4
Costa Rica,Nicaragua,7,0,CCCF Championship,7
El Salvador,Nicaragua,8,1,CCCF Championship,7
El Salvador,Costa Rica,4,2,CCCF Championship,2
Guatemala,Nicaragua,6,2,CCCF Championship,4
El Salvador,Nicaragua,10,1,CCCF Championship,9
Guatemala,Costa Rica,4,2,CCCF Championship,2
El Salvador,Costa Rica,2,4,CCCF Championship,2
Nicaragua,Guatemala,1,5,CCCF Championship,4
Trinidad and Tobago,Barbados,5,0,Friendly,5
Aruba,Venezuela,1,3,Friendly,2
Curaçao,Haiti,5,0,Friendly,5
Haiti,Venezuela,0,2,Friendly,2
Croatia,Slovakia,7,3,Friendly,4
Curaçao,Aruba,3,1,Friendly,2
Brazil,Uruguay,6,1,Friendly,5
Brazil,Uruguay,4,0,Friendly,4
Curaçao,Aruba,2,4,Friendly,2
Suriname,Aruba,5,0,Friendly,5
Suriname,Curaçao,0,2,Friendly,2
Aruba,Curaçao,1,5,Friendly,4
Trinidad and Tobago,Barbados,3,0,Friendly,3
Barbados,Guyana,0,3,Friendly,3
Trinidad and Tobago,Barbados,6,1,Friendly,5
Trinidad and Tobago,Guyana,3,0,Friendly,3
Barbados,Trinidad and Tobago,1,4,Friendly,3
Trinidad and Tobago,Guyana,3,0,Friendly,3
France,Belgium,3,1,Friendly,2
Argentina,Paraguay,5,2,Copa Chevallier Boutell,3
Argentina,Paraguay,5,3,Copa Chevallier Boutell,2
Chile,Ecuador,6,3,Copa América,3
Argentina,Bolivia,4,0,Copa América,4
Brazil,Colombia,3,0,Copa América,3
Chile,Bolivia,5,0,Copa América,5
Ecuador,Uruguay,1,5,Copa América,4
Bolivia,Brazil,0,2,Copa América,2
Colombia,Uruguay,0,7,Copa América,7
Argentina,Ecuador,4,2,Copa América,2
Chile,Colombia,2,0,Copa América,2
Argentina,Colombia,9,1,Copa América,8
Brazil,Uruguay,3,0,Copa América,3
Argentina,Brazil,3,1,Copa América,2
Bolivia,Uruguay,0,2,Copa América,2
Colombia,Ecuador,3,1,Copa América,2
Brazil,Ecuador,9,2,Copa América,7
Uganda,Kenya,4,1,Friendly,3
Spain,Portugal,4,2,Friendly,2
Luxembourg,Belgium,4,1,Friendly,3
Latvia,Lithuania,3,7,Friendly,4
Paraguay,Argentina,5,1,Copa Chevallier Boutell,4
Paraguay,Argentina,1,3,Copa Chevallier Boutell,2
Switzerland,England,3,1,Friendly,2
Argentina,Uruguay,6,2,Copa Newton,4
Hungary,Austria,2,0,Friendly,2
Hungary,Austria,5,2,Friendly,3
Uganda,Tanzania,7,0,Friendly,7
Denmark,Norway,4,2,Friendly,2
Suriname,Guyana,3,1,Friendly,2
Sweden,Finland,7,2,Friendly,5
Suriname,Guyana,4,1,Friendly,3
Suriname,Guyana,6,0,Friendly,6
Norway,Denmark,1,5,Friendly,4
Finland,Sweden,1,6,Friendly,5
Hungary,Romania,7,2,Friendly,5
Sweden,Denmark,4,1,Friendly,3
Sweden,Norway,10,0,Friendly,10
Switzerland,Sweden,3,0,Friendly,3
Austria,France,4,1,Friendly,3
Brazil,Argentina,6,2,Copa Roca,4
Brazil,Argentina,3,1,Copa Roca,2
Argentina,Paraguay,2,0,Copa América,2
Bolivia,Brazil,0,3,Copa América,3
Argentina,Bolivia,7,1,Copa América,6
England,Belgium,2,0,Friendly,2
Argentina,Chile,3,1,Copa América,2
Bolivia,Paraguay,2,4,Copa América,2
Bolivia,Uruguay,0,5,Copa América,5
Argentina,Uruguay,3,1,Copa América,2
Brazil,Chile,5,1,Copa América,4
Bolivia,Chile,1,4,Copa América,3
Argentina,Brazil,2,0,Copa América,2
Belgium,Luxembourg,7,0,Friendly,7
El Salvador,Guatemala,1,3,CCCF Championship,2
Costa Rica,Nicaragua,7,1,CCCF Championship,6
Costa Rica,Panama,7,0,CCCF Championship,7
El Salvador,Nicaragua,7,2,CCCF Championship,5
Honduras,Guatemala,5,3,CCCF Championship,2
Costa Rica,Honduras,5,1,CCCF Championship,4
El Salvador,Panama,4,1,CCCF Championship,3
Guatemala,Nicaragua,7,0,CCCF Championship,7
Costa Rica,Guatemala,1,4,CCCF Championship,3
El Salvador,Honduras,3,1,CCCF Championship,2
Luxembourg,Netherlands,2,6,Friendly,4
Panama,Nicaragua,0,2,CCCF Championship,2
Costa Rica,El Salvador,4,0,CCCF Championship,4
Honduras,Nicaragua,10,0,CCCF Championship,10
France,Czechoslovakia,3,0,Friendly,3
France,Austria,3,1,Friendly,2
Czechoslovakia,Yugoslavia,0,2,Friendly,2
England,Switzerland,4,1,Friendly,3
Netherlands,Belgium,6,3,Friendly,3
Scotland,Switzerland,3,1,Friendly,2
Aruba,Suriname,8,1,Friendly,7
Curaçao,Suriname,6,0,Friendly,6
Portugal,Republic of Ireland,3,1,Friendly,2
Zimbabwe,Zambia,0,4,Friendly,4
Denmark,Sweden,3,1,Friendly,2
Norway,Finland,12,0,Friendly,12
Sweden,Switzerland,7,2,Friendly,5
Denmark,Norway,2,0,Friendly,2
Iceland,Denmark,0,3,Friendly,3
Albania,Montenegro,5,0,Friendly,5
Finland,Denmark,2,5,Friendly,3
Finland,Sweden,0,7,Friendly,7
Norway,Sweden,0,3,Friendly,3
Kenya,Tanzania,3,0,Friendly,3
Northern Ireland,England,2,7,British Home Championship,5
Hungary,Austria,2,0,Friendly,2
Albania,Bulgaria,3,1,Balkan Cup,2
Wales,Scotland,3,1,British Home Championship,2
Denmark,Norway,7,1,Friendly,6
Guyana,Suriname,0,3,Friendly,3
Guyana,Suriname,3,1,Friendly,2
Luxembourg,Hungary,2,7,Friendly,5
England,Wales,3,0,British Home Championship,3
Aruba,Curaçao,0,4,Friendly,4
Aruba,Curaçao,3,1,Friendly,2
England,Netherlands,8,2,Friendly,6
Portugal,Spain,4,1,Friendly,3
Jamaica,Trinidad and Tobago,0,6,Friendly,6
Curaçao,Trinidad and Tobago,4,0,Friendly,4
Curaçao,Trinidad and Tobago,3,0,Friendly,3
Suriname,French Guiana,9,1,Friendly,8
Italy,Switzerland,5,2,Friendly,3
England,France,3,0,Friendly,3
Hungary,Austria,5,2,Friendly,3
Republic of Ireland,Portugal,0,2,Friendly,2
Czechoslovakia,Yugoslavia,3,1,Friendly,2
Australia,South Africa,2,4,Friendly,2
Luxembourg,Scotland,0,6,Friendly,6
Albania,Romania,0,4,Balkan Cup,4
Portugal,England,0,10,Friendly,10
France,Netherlands,4,0,Friendly,4
France,Belgium,4,2,Friendly,2
Madagascar,Réunion,4,2,Friendly,2
Australia,South Africa,5,1,Friendly,4
Norway,Poland,3,1,Friendly,2
Bulgaria,Albania,2,0,Balkan Cup,2
Denmark,Sweden,1,4,Nordic Championship,3
Curaçao,Aruba,4,1,Friendly,3
Romania,Yugoslavia,1,3,Balkan Cup,2
Sweden,Denmark,6,1,Friendly,5
Norway,Sweden,1,5,Friendly,4
New Zealand,South Africa,0,6,Friendly,6
New Zealand,South Africa,3,8,Friendly,5
Mexico,United States,5,0,NAFC Championship,5
Cuba,Mexico,1,3,NAFC Championship,2
New Zealand,South Africa,1,4,Friendly,3
Cuba,United States,5,2,NAFC Championship,3
Iceland,Norway,2,4,Friendly,2
Hungary,Bulgaria,9,0,Balkan Cup,9
Hungary,Albania,3,0,Balkan Cup,3
Sweden,Finland,7,0,Nordic Championship,7
Czechoslovakia,Poland,6,3,Friendly,3
Suriname,Guyana,4,0,Friendly,4
Albania,Yugoslavia,2,4,Balkan Cup,2
Finland,Poland,1,4,Friendly,3
Tanzania,Zanzibar,3,1,Friendly,2
Tanzania,Uganda,2,4,Friendly,2
Belgium,England,2,5,Friendly,3
Netherlands,Switzerland,6,2,Friendly,4
Norway,Denmark,3,5,Nordic Championship,2
Romania,Czechoslovakia,2,6,Friendly,4
Northern Ireland,Scotland,2,0,British Home Championship,2
Denmark,Finland,4,1,Nordic Championship,3
Lithuania,Latvia,0,3,Friendly,3
Sweden,Norway,4,1,Nordic Championship,3
Romania,Hungary,0,3,Balkan Cup,3
Wales,England,0,3,British Home Championship,3
Yugoslavia,Poland,7,1,Friendly,6
Catalonia,Spain,3,1,Friendly,2
Iran,Turkey,1,3,Friendly,2
Switzerland,Belgium,4,0,Friendly,4
Guyana,Jamaica,2,0,Friendly,2
Trinidad and Tobago,Jamaica,6,0,Friendly,6
Austria,Italy,5,1,Friendly,4
Trinidad and Tobago,Guyana,2,0,Friendly,2
England,Sweden,4,2,Friendly,2
Portugal,France,2,4,Friendly,2
Argentina,Paraguay,6,0,Copa América,6
Colombia,Uruguay,0,2,Copa América,2
Argentina,Bolivia,7,0,Copa América,7
Djibouti,Ethiopia,0,5,Friendly,5
Chile,Uruguay,0,6,Copa América,6
Cuba,Puerto Rico,4,0,Friendly,4
Bolivia,Uruguay,0,3,Copa América,3
Ecuador,Chile,0,3,Copa América,3
Paraguay,Uruguay,4,2,Copa América,2
Italy,Czechoslovakia,3,1,Friendly,2
Ecuador,Uruguay,1,6,Copa América,5
Argentina,Colombia,6,0,Copa América,6
Bolivia,Paraguay,1,3,Copa América,2
Colombia,Paraguay,0,2,Copa América,2
Colombia,Peru,1,5,Copa América,4
Ecuador,Argentina,0,2,Copa América,2
Bolivia,Peru,0,2,Copa América,2
Argentina,Uruguay,3,1,Copa América,2
Chile,Colombia,4,1,Copa América,3
Ecuador,Paraguay,0,4,Copa América,4
Costa Rica,El Salvador,3,1,CCCF Championship,2
Guatemala,El Salvador,3,0,CCCF Championship,3
Panama,Curaçao,1,3,CCCF Championship,2
Wales,Northern Ireland,2,0,British Home Championship,2
Costa Rica,Panama,3,1,CCCF Championship,2
Curaçao,El Salvador,0,2,CCCF Championship,2
Suriname,Trinidad and Tobago,0,2,Friendly,2
Curaçao,Panama,2,5,CCCF Championship,3
Panama,El Salvador,2,0,CCCF Championship,2
El Salvador,Costa Rica,0,6,CCCF Championship,6
Curaçao,Costa Rica,4,1,CCCF Championship,3
Spain,Portugal,2,0,Friendly,2
France,Italy,1,3,Friendly,2
Scotland,England,0,2,British Home Championship,2
Uruguay,Brazil,4,2,Copa Rio Branco,2
Austria,Switzerland,3,1,Friendly,2
Poland,Czechoslovakia,3,1,Balkan Cup,2
Hungary,Switzerland,7,4,Central European International Cup,3
Greece,Turkey,1,3,Friendly,2
Scotland,Belgium,2,0,Friendly,2
Italy,England,0,4,Friendly,4
France,Scotland,3,0,Friendly,3
Portugal,Republic of Ireland,2,0,Friendly,2
Belgium,France,4,2,Friendly,2
Hungary,Romania,9,0,Balkan Cup,9
Jamaica,Cuba,3,0,Friendly,3
Czechoslovakia,France,0,4,Friendly,4
Finland,Denmark,0,3,Nordic Championship,3
Denmark,Poland,8,0,Friendly,8
Iceland,Finland,2,0,Friendly,2
Bulgaria,Yugoslavia,1,3,Balkan Cup,2
Mauritius,Madagascar,4,1,Friendly,3
Mauritius,Réunion,5,1,Friendly,4
Sweden,Austria,3,0,Friendly,3
Norway,United States,11,0,Friendly,11
Northern Ireland,United States,5,0,Friendly,5
New Zealand,Australia,0,6,Friendly,6
Zimbabwe,Zambia,4,0,Friendly,4
New Zealand,Australia,0,7,Friendly,7
Martinique,Dominica,5,0,Friendly,5
New Zealand,Australia,0,4,Friendly,4
Norway,Finland,2,0,Nordic Championship,2
New Zealand,Australia,1,8,Friendly,7
Norway,Sweden,3,5,Nordic Championship,2
Poland,Hungary,2,6,Balkan Cup,4
Kenya,Zanzibar,3,1,Friendly,2
Uganda,Tanzania,6,0,Friendly,6
French Guiana,Suriname,2,4,Friendly,2
United States,Israel,3,1,Friendly,2
Suriname,Guyana,3,0,Friendly,3
Northern Ireland,England,2,6,British Home Championship,4
Jamaica,Haiti,3,0,Friendly,3
Wales,Scotland,1,3,British Home Championship,2
Romania,Hungary,1,5,Balkan Cup,4
Trinidad and Tobago,Haiti,4,0,Friendly,4
Trinidad and Tobago,Haiti,4,0,Friendly,4
Czechoslovakia,Austria,3,1,Central European International Cup,2
England,Switzerland,6,0,Friendly,6
Dominica,Martinique,0,6,Friendly,6
Guadeloupe,French Guiana,7,2,Friendly,5
Guadeloupe,Martinique,3,0,Friendly,3
Macau,South Korea,1,5,Friendly,4
Italy,Portugal,4,1,Friendly,3
Northern Ireland,Wales,0,2,British Home Championship,2
Spain,Italy,1,3,Friendly,2
Brazil,Ecuador,9,1,Copa América,8
Colombia,Paraguay,0,3,Copa América,3
England,Scotland,1,3,British Home Championship,2
Brazil,Bolivia,10,1,Copa América,9
Colombia,Peru,0,4,Copa América,4
Czechoslovakia,Hungary,5,2,Central European International Cup,3
Paraguay,Peru,3,1,Copa América,2
Brazil,Colombia,5,0,Copa América,5
Ecuador,Peru,0,4,Copa América,4
Netherlands,France,4,1,Friendly,3
Brazil,Peru,7,1,Copa América,6
Republic of Ireland,Belgium,0,2,Friendly,2
Bolivia,Ecuador,2,0,Copa América,2
Haiti,Trinidad and Tobago,5,0,Friendly,5
Bolivia,Peru,0,3,Copa América,3
Chile,Paraguay,2,4,Copa América,2
Scotland,France,2,0,Friendly,2
Bolivia,Paraguay,0,7,Copa América,7
Brazil,Uruguay,5,1,Copa América,4
Chile,Peru,0,3,Copa América,3
Ethiopia,Djibouti,6,0,Friendly,6
Jamaica,Trinidad and Tobago,3,1,Friendly,2
Colombia,Ecuador,1,4,Copa América,3
Bolivia,Colombia,4,0,Copa América,4
Chile,Uruguay,3,1,Copa América,2
Hungary,Austria,6,1,Central European International Cup,5
Puerto Rico,Trinidad and Tobago,2,8,Friendly,6
Brazil,Paraguay,7,0,Copa América,7
Puerto Rico,Trinidad and Tobago,0,7,Friendly,7
Sweden,England,3,1,Friendly,2
Greece,Egypt,1,3,Friendly,2
Norway,England,1,4,Friendly,3
Belgium,Wales,3,1,Friendly,2
France,England,1,3,Friendly,2
Italy,Austria,3,1,Central European International Cup,2
Switzerland,Wales,4,0,Friendly,4
Sweden,Republic of Ireland,3,1,FIFA World Cup qualification,2
France,Switzerland,4,2,Friendly,2
Republic of Ireland,Spain,1,4,Friendly,3
Finland,Netherlands,1,4,Friendly,3
Madagascar,Mauritius,1,3,Friendly,2
France,Spain,1,5,Friendly,4
Norway,Yugoslavia,1,3,Friendly,2
United States,Scotland,0,4,Friendly,4
Switzerland,Luxembourg,5,2,FIFA World Cup qualification,3
Martinique,Trinidad and Tobago,2,0,Friendly,2
Hungary,Poland,8,2,Friendly,6
Curaçao,Aruba,3,0,Friendly,3
Israel,Cyprus,3,1,Friendly,2
El Salvador,Panama,3,1,Friendly,2
Denmark,Iceland,5,1,Friendly,4
Suriname,French Guiana,5,0,Friendly,5
Yugoslavia,Israel,6,0,FIFA World Cup qualification,6
Czechoslovakia,Bulgaria,1,3,Friendly,2
Mexico,United States,6,0,NAFC Championship,6
Republic of Ireland,Finland,3,0,FIFA World Cup qualification,3
Denmark,Finland,0,2,Nordic Championship,2
Mexico,Cuba,2,0,NAFC Championship,2
Norway,Denmark,0,2,Nordic Championship,2
Israel,Yugoslavia,2,5,FIFA World Cup qualification,3
Mexico,United States,6,2,FIFA World Cup qualification,4
England,Republic of Ireland,0,2,Friendly,2
United States,Cuba,5,2,FIFA World Cup qualification,3
Austria,Czechoslovakia,3,1,Central European International Cup,2
Mexico,Cuba,3,0,FIFA World Cup qualification,3
Northern Ireland,Scotland,2,8,FIFA World Cup qualification,6
Belgium,Switzerland,3,0,Friendly,3
Sweden,Finland,8,1,Nordic Championship,7
Réunion,Mauritius,0,6,Friendly,6
Sierra Leone,Nigeria,0,2,Friendly,2
Réunion,Madagascar,1,3,Friendly,2
Wales,England,1,4,FIFA World Cup qualification,3
Czechoslovakia,Poland,2,0,Friendly,2
Hungary,Bulgaria,5,0,Friendly,5
Scotland,Wales,2,0,FIFA World Cup qualification,2
Republic of Ireland,Sweden,1,3,FIFA World Cup qualification,2
Yugoslavia,Austria,2,5,Friendly,3
England,Northern Ireland,9,2,FIFA World Cup qualification,7
Hungary,Sweden,5,0,Friendly,5
Turkey,Syria,7,0,FIFA World Cup qualification,7
Wales,Belgium,5,1,Friendly,4
Greece,Syria,8,0,Friendly,8
Albania,Romania,1,4,Friendly,3
England,Italy,2,0,Friendly,2
Kenya,Tanzania,0,2,Friendly,2
Cuba,Jamaica,2,5,Friendly,3
Haiti,Jamaica,2,0,Friendly,2
Haiti,Cuba,3,0,Friendly,3
Egypt,Greece,2,0,Friendly,2
Bolivia,Chile,2,0,Friendly,2
Croatia,Serbia,4,1,Friendly,3
Italy,Belgium,3,1,Friendly,2
Chile,Bolivia,5,0,Friendly,5
Guyana,Trinidad and Tobago,1,4,Friendly,3
Argentina,Paraguay,4,0,Copa Chevallier Boutell,4
Spain,Portugal,5,1,FIFA World Cup qualification,4
Chile,Uruguay,1,5,Friendly,4
Mauritius,Réunion,15,2,Friendly,13
Belgium,Netherlands,2,0,Friendly,2
South Korea,Taiwan,3,1,Friendly,2
Scotland,Switzerland,3,1,Friendly,2
Hungary,Czechoslovakia,5,0,Friendly,5
Brazil,Paraguay,2,0,Copa Oswaldo Cruz,2
Belgium,Republic of Ireland,5,1,Friendly,4
Austria,Hungary,5,3,Friendly,2
Portugal,England,3,5,Friendly,2
Belgium,England,1,4,Friendly,3
Turkey,Iran,6,1,Friendly,5
Yugoslavia,Denmark,5,1,Friendly,4
Belgium,France,4,1,Friendly,3
Poland,Hungary,2,5,Friendly,3
Sweden,Netherlands,4,1,Friendly,3
Finland,Netherlands,4,1,Friendly,3
Switzerland,Yugoslavia,0,4,Friendly,4
Zimbabwe,Australia,0,5,Friendly,5
Zimbabwe,Australia,1,4,Friendly,3
Denmark,Norway,4,0,Nordic Championship,4
Brazil,Mexico,4,0,FIFA World Cup,4
Chile,England,0,2,FIFA World Cup,2
Denmark,Norway,1,4,Friendly,3
Spain,United States,3,1,FIFA World Cup,2
Switzerland,Yugoslavia,0,3,FIFA World Cup,3
Mexico,Yugoslavia,1,4,FIFA World Cup,3
Chile,Spain,0,2,FIFA World Cup,2
Brazil,Yugoslavia,2,0,FIFA World Cup,2
Bolivia,Uruguay,0,8,FIFA World Cup,8
Chile,United States,5,2,FIFA World Cup,3
Italy,Paraguay,2,0,FIFA World Cup,2
Brazil,Sweden,7,1,FIFA World Cup,6
Madagascar,Mauritius,1,5,Friendly,4
Brazil,Spain,6,1,FIFA World Cup,5
Spain,Sweden,1,3,FIFA World Cup,2
South Africa,Australia,0,2,Friendly,2
Suriname,Guyana,3,0,Friendly,3
Suriname,Guyana,4,1,Friendly,3
El Salvador,Guatemala,2,0,Friendly,2
Denmark,Yugoslavia,1,4,Friendly,3
Norway,Finland,4,1,Nordic Championship,3
Hungary,Albania,12,0,Friendly,12
Norway,Sweden,1,3,Nordic Championship,2
Northern Ireland,England,1,4,British Home Championship,3
Austria,Yugoslavia,7,2,Friendly,5
Romania,Albania,6,0,Friendly,6
Tanzania,Zanzibar,4,0,Friendly,4
Kenya,Uganda,3,1,Friendly,2
Sweden,Denmark,4,0,Nordic Championship,4
Switzerland,Netherlands,7,5,Friendly,2
Wales,Scotland,1,3,British Home Championship,2
Poland,Czechoslovakia,1,4,Friendly,3
Iran,Afghanistan,4,0,Friendly,4
Israel,Turkey,5,1,Friendly,4
Scotland,Northern Ireland,6,1,British Home Championship,5
Austria,Denmark,5,1,Friendly,4
Yugoslavia,Norway,4,0,Friendly,4
Belgium,Netherlands,7,2,Friendly,5
Switzerland,Sweden,4,2,Friendly,2
England,Wales,4,2,British Home Championship,2
Trinidad and Tobago,Suriname,5,0,Friendly,5
Curaçao,Suriname,3,0,Friendly,3
Trinidad and Tobago,Curaçao,5,1,Friendly,4
France,Netherlands,5,2,Friendly,3
Spain,Switzerland,6,3,Friendly,3
Costa Rica,Nicaragua,8,1,CCCF Championship,7
Panama,Costa Rica,2,0,CCCF Championship,2
Panama,Nicaragua,4,0,CCCF Championship,4
Nicaragua,Costa Rica,1,4,CCCF Championship,3
Panama,Nicaragua,6,2,CCCF Championship,4
Barbados,Grenada,1,3,Friendly,2
Martinique,Guadeloupe,3,0,Friendly,3
Portugal,Italy,1,4,Friendly,3
Scotland,Denmark,3,1,Friendly,2
England,Portugal,5,2,Friendly,3
Belgium,Scotland,0,5,Friendly,5
Barbados,Jamaica,3,0,Friendly,3
Austria,Scotland,4,0,Friendly,4
Hungary,Poland,6,0,Friendly,6
Barbados,Jamaica,5,2,Friendly,3
Italy,France,4,1,Friendly,3
Sweden,Turkey,3,1,Friendly,2
Yugoslavia,Switzerland,7,3,Friendly,4
Madagascar,Réunion,3,1,Friendly,2
Mauritius,Madagascar,7,1,Friendly,6
Mauritius,Réunion,10,2,Friendly,8
Norway,Iceland,3,1,Friendly,2
Norway,Yugoslavia,2,4,Friendly,2
Suriname,Guyana,6,1,Friendly,5
Suriname,Guyana,5,0,Friendly,5
Suriname,Guyana,4,0,Friendly,4
Norway,Denmark,2,0,Nordic Championship,2
New Caledonia,New Zealand,2,0,Friendly,2
New Caledonia,New Zealand,4,6,Friendly,2
Austria,Germany,0,2,Friendly,2
New Caledonia,New Zealand,2,0,Friendly,2
New Caledonia,New Zealand,1,3,Friendly,2
New Zealand,Vanuatu,9,0,Friendly,9
Northern Ireland,Scotland,0,3,British Home Championship,3
Fiji,New Zealand,4,6,Friendly,2
Belgium,Austria,1,8,Friendly,7
Nigeria,Ghana,5,0,Friendly,5
Denmark,Sweden,3,1,Nordic Championship,2
Luxembourg,Finland,3,0,Friendly,3
England,Northern Ireland,2,0,British Home Championship,2
Hungary,Finland,8,0,Friendly,8
Turkey,Germany,0,2,Friendly,2
Venezuela,Panama,4,1,Friendly,3
Guadeloupe,Trinidad and Tobago,0,2,Friendly,2
Germany,Luxembourg,4,1,Friendly,3
Curaçao,Aruba,3,0,Friendly,3
Curaçao,Aruba,3,1,Friendly,2
Guyana,Suriname,0,9,Friendly,9
Belgium,Italy,2,0,Friendly,2
Guadeloupe,Martinique,4,0,Friendly,4
Myanmar,India,0,4,Friendly,4
Chile,Panama,6,1,Pan American Championship,5
Wales,Northern Ireland,3,0,British Home Championship,3
Austria,Belgium,2,0,Friendly,2
Mexico,Uruguay,1,3,Pan American Championship,2
Panama,Peru,1,7,Pan American Championship,6
Chile,Mexico,4,0,Pan American Championship,4
Sri Lanka,Pakistan,0,2,Friendly,2
Peru,Uruguay,2,5,Pan American Championship,3
Belgium,Netherlands,4,2,Friendly,2
Brazil,Mexico,2,0,Pan American Championship,2
Panama,Uruguay,1,6,Pan American Championship,5
Mexico,Panama,4,2,Pan American Championship,2
Brazil,Panama,5,0,Pan American Championship,5
Chile,Uruguay,2,0,Pan American Championship,2
Brazil,Uruguay,4,2,Pan American Championship,2
Chile,Brazil,0,3,Pan American Championship,3
France,Portugal,3,0,Friendly,3
Luxembourg,Germany,0,3,Friendly,3
Mexico,Peru,0,3,Pan American Championship,3
Scotland,United States,6,0,Friendly,6
Germany,Republic of Ireland,3,0,Friendly,3
Austria,Republic of Ireland,6,0,Friendly,6
Romania,Czechoslovakia,3,1,Friendly,2
Hungary,German DR,5,0,Friendly,5
Switzerland,England,0,3,Friendly,3
Sweden,Scotland,3,1,Friendly,2
Spain,Republic of Ireland,6,0,Friendly,6
Turkey,Switzerland,1,5,Friendly,4
Denmark,Sweden,0,2,Friendly,2
Finland,Sweden,3,1,Friendly,2
Poland,Hungary,1,5,Friendly,4
Finland,Hungary,1,6,Friendly,5
Yugoslavia,Norway,4,1,Friendly,3
Haiti,Jamaica,4,1,Friendly,3
Haiti,Jamaica,2,0,Friendly,2
Réunion,Mauritius,0,6,Friendly,6
Madagascar,Mauritius,0,7,Friendly,7
Finland,China PR,4,0,Friendly,4
Silesia,China PR,5,1,Friendly,4
Norway,Finland,7,2,Nordic Championship,5
Zambia,Zimbabwe,1,4,Friendly,3
Fiji,New Zealand,0,2,Friendly,2
Fiji,New Zealand,0,9,Friendly,9
Fiji,New Zealand,2,5,Friendly,3
Switzerland,Hungary,2,4,Central European International Cup,2
Finland,Sweden,1,8,Nordic Championship,7
Poland,German DR,3,0,Friendly,3
Yugoslavia,Austria,4,2,Friendly,2
Uganda,Tanzania,4,0,Friendly,4
Kenya,Zanzibar,7,1,Friendly,6
Tanzania,Zanzibar,1,3,Friendly,2
Uganda,Kenya,6,3,Friendly,3
Tahiti,New Zealand,3,5,Friendly,2
France,Germany,3,1,Friendly,2
Denmark,Norway,1,3,Nordic Championship,2
Hungary,Czechoslovakia,5,0,Friendly,5
Romania,German DR,3,1,Friendly,2
Yugoslavia,Egypt,5,0,Friendly,5
Germany,Switzerland,5,1,Friendly,4
France,Northern Ireland,3,1,Friendly,2
England,Wales,5,2,British Home Championship,3
England,Belgium,5,0,Friendly,5
Portugal,Argentina,1,3,Friendly,2
Italy,Switzerland,2,0,Central European International Cup,2
Egypt,Yugoslavia,1,3,Friendly,2
Bolivia,Uruguay,0,2,Copa América,2
Chile,Paraguay,0,3,Copa América,3
Bolivia,Brazil,1,8,Copa América,7
Costa Rica,El Salvador,5,1,CCCF Championship,4
Costa Rica,Panama,3,0,CCCF Championship,3
El Salvador,Nicaragua,4,1,CCCF Championship,3
Curaçao,Nicaragua,8,0,CCCF Championship,8
Brazil,Ecuador,2,0,Copa América,2
Panama,Curaçao,2,4,CCCF Championship,2
Costa Rica,Honduras,4,1,CCCF Championship,3
Panama,Nicaragua,0,2,CCCF Championship,2
El Salvador,Honduras,0,3,CCCF Championship,3
Costa Rica,Nicaragua,3,0,CCCF Championship,3
Chile,Ecuador,3,0,Copa América,3
Spain,Belgium,3,1,Friendly,2
Costa Rica,Guatemala,3,0,CCCF Championship,3
Honduras,Panama,3,1,CCCF Championship,2
Ecuador,Uruguay,0,6,Copa América,6
Republic of Ireland,Austria,4,0,Friendly,4
Peru,Uruguay,0,3,Copa América,3
Hong Kong,South Korea,4,0,Friendly,4
South Korea,Taiwan,2,4,Friendly,2
Singapore,South Korea,3,1,Friendly,2
Netherlands,Belgium,0,2,Friendly,2
Singapore,South Korea,1,3,Friendly,2
Czechoslovakia,Italy,2,0,Central European International Cup,2
Indonesia,South Korea,1,3,Friendly,2
Argentina,England,3,1,Friendly,2
Belgium,Yugoslavia,1,3,Friendly,2
France,Wales,6,1,Friendly,5
Guadeloupe,Martinique,0,2,Friendly,2
Italy,Hungary,0,3,Central European International Cup,3
Yugoslavia,Wales,5,2,Friendly,3
Finland,Belgium,2,4,FIFA World Cup qualification,2
Gambia,Guinea-Bissau,1,3,Friendly,2
United States,England,3,6,Friendly,3
Czechoslovakia,Romania,2,0,FIFA World Cup qualification,2
Singapore,Philippines,3,1,Friendly,2
Denmark,Sweden,1,3,Nordic Championship,2
Switzerland,Denmark,1,4,Friendly,3
Romania,Bulgaria,3,1,FIFA World Cup qualification,2
Sweden,Hungary,2,4,Friendly,2
Mauritius,Réunion,9,4,Friendly,5
Madagascar,Réunion,6,4,Friendly,2
Mexico,Haiti,8,0,FIFA World Cup qualification,8
Peru,Chile,5,0,Copa del Pacífico,5
Denmark,Iceland,4,0,Friendly,4
Catalonia,Spain,0,6,Friendly,6
Norway,Iceland,3,1,Friendly,2
Sweden,Finland,4,0,FIFA World Cup qualification,4
Finland,Norway,1,4,Nordic Championship,3
Vanuatu,Tahiti,2,4,Friendly,2
Vanuatu,Tahiti,2,4,Friendly,2
Uganda,Burundi,9,1,Friendly,8
Czechoslovakia,Switzerland,5,0,Central European International Cup,5
Luxembourg,France,1,6,FIFA World Cup qualification,5
New Caledonia,Tahiti,5,0,Friendly,5
New Caledonia,Tahiti,4,1,Friendly,3
New Caledonia,Tahiti,4,1,Friendly,3
Kernow,Trinidad and Tobago,3,6,Friendly,3
Austria,Portugal,9,1,FIFA World Cup qualification,8
Norway,Netherlands,4,0,Friendly,4
Zanzibar,Uganda,1,5,Friendly,4
Kenya,Tanzania,7,1,Friendly,6
Kernow,Trinidad and Tobago,2,4,Friendly,2
Kenya,Uganda,6,2,Friendly,4
Northern Ireland,Scotland,1,3,FIFA World Cup qualification,2
Czechoslovakia,Hungary,1,5,Friendly,4
Denmark,Finland,6,1,Nordic Championship,5
Republic of Ireland,France,3,5,FIFA World Cup qualification,2
Belgium,Sweden,2,0,FIFA World Cup qualification,2
Wales,England,1,4,FIFA World Cup qualification,3
Germany,Saarland,3,0,FIFA World Cup qualification,3
Yugoslavia,France,3,1,Friendly,2
Sri Lanka,India,0,2,Friendly,2
Republic of Ireland,Luxembourg,4,0,FIFA World Cup qualification,4
Myanmar,India,2,4,Friendly,2
England,Northern Ireland,3,1,FIFA World Cup qualification,2
France,Switzerland,2,4,Friendly,2
Haiti,Jamaica,4,1,Friendly,3
Germany,Norway,5,1,FIFA World Cup qualification,4
Portugal,South Africa,3,1,Friendly,2
England,Hungary,3,6,Friendly,3
Albania,Poland,2,0,Friendly,2
Italy,Czechoslovakia,3,0,Central European International Cup,3
France,Luxembourg,8,0,FIFA World Cup qualification,8
Haiti,Mexico,0,4,FIFA World Cup qualification,4
Spain,Turkey,4,1,FIFA World Cup qualification,3
Mexico,United States,4,0,FIFA World Cup qualification,4
Mexico,United States,3,1,FIFA World Cup qualification,2
Italy,Egypt,5,1,FIFA World Cup qualification,4
Egypt,Hungary,0,3,Friendly,3
Paraguay,Chile,4,0,FIFA World Cup qualification,4
Chile,Paraguay,1,3,FIFA World Cup qualification,2
Chile,Brazil,0,2,FIFA World Cup qualification,2
Japan,South Korea,1,5,FIFA World Cup qualification,4
Israel,Greece,0,2,FIFA World Cup qualification,2
Brazil,Paraguay,4,1,FIFA World Cup qualification,3
Saarland,Germany,1,3,FIFA World Cup qualification,2
Scotland,England,2,4,FIFA World Cup qualification,2
Belgium,Netherlands,4,0,Friendly,4
Haiti,United States,0,3,FIFA World Cup qualification,3
Uruguay,Paraguay,1,4,Friendly,3
France,Italy,1,3,Friendly,2
Switzerland,Germany,3,5,Friendly,2
Ethiopia,Djibouti,10,2,Friendly,8
Austria,Wales,2,0,Friendly,2
Yugoslavia,Belgium,0,2,Friendly,2
Sweden,Netherlands,6,1,Friendly,5
Guadeloupe,Martinique,2,4,Friendly,2
Hungary,England,7,1,Friendly,6
Austria,Norway,5,0,Friendly,5
Switzerland,Netherlands,3,1,Friendly,2
Djibouti,Ethiopia,0,2,Friendly,2
Ghana,Sierra Leone,2,0,Friendly,2
Sweden,Finland,6,0,Friendly,6
Saarland,Uruguay,1,7,Friendly,6
Sweden,Norway,3,0,Friendly,3
Brazil,Mexico,5,0,FIFA World Cup,5
Czechoslovakia,Uruguay,0,2,FIFA World Cup,2
Germany,Turkey,4,1,FIFA World Cup,3
Hungary,South Korea,9,0,FIFA World Cup,9
Austria,Czechoslovakia,5,0,FIFA World Cup,5
Scotland,Uruguay,0,7,FIFA World Cup,7
Belgium,Italy,1,4,FIFA World Cup,3
Germany,Hungary,3,8,FIFA World Cup,5
South Korea,Turkey,0,7,FIFA World Cup,7
Switzerland,England,0,2,FIFA World Cup,2
Germany,Turkey,7,2,FIFA World Cup,5
Switzerland,Italy,4,1,FIFA World Cup,3
England,Uruguay,2,4,FIFA World Cup,2
Switzerland,Austria,5,7,FIFA World Cup,2
Brazil,Hungary,2,4,FIFA World Cup,2
Germany,Yugoslavia,2,0,FIFA World Cup,2
Austria,Germany,1,6,FIFA World Cup,5
Hungary,Uruguay,4,2,FIFA World Cup,2
Austria,Uruguay,3,1,FIFA World Cup,2
Madagascar,Réunion,2,6,Friendly,4
Mauritius,Madagascar,4,1,Friendly,3
Mauritius,Réunion,11,0,Friendly,11
Curaçao,Netherlands,2,0,Friendly,2
Suriname,Netherlands,0,2,Friendly,2
Finland,Sweden,1,10,Nordic Championship,9
Zimbabwe,Zambia,2,4,Friendly,2
Australia,New Zealand,4,1,Friendly,3
Norway,Finland,3,1,Nordic Championship,2
Australia,New Zealand,4,1,Friendly,3
Russia,Sweden,7,0,Friendly,7
Chile,Peru,2,4,Copa del Pacífico,2
Hungary,Romania,5,1,Friendly,4
Wales,Yugoslavia,1,3,Friendly,2
Belgium,Germany,2,0,Friendly,2
Saarland,Yugoslavia,1,5,Friendly,4
Northern Ireland,England,0,2,British Home Championship,2
Kenya,Zanzibar,5,0,Friendly,5
Tanzania,Uganda,3,5,Friendly,2
Hungary,Switzerland,3,0,Friendly,3
Kenya,Uganda,1,4,Friendly,3
Sweden,Denmark,5,2,Nordic Championship,3
Germany,France,1,3,Friendly,2
Yugoslavia,Turkey,5,1,Friendly,4
Bulgaria,German DR,3,1,Friendly,2
Hungary,Czechoslovakia,4,1,Friendly,3
Nigeria,Ghana,3,0,Friendly,3
Cambodia,Thailand,7,1,Friendly,6
Hungary,Austria,4,1,Friendly,3
Portugal,Argentina,1,3,Friendly,2
England,Germany,3,1,Friendly,2
Italy,Argentina,2,0,Friendly,2
Scotland,Hungary,2,4,Friendly,2
Portugal,Germany,0,3,Friendly,3
Chile,Ecuador,7,1,Copa América,6
Martinique,Guadeloupe,4,1,Friendly,3
Argentina,Paraguay,5,3,Copa América,2
Argentina,Ecuador,4,0,Copa América,4
Paraguay,Uruguay,1,3,Copa América,2
Ecuador,Peru,2,4,Copa América,2
Ecuador,Paraguay,0,2,Copa América,2
Chile,Paraguay,5,0,Copa América,5
Ecuador,Uruguay,1,5,Copa América,4
Argentina,Uruguay,6,1,Copa América,5
England,Scotland,7,2,British Home Championship,5
France,Sweden,2,0,Friendly,2
Scotland,Portugal,3,0,Friendly,3
Norway,Hungary,0,5,Friendly,5
Sweden,Hungary,3,7,Friendly,4
Denmark,Hungary,0,6,Friendly,6
Austria,Scotland,1,4,Friendly,3
Finland,Hungary,1,9,Friendly,8
Netherlands,Switzerland,4,1,Friendly,3
Portugal,England,3,1,Friendly,2
Norway,Republic of Ireland,1,3,Friendly,2
Hungary,Scotland,3,1,Friendly,2
Italy,Yugoslavia,0,4,Central European International Cup,4
Belgium,Czechoslovakia,1,3,Friendly,2
Sweden,Romania,4,1,Friendly,3
Switzerland,Spain,0,3,Friendly,3
Sweden,Russia,0,6,Friendly,6
Iceland,Denmark,0,4,Friendly,4
Réunion,Mauritius,1,3,Friendly,2
Réunion,Madagascar,2,4,Friendly,2
Costa Rica,Guatemala,9,1,Friendly,8
Guatemala,Costa Rica,3,1,Friendly,2
Finland,Norway,1,3,Nordic Championship,2
Honduras,Cuba,3,0,CCCF Championship,3
Costa Rica,Cuba,6,0,CCCF Championship,6
Honduras,El Salvador,3,1,CCCF Championship,2
Guatemala,Curaçao,4,1,CCCF Championship,3
Aruba,Cuba,4,1,CCCF Championship,3
Costa Rica,El Salvador,4,0,CCCF Championship,4
Honduras,Curaçao,0,2,CCCF Championship,2
Guatemala,Costa Rica,0,2,CCCF Championship,2
El Salvador,Aruba,2,0,CCCF Championship,2
Curaçao,El Salvador,3,0,CCCF Championship,3
Curaçao,Cuba,2,0,CCCF Championship,2
Sweden,Finland,3,0,Nordic Championship,3
Australia,South Africa,0,3,Friendly,3
Australia,South Africa,0,2,Friendly,2
Finland,Poland,1,3,Friendly,2
Russia,India,11,1,Friendly,10
Australia,South Africa,0,8,Friendly,8
Australia,South Africa,0,6,Friendly,6
Czechoslovakia,Belgium,5,2,Friendly,3
Yugoslavia,Germany,3,1,Friendly,2
Australia,South Africa,1,4,Friendly,3
Czechoslovakia,Hungary,1,3,Central European International Cup,2
Denmark,England,1,5,Friendly,4
Kenya,Zanzibar,8,0,Friendly,8
Tanzania,Uganda,1,5,Friendly,4
Hungary,Austria,6,1,Central European International Cup,5
Republic of Ireland,Yugoslavia,1,4,Friendly,3
Ghana,Nigeria,7,0,Friendly,7
England,Northern Ireland,3,0,British Home Championship,3
Netherlands,Norway,3,0,Friendly,3
Scotland,Wales,2,0,British Home Championship,2
Brazil,Paraguay,3,0,Copa Oswaldo Cruz,3
Bulgaria,Czechoslovakia,3,0,Friendly,3
Hungary,Sweden,4,2,Friendly,2
Germany,Norway,2,0,Friendly,2
Portugal,Sweden,2,6,Friendly,4
Hungary,Italy,2,0,Central European International Cup,2
England,Spain,4,1,Friendly,3
Suriname,Trinidad and Tobago,5,2,Friendly,3
Suriname,Trinidad and Tobago,3,1,Friendly,2
Pakistan,Myanmar,4,2,Friendly,2
Suriname,Trinidad and Tobago,3,0,Friendly,3
Turkey,Portugal,3,1,Friendly,2
Egypt,Portugal,0,4,Friendly,4
Myanmar,Sri Lanka,3,1,Friendly,2
Curaçao,Martinique,3,1,Friendly,2
Curaçao,Martinique,3,1,Friendly,2
Uruguay,Paraguay,4,2,Copa América,2
Brazil,Chile,1,4,Copa América,3
Uruguay,Peru,2,0,Copa América,2
Argentina,Chile,2,0,Copa América,2
Chile,Paraguay,2,0,Copa América,2
Italy,France,2,0,Friendly,2
Turkey,Hungary,3,1,Friendly,2
Philippines,South Korea,0,2,AFC Asian Cup qualification,2
Lebanon,Hungary,1,4,Friendly,3
Mexico,Peru,0,2,Pan American Championship,2
Argentina,Chile,3,0,Pan American Championship,3
Belgium,Switzerland,1,3,Friendly,2
Brazil,Costa Rica,7,1,Pan American Championship,6
Panama,Venezuela,2,4,Friendly,2
Haiti,Venezuela,3,0,Friendly,3
Costa Rica,Peru,4,2,Pan American Championship,2
Malaysia,Cambodia,9,2,AFC Asian Cup qualification,7
France,Austria,3,1,Friendly,2
Portugal,Turkey,3,1,Friendly,2
South Korea,Philippines,3,0,AFC Asian Cup qualification,3
Italy,Brazil,3,0,Friendly,3
Martinique,Guadeloupe,3,0,Friendly,3
Vietnam Republic,Malaysia,4,0,AFC Asian Cup qualification,4
England,Brazil,4,2,Friendly,2
Netherlands,Republic of Ireland,1,4,Friendly,3
Switzerland,Czechoslovakia,1,6,Central European International Cup,5
Finland,England,1,5,Friendly,4
Hungary,Czechoslovakia,2,4,Central European International Cup,2
Russia,Denmark,5,1,Friendly,4
Germany,England,1,3,Friendly,2
Portugal,Spain,3,1,Friendly,2
Finland,Sweden,1,3,Nordic Championship,2
Paraguay,Brazil,0,2,Copa Oswaldo Cruz,2
Norway,Germany,1,3,Friendly,2
Paraguay,Brazil,2,5,Copa Oswaldo Cruz,3
Romania,Sweden,0,2,Friendly,2
Brazil,Uruguay,2,0,Atlantic Cup,2
Romania,Norway,2,0,Friendly,2
Mauritius,Réunion,8,3,Friendly,5
Brazil,Italy,2,0,Friendly,2
Denmark,Russia,2,5,Friendly,3
Madagascar,Réunion,4,2,Friendly,2
Hungary,Poland,4,1,Friendly,3
Poland,German DR,0,2,Friendly,2
Russia,Lithuania,2,0,Friendly,2
Brazil,Czechoslovakia,4,1,Friendly,3
Russia,Belarus,5,1,Friendly,4
Yugoslavia,China PR,4,0,Friendly,4
Estonia,Lithuania,0,2,Friendly,2
Russia,Belarus,4,2,Friendly,2
Lithuania,Moldova,1,4,Friendly,3
Chile,Czechoslovakia,3,0,Friendly,3
South Korea,Taiwan,2,0,AFC Asian Cup qualification,2
Yugoslavia,Indonesia,4,2,Friendly,2
Bulgaria,Romania,2,0,Friendly,2
Croatia,Indonesia,5,2,Friendly,3
South Korea,Vietnam Republic,5,3,AFC Asian Cup,2
Finland,Denmark,0,4,Nordic Championship,4
Norway,Sweden,3,1,Nordic Championship,2
Yugoslavia,Hungary,1,3,Central European International Cup,2
Hong Kong,South Korea,2,4,Friendly,2
German DR,Indonesia,3,1,Friendly,2
Austria,Luxembourg,7,0,FIFA World Cup qualification,7
China PR,North Vietnam,5,3,Friendly,2
North Korea,North Vietnam,3,0,Friendly,3
Austria,Hungary,0,2,Friendly,2
Bulgaria,German DR,3,1,Friendly,2
Vietnam Republic,Thailand,3,1,Friendly,2
Nigeria,Ghana,3,0,Friendly,3
Poland,Norway,5,3,Friendly,2
Poland,Finland,5,0,Friendly,5
Philippines,United States,0,4,Friendly,4
France,Belgium,6,3,FIFA World Cup qualification,3
England,Wales,3,1,British Home Championship,2
Indonesia,United States,7,5,Friendly,2
Germany,Switzerland,1,3,Friendly,2
Scotland,Yugoslavia,2,0,Friendly,2
Republic of Ireland,Germany,3,0,Friendly,3
Tanzania,Kenya,0,9,Friendly,9
England,Yugoslavia,3,0,Friendly,3
Uganda,Zanzibar,5,2,Friendly,3
England,Denmark,5,2,FIFA World Cup qualification,3
Australia,India,1,7,Friendly,6
Singapore,Bulgaria,2,10,Friendly,8
Germany,Belgium,4,1,Friendly,3
Indonesia,Yugoslavia,1,5,Friendly,4
India,Yugoslavia,0,3,Friendly,3
Jamaica,Trinidad and Tobago,2,0,Friendly,2
Spain,Netherlands,5,1,Friendly,4
Guatemala,Costa Rica,2,6,FIFA World Cup qualification,4
Egypt,Ethiopia,4,0,African Cup of Nations,4
Costa Rica,Guatemala,3,1,FIFA World Cup qualification,2
Costa Rica,Curaçao,4,0,FIFA World Cup qualification,4
Ecuador,Uruguay,2,5,Copa América,3
German DR,Luxembourg,3,0,Friendly,3
Argentina,Colombia,8,2,Copa América,6
Brazil,Chile,4,2,Copa América,2
Guatemala,Curaçao,1,3,FIFA World Cup qualification,2
Argentina,Ecuador,3,0,Copa América,3
Argentina,Uruguay,4,0,Copa América,4
Netherlands,Luxembourg,4,1,FIFA World Cup qualification,3
Brazil,Ecuador,7,1,Copa América,6
Peru,Uruguay,3,5,Copa América,2
Brazil,Colombia,9,0,Copa América,9
Peru,Colombia,4,1,Copa América,3
Argentina,Chile,6,2,Copa América,4
Belgium,Spain,0,5,Friendly,5
Chile,Uruguay,0,2,Copa América,2
Colombia,Ecuador,4,1,Copa América,3
Argentina,Brazil,3,0,Copa América,3
Mexico,United States,6,0,FIFA World Cup qualification,6
Peru,Argentina,1,4,Friendly,3
Austria,Switzerland,4,0,Central European International Cup,4
Martinique,Guadeloupe,6,1,Friendly,5
United States,Mexico,2,7,FIFA World Cup qualification,5
Northern Ireland,Portugal,3,0,FIFA World Cup qualification,3
England,Republic of Ireland,5,1,FIFA World Cup qualification,4
Scotland,Spain,4,2,FIFA World Cup qualification,2
Indonesia,China PR,2,0,FIFA World Cup qualification,2
Yugoslavia,Italy,6,1,Central European International Cup,5
Denmark,England,1,4,FIFA World Cup qualification,3
Guadeloupe,Martinique,5,2,Friendly,3
Germany,Scotland,1,3,Friendly,2
Czechoslovakia,Wales,2,0,FIFA World Cup qualification,2
Portugal,Italy,3,0,FIFA World Cup qualification,3
Spain,Scotland,4,1,FIFA World Cup qualification,3
France,Iceland,8,0,FIFA World Cup qualification,8
Tunisia,Libya,4,2,Friendly,2
Belgium,Iceland,8,3,FIFA World Cup qualification,5
Paraguay,Bolivia,5,2,Copa Paz del Chaco,3
Brazil,Portugal,3,0,Friendly,3
Czechoslovakia,German DR,3,1,FIFA World Cup qualification,2
Finland,Denmark,2,0,Friendly,2
Denmark,Norway,2,0,Friendly,2
Finland,Sweden,1,5,Friendly,4
Canada,United States,5,1,FIFA World Cup qualification,4
Hungary,Bulgaria,4,1,FIFA World Cup qualification,3
Russia,Poland,3,0,FIFA World Cup qualification,3
Mexico,Canada,3,0,FIFA World Cup qualification,3
Mexico,Canada,2,0,FIFA World Cup qualification,2
Finland,Poland,1,3,FIFA World Cup qualification,2
Paraguay,Colombia,3,0,FIFA World Cup qualification,3
Iceland,Norway,0,3,Friendly,3
Brazil,Argentina,2,0,Copa Roca,2
Iceland,Denmark,2,6,Friendly,4
Denmark,Norway,1,3,Friendly,2
Paraguay,Uruguay,5,0,FIFA World Cup qualification,5
Bulgaria,Russia,0,4,Friendly,4
China PR,Sudan,4,1,Friendly,3
Uruguay,Paraguay,2,0,FIFA World Cup qualification,2
Curaçao,Haiti,1,3,CCCF Championship,2
Finland,Russia,0,10,FIFA World Cup qualification,10
Curaçao,Cuba,2,0,CCCF Championship,2
Cuba,Honduras,0,2,CCCF Championship,2
Curaçao,Panama,3,0,CCCF Championship,3
Cuba,Haiti,1,6,CCCF Championship,5
Malawi,Zambia,0,5,Friendly,5
Indonesia,Thailand,4,0,Merdeka Tournament,4
Cambodia,Thailand,0,3,Merdeka Tournament,3
Finland,Norway,0,4,Nordic Championship,4
Iceland,France,1,5,FIFA World Cup qualification,4
Malaysia,Myanmar,5,2,Merdeka Tournament,3
Myanmar,Cambodia,2,0,Merdeka Tournament,2
Malaysia,Vietnam Republic,1,4,Merdeka Tournament,3
Singapore,Thailand,6,0,Merdeka Tournament,6
Tanzania,Uganda,2,4,Friendly,2
Iceland,Belgium,2,5,FIFA World Cup qualification,3
Zanzibar,Kenya,1,5,Friendly,4
Myanmar,Thailand,5,2,Merdeka Tournament,3
Indonesia,Vietnam Republic,3,1,Merdeka Tournament,2
Malaysia,Indonesia,4,2,Merdeka Tournament,2
Netherlands,Luxembourg,5,2,FIFA World Cup qualification,3
New Caledonia,Tahiti,2,4,Friendly,2
Sweden,Finland,5,1,Nordic Championship,4
Wales,German DR,4,1,FIFA World Cup qualification,3
New Caledonia,Tahiti,2,0,Friendly,2
Bolivia,Chile,3,0,FIFA World Cup qualification,3
Luxembourg,Austria,0,3,FIFA World Cup qualification,3
Denmark,Republic of Ireland,0,2,FIFA World Cup qualification,2
Bolivia,Argentina,2,0,FIFA World Cup qualification,2
Hungary,France,2,0,Friendly,2
Chile,Argentina,0,2,FIFA World Cup qualification,2
Denmark,Finland,3,0,Nordic Championship,3
Sweden,Norway,5,2,Nordic Championship,3
Wales,England,0,4,British Home Championship,4
Argentina,Chile,4,0,FIFA World Cup qualification,4
Mexico,Costa Rica,2,0,FIFA World Cup qualification,2
Mauritius,Madagascar,4,0,Friendly,4
Argentina,Bolivia,4,0,FIFA World Cup qualification,4
German DR,Czechoslovakia,1,4,FIFA World Cup qualification,3
Cambodia,Malaysia,1,3,Friendly,2
Bulgaria,Norway,7,0,FIFA World Cup qualification,7
Poland,Finland,4,0,FIFA World Cup qualification,4
Romania,Greece,3,0,FIFA World Cup qualification,3
Hungary,Norway,5,0,FIFA World Cup qualification,5
Yugoslavia,Greece,4,1,FIFA World Cup qualification,3
Netherlands,Belgium,5,2,Friendly,3
Yugoslavia,Romania,2,0,FIFA World Cup qualification,2
Poland,Russia,0,2,FIFA World Cup qualification,2
Switzerland,Spain,1,4,FIFA World Cup qualification,3
England,France,4,0,Friendly,4
Italy,Portugal,3,0,FIFA World Cup qualification,3
Israel,Wales,0,2,FIFA World Cup qualification,2
Malta,Denmark,3,0,Friendly,3
Wales,Israel,2,0,FIFA World Cup qualification,2
Ghana,Togo,5,2,Friendly,3
Malaysia,Singapore,5,2,Friendly,3
Belgium,Germany,0,2,Friendly,2
Malaysia,Singapore,3,1,Friendly,2
Germany,Spain,2,0,Friendly,2
Morocco,Libya,3,1,Friendly,2
Belgium,Netherlands,2,7,Friendly,5
Scotland,England,0,4,British Home Championship,4
Hungary,Yugoslavia,2,0,Friendly,2
Zimbabwe,Zambia,0,2,Friendly,2
Netherlands,Curaçao,8,1,Friendly,7
Argentina,Paraguay,2,0,Friendly,2
Argentina,Uruguay,2,0,Friendly,2
Brazil,Paraguay,5,1,Copa Oswaldo Cruz,4
Singapore,Malaysia,0,3,Friendly,3
Tunisia,Libya,4,1,Friendly,3
Trinidad and Tobago,Jamaica,4,0,Friendly,4
Yugoslavia,England,5,0,Friendly,5
Philippines,Indonesia,0,3,Friendly,3
Austria,Republic of Ireland,3,1,Friendly,2
Brazil,Bulgaria,4,0,Friendly,4
Malaysia,Pakistan,4,2,Friendly,2
Brazil,Bulgaria,3,1,Friendly,2
Switzerland,Belgium,0,2,Friendly,2
Argentina,Germany,1,3,FIFA World Cup,2
Austria,Brazil,0,3,FIFA World Cup,3
France,Paraguay,7,3,FIFA World Cup,4
Sweden,Mexico,3,0,FIFA World Cup,3
Argentina,Northern Ireland,3,1,FIFA World Cup,2
Austria,Russia,0,2,FIFA World Cup,2
Argentina,Czechoslovakia,1,6,FIFA World Cup,5
Brazil,Russia,2,0,FIFA World Cup,2
Hungary,Mexico,4,0,FIFA World Cup,4
Norway,Finland,2,0,Nordic Championship,2
France,Northern Ireland,4,0,FIFA World Cup,4
Sweden,Russia,2,0,FIFA World Cup,2
Brazil,France,5,2,FIFA World Cup,3
Sweden,Germany,3,1,FIFA World Cup,2
France,Germany,6,3,FIFA World Cup,3
Sweden,Brazil,2,5,FIFA World Cup,3
Singapore,Indonesia,0,5,Friendly,5
Malaysia,Indonesia,2,4,Friendly,2
Finland,Sweden,1,7,Nordic Championship,6
Indonesia,Singapore,2,0,Merdeka Tournament,2
Indonesia,Vietnam Republic,4,1,Merdeka Tournament,3
Malaysia,Vietnam Republic,2,0,Merdeka Tournament,2
New Caledonia,New Zealand,1,5,Friendly,4
Zimbabwe,Zambia,4,2,Friendly,2
Finland,Denmark,1,4,Nordic Championship,3
Norway,Sweden,0,2,Nordic Championship,2
Poland,Hungary,1,3,Friendly,2
Russia,Hungary,3,1,UEFA Euro qualification,2
France,Greece,7,1,UEFA Euro qualification,6
Kenya,Tanzania,3,1,Friendly,2
Uganda,Tanzania,2,0,Friendly,2
Kenya,Zanzibar,4,0,Friendly,4
Kenya,Uganda,2,0,Friendly,2
Netherlands,Denmark,5,1,Friendly,4
Spain,Northern Ireland,6,2,Friendly,4
Réunion,Mauritius,0,2,Friendly,2
Wales,Scotland,0,3,British Home Championship,3
Réunion,Madagascar,1,3,Friendly,2
England,Russia,5,0,Friendly,5
German DR,Norway,4,1,Friendly,3
Netherlands,Switzerland,2,0,Friendly,2
Romania,Turkey,3,0,UEFA Euro qualification,3
Netherlands,South Africa,9,3,Friendly,6
Hungary,Belgium,3,1,Friendly,2
Germany,Bulgaria,3,0,Friendly,3
Hong Kong,Japan,5,2,Friendly,3
Malaysia,Japan,6,2,Friendly,4
Malaysia,Japan,1,3,Friendly,2
Mexico,Costa Rica,3,1,Friendly,2
Trinidad and Tobago,Barbados,2,0,Friendly,2
Barbados,Jamaica,1,3,Friendly,2
Argentina,Chile,6,1,Copa América,5
Bolivia,Uruguay,0,7,Copa América,7
Argentina,Bolivia,2,0,Copa América,2
Martinique,Guadeloupe,3,0,Friendly,3
Peru,Uruguay,5,3,Copa América,2
Bolivia,Paraguay,0,5,Copa América,5
Brazil,Chile,3,0,Copa América,3
Argentina,Peru,3,1,Copa América,2
Paraguay,Uruguay,1,3,Copa América,2
Bolivia,Brazil,2,4,Copa América,2
Argentina,Paraguay,3,1,Copa América,2
Bolivia,Chile,2,5,Copa América,3
Brazil,Uruguay,3,1,Copa América,2
Brazil,Paraguay,4,1,Copa América,3
Philippines,Hong Kong,0,7,AFC Asian Cup qualification,7
Argentina,Uruguay,4,1,Copa América,3
Philippines,Taiwan,4,7,AFC Asian Cup qualification,3
Republic of Ireland,Czechoslovakia,2,0,UEFA Euro qualification,2
Hungary,Yugoslavia,4,0,Friendly,4
Northern Ireland,Wales,4,1,British Home Championship,3
Switzerland,Yugoslavia,1,5,Central European International Cup,4
Turkey,Romania,2,0,UEFA Euro qualification,2
Uruguay,Paraguay,1,3,Friendly,2
Singapore,Vietnam Republic,1,4,AFC Asian Cup qualification,3
Czechoslovakia,Republic of Ireland,4,0,UEFA Euro qualification,4
Singapore,Malaysia,2,5,AFC Asian Cup qualification,3
Brazil,England,2,0,Friendly,2
Peru,England,4,1,Friendly,3
Sweden,Portugal,2,0,Friendly,2
Egypt,Ethiopia,4,0,African Cup of Nations,4
Belgium,Austria,0,2,Friendly,2
United States,England,1,8,Friendly,7
Martinique,Suriname,3,1,Friendly,2
Martinique,Suriname,3,0,Friendly,3
Yugoslavia,Bulgaria,2,0,UEFA Euro qualification,2
Guadeloupe,Suriname,3,1,Friendly,2
Austria,Belgium,4,2,Friendly,2
Denmark,Sweden,0,6,Nordic Championship,6
German DR,Portugal,0,2,UEFA Euro qualification,2
Poland,Israel,7,2,Friendly,5
Finland,Norway,2,4,Nordic Championship,2
Poland,Spain,2,4,UEFA Euro qualification,2
Tahiti,New Caledonia,2,4,Friendly,2
Tahiti,New Caledonia,3,1,Friendly,2
Sweden,Finland,3,1,Nordic Championship,2
Hong Kong,Taiwan,1,3,Friendly,2
India,Singapore,2,0,Merdeka Tournament,2
South Korea,Singapore,4,1,Merdeka Tournament,3
Japan,Singapore,4,1,Merdeka Tournament,3
Japan,South Korea,1,3,Merdeka Tournament,2
Russia,Czechoslovakia,3,1,Friendly,2
Malaysia,South Korea,2,4,Friendly,2
India,Vietnam Republic,1,5,Friendly,4
Singapore,South Korea,0,4,Friendly,4
Brazil,Chile,7,0,Copa Bernardo O'Higgins,7
Austria,Norway,5,2,UEFA Euro qualification,3
Suriname,Martinique,4,1,Friendly,3
Northern Ireland,Scotland,0,4,British Home Championship,4
Denmark,Finland,4,0,Nordic Championship,4
Netherlands,Belgium,9,1,Friendly,8
Switzerland,Germany,0,4,Friendly,4
Kenya,Zanzibar,5,0,Friendly,5
Tanzania,Kenya,0,2,Friendly,2
Yugoslavia,Hungary,2,4,Friendly,2
Spain,Poland,3,0,UEFA Euro qualification,3
Czechoslovakia,Denmark,5,1,UEFA Euro qualification,4
Sweden,Norway,6,2,Nordic Championship,4
Germany,Netherlands,7,0,Friendly,7
North Korea,North Vietnam,5,0,Friendly,5
Hungary,Switzerland,8,0,Central European International Cup,8
China PR,North Vietnam,2,0,Friendly,2
Netherlands,Norway,7,1,Friendly,6
France,Portugal,5,3,Friendly,2
Chile,Argentina,4,2,Friendly,2
Ghana,Nigeria,5,2,Friendly,3
Spain,Austria,6,3,Friendly,3
Nigeria,Benin,10,1,Friendly,9
Greece,Denmark,1,3,Friendly,2
Iran,Israel,3,0,AFC Asian Cup qualification,3
Ecuador,Uruguay,0,4,Copa América,4
India,Israel,1,3,AFC Asian Cup qualification,2
Argentina,Paraguay,4,2,Copa América,2
Israel,Pakistan,2,0,AFC Asian Cup qualification,2
Brazil,Uruguay,0,3,Copa América,3
France,Austria,5,2,UEFA Euro qualification,3
Costa Rica,Honduras,6,1,Friendly,5
Argentina,Uruguay,0,5,Copa América,5
Ecuador,Brazil,1,3,Copa América,2
Argentina,Brazil,4,1,Copa América,3
Ecuador,Paraguay,3,1,Copa América,2
Morocco,Yugoslavia,0,5,Friendly,5
Tunisia,Yugoslavia,1,5,Friendly,4
Italy,Switzerland,3,0,Central European International Cup,3
Ghana,Sierra Leone,6,2,Friendly,4
Costa Rica,Curaçao,4,0,CCCF Championship,4
Costa Rica,Brazil,3,0,Pan American Championship,3
Spain,Italy,3,1,Friendly,2
Costa Rica,Argentina,0,2,Pan American Championship,2
France,Chile,6,0,Friendly,6
Argentina,Mexico,2,0,Pan American Championship,2
Costa Rica,Brazil,0,4,Pan American Championship,4
Austria,France,2,4,UEFA Euro qualification,2
Belgium,Switzerland,3,1,Friendly,2
Republic of Ireland,Chile,2,0,Friendly,2
Netherlands,Bulgaria,4,2,Friendly,2
Switzerland,Chile,4,2,Friendly,2
Cameroon,Djibouti,9,2,Friendly,7
Madagascar,Burkina Faso,6,1,Friendly,5
Indonesia,Malaysia,5,0,Friendly,5
Egypt,Brazil,0,5,Friendly,5
Czechoslovakia,Austria,4,0,Friendly,4
Egypt,Brazil,1,3,Friendly,2
Singapore,India,3,0,Friendly,3
Egypt,Brazil,0,3,Friendly,3
Spain,England,3,0,Friendly,3
Sweden,Republic of Ireland,4,1,Friendly,3
Switzerland,Netherlands,3,1,Friendly,2
Russia,Poland,7,1,Friendly,6
Bulgaria,Belgium,4,1,Friendly,3
Hungary,England,2,0,Friendly,2
Romania,Czechoslovakia,0,2,UEFA Euro qualification,2
Yugoslavia,Portugal,5,1,UEFA Euro qualification,4
Argentina,Brazil,4,2,Copa Roca,2
Denmark,Norway,3,0,Nordic Championship,3
Argentina,Brazil,1,4,Copa Roca,3
Austria,Scotland,4,1,Friendly,3
Czechoslovakia,Romania,3,0,UEFA Euro qualification,3
Turkey,Scotland,4,2,Friendly,2
Norway,Iceland,4,0,Friendly,4
Finland,Sweden,0,3,Nordic Championship,3
Mexico,Netherlands,3,1,Friendly,2
Poland,Bulgaria,4,0,Friendly,4
Brazil,Chile,4,0,Friendly,4
Denmark,Greece,7,2,Friendly,5
Czechoslovakia,Russia,0,3,UEFA Euro,3
France,Czechoslovakia,0,2,UEFA Euro,2
Bulgaria,German DR,2,0,Friendly,2
Peru,Spain,1,3,Friendly,2
Brazil,Argentina,5,1,Atlantic Cup,4
Chile,Spain,0,4,Friendly,4
Chile,Spain,1,4,Friendly,3
Argentina,Spain,2,0,Friendly,2
Iceland,Germany,0,5,Friendly,5
Malaysia,Japan,3,0,Merdeka Tournament,3
Pakistan,Thailand,7,0,Merdeka Tournament,7
South Korea,Indonesia,2,0,Merdeka Tournament,2
Yugoslavia,Tunisia,7,0,Friendly,7
Malaysia,Thailand,8,2,Merdeka Tournament,6
Indonesia,Singapore,8,3,Merdeka Tournament,5
Pakistan,Japan,3,1,Merdeka Tournament,2
Japan,Thailand,3,1,Merdeka Tournament,2
Indonesia,Vietnam Republic,5,3,Merdeka Tournament,2
Indonesia,Pakistan,4,0,Merdeka Tournament,4
Argentina,Uruguay,4,0,Atlantic Cup,4
Singapore,Pakistan,4,1,Friendly,3
Indonesia,Pakistan,5,2,Friendly,3
Ghana,Nigeria,4,1,FIFA World Cup qualification,3
Norway,Finland,6,3,Nordic Championship,3
Austria,Russia,3,1,Friendly,2
Tahiti,New Zealand,1,5,Friendly,4
Costa Rica,Honduras,5,0,FIFA World Cup qualification,5
Norway,Sweden,3,1,Nordic Championship,2
Trinidad and Tobago,Martinique,3,1,Friendly,2
Belgium,Netherlands,1,4,Friendly,3
Ghana,Mali,5,1,Friendly,4
Nigeria,Guinea-Bissau,4,1,Friendly,3
North Vietnam,Mongolia,3,1,Friendly,2
China PR,Mongolia,6,1,Friendly,5
North Vietnam,North Korea,1,3,Friendly,2
Northern Ireland,England,2,5,British Home Championship,3
Nigeria,Ghana,0,3,Friendly,3
Kenya,Zanzibar,4,1,Friendly,3
Mongolia,North Korea,1,10,Friendly,9
Uganda,Zanzibar,3,0,Friendly,3
Kenya,Tanzania,5,0,Friendly,5
Switzerland,France,6,2,Friendly,4
South Korea,Vietnam Republic,5,1,AFC Asian Cup,4
Tanzania,Zanzibar,4,2,Friendly,2
Taiwan,Vietnam Republic,2,0,AFC Asian Cup,2
South Korea,Israel,3,0,AFC Asian Cup,3
Israel,Vietnam Republic,5,1,AFC Asian Cup,4
Luxembourg,England,0,9,FIFA World Cup qualification,9
Sweden,Belgium,2,0,FIFA World Cup qualification,2
Wales,Scotland,2,0,British Home Championship,2
Sweden,Denmark,2,0,Nordic Championship,2
England,Spain,4,2,Friendly,2
Austria,Spain,3,0,Friendly,3
Czechoslovakia,Netherlands,4,0,Friendly,4
German DR,Finland,5,1,Friendly,4
Republic of Ireland,Norway,3,1,Friendly,2
Mexico,United States,3,0,FIFA World Cup qualification,3
Scotland,Northern Ireland,5,2,British Home Championship,3
Hungary,Poland,4,1,Friendly,3
Belgium,Switzerland,2,4,FIFA World Cup qualification,2
Greece,Germany,0,3,FIFA World Cup qualification,3
Hungary,Austria,2,0,Friendly,2
England,Wales,5,1,British Home Championship,4
Israel,Cyprus,6,1,FIFA World Cup qualification,5
Ecuador,Argentina,3,6,FIFA World Cup qualification,3
Tunisia,German DR,0,3,Friendly,3
France,Bulgaria,3,0,FIFA World Cup qualification,3
Argentina,Ecuador,5,0,FIFA World Cup qualification,5
Chile,Paraguay,4,1,Friendly,3
Chile,Paraguay,3,1,Friendly,2
Saint Lucia,Dominica,4,1,Windward Islands Tournament,3
Grenada,Saint Vincent and the Grenadines,3,6,Windward Islands Tournament,3
Saint Lucia,Grenada,0,4,Windward Islands Tournament,4
Dominica,Grenada,1,8,Windward Islands Tournament,7
Colombia,United States,2,0,Friendly,2
Egypt,Hungary,0,2,Friendly,2
Costa Rica,Cuba,4,1,CCCF Championship,3
Ghana,Mali,3,0,Friendly,3
Guatemala,Haiti,1,3,CCCF Championship,2
Curaçao,Honduras,2,4,CCCF Championship,2
Cuba,Guatemala,0,2,CCCF Championship,2
Haiti,Panama,3,1,CCCF Championship,2
Haiti,Honduras,0,2,CCCF Championship,2
Chile,Peru,5,2,Friendly,3
Portugal,Luxembourg,6,0,FIFA World Cup qualification,6
Netherlands,Belgium,6,2,Friendly,4
Panama,Haiti,0,3,Friendly,3
Panama,Haiti,0,2,Friendly,2
Chile,Germany,3,1,Friendly,2
Costa Rica,Curaçao,6,0,FIFA World Cup qualification,6
Spain,France,2,0,Friendly,2
Mexico,Curaçao,7,0,FIFA World Cup qualification,7
Mexico,Costa Rica,4,1,FIFA World Cup qualification,3
Northern Ireland,Wales,1,5,British Home Championship,4
England,Scotland,9,3,British Home Championship,6
Hungary,German DR,2,0,FIFA World Cup qualification,2
Sierra Leone,Nigeria,1,4,Friendly,3
Curaçao,Costa Rica,2,0,FIFA World Cup qualification,2
Netherlands,Hungary,0,3,FIFA World Cup qualification,3
Paraguay,Brazil,0,2,Copa Oswaldo Cruz,2
Scotland,Republic of Ireland,4,1,FIFA World Cup qualification,3
Republic of Ireland,Scotland,0,3,FIFA World Cup qualification,3
Yugoslavia,Hungary,2,4,Friendly,2
England,Mexico,8,0,Friendly,8
Czechoslovakia,Scotland,4,0,FIFA World Cup qualification,4
Austria,England,3,1,Friendly,2
Sweden,Switzerland,4,0,FIFA World Cup qualification,4
Ghana,Nigeria,3,0,Friendly,3
Portugal,Argentina,0,2,Friendly,2
Japan,South Korea,0,2,FIFA World Cup qualification,2
Spain,Argentina,2,0,Friendly,2
Italy,Argentina,4,1,Friendly,3
Finland,Bulgaria,0,2,FIFA World Cup qualification,2
Finland,Norway,4,1,Nordic Championship,3
Russia,Norway,5,2,FIFA World Cup qualification,3
Malaysia,Vietnam Republic,3,1,Merdeka Tournament,2
India,Japan,1,3,Merdeka Tournament,2
Sweden,Finland,4,0,Nordic Championship,4
Singapore,Thailand,5,3,Merdeka Tournament,2
Indonesia,Japan,2,0,Friendly,2
India,Vietnam Republic,1,3,Friendly,2
Norway,Russia,0,3,FIFA World Cup qualification,3
New Caledonia,Tahiti,3,0,Friendly,3
Norway,Denmark,0,4,Nordic Championship,4
Germany,Denmark,5,1,Friendly,4
England,Luxembourg,4,1,FIFA World Cup qualification,3
France,Finland,5,1,FIFA World Cup qualification,4
Tanzania,Uganda,3,1,Friendly,2
Belgium,Sweden,0,2,FIFA World Cup qualification,2
Kenya,Zanzibar,10,0,Friendly,10
Tanzania,Zanzibar,3,0,Friendly,3
Northern Ireland,Scotland,1,6,British Home Championship,5
Republic of Ireland,Czechoslovakia,1,3,FIFA World Cup qualification,2
Luxembourg,Portugal,4,2,FIFA World Cup qualification,2
Poland,Germany,0,2,Friendly,2
Romania,Turkey,4,0,Friendly,4
Yugoslavia,South Korea,5,1,FIFA World Cup qualification,4
Argentina,Paraguay,5,1,Friendly,4
Denmark,Finland,9,1,Nordic Championship,8
Israel,Italy,2,4,FIFA World Cup qualification,2
Northern Ireland,Greece,2,0,FIFA World Cup qualification,2
Belgium,France,3,0,Friendly,3
Vietnam Republic,Indonesia,4,1,Vietnam Independence Cup,3
Poland,German DR,3,1,Friendly,2
Sweden,Norway,2,0,Nordic Championship,2
Indonesia,Malaysia,1,3,Vietnam Independence Cup,2
England,Portugal,2,0,FIFA World Cup qualification,2
Myanmar,South Korea,3,0,Friendly,3
Bulgaria,Finland,3,1,FIFA World Cup qualification,2
Czechoslovakia,Republic of Ireland,7,1,FIFA World Cup qualification,6
Uganda,Kenya,2,0,African Cup of Nations qualification,2
Italy,Israel,6,0,FIFA World Cup qualification,6
Poland,Denmark,5,0,Friendly,5
Scotland,Wales,2,0,British Home Championship,2
Netherlands,Belgium,0,4,Friendly,4
South Korea,Yugoslavia,1,3,FIFA World Cup qualification,2
Czechoslovakia,Scotland,4,2,FIFA World Cup qualification,2
Kenya,Zanzibar,4,0,Friendly,4
Panama,Venezuela,2,6,Friendly,4
Uganda,Zanzibar,2,0,Friendly,2
Indonesia,Yugoslavia,1,5,Friendly,4
Kenya,Uganda,4,1,Friendly,3
Chile,Hungary,5,1,Friendly,4
Tanzania,Kenya,1,3,Friendly,2
Morocco,German DR,2,0,Friendly,2
Panama,Venezuela,0,3,Friendly,3
Israel,Yugoslavia,0,2,Friendly,2
Ghana,Nigeria,5,1,Friendly,4
Belgium,Bulgaria,4,0,Friendly,4
Ethiopia,Kenya,6,1,Friendly,5
Ethiopia,Tunisia,4,2,African Cup of Nations,2
Tunisia,Uganda,3,0,African Cup of Nations,3
Ethiopia,Egypt,4,2,African Cup of Nations,2
Mali,Ivory Coast,4,0,Friendly,4
Mali,Ivory Coast,0,2,Friendly,2
Libya,Tunisia,6,3,Friendly,3
Belgium,Netherlands,3,1,Friendly,2
England,Austria,3,1,Friendly,2
Sweden,Czechoslovakia,3,1,Friendly,2
France,Poland,1,3,Friendly,2
Germany,Uruguay,3,0,Friendly,3
Luxembourg,Russia,1,3,Friendly,2
Wales,Northern Ireland,4,0,British Home Championship,4
Scotland,England,2,0,British Home Championship,2
Morocco,Poland,1,3,Friendly,2
Sweden,Russia,0,2,Friendly,2
Brazil,Paraguay,6,0,Copa Oswaldo Cruz,6
Czechoslovakia,Uruguay,3,1,Friendly,2
Brazil,Paraguay,4,0,Copa Oswaldo Cruz,4
Russia,Uruguay,5,0,Friendly,5
Austria,Bulgaria,2,0,Friendly,2
England,Switzerland,3,1,Friendly,2
Netherlands,Northern Ireland,4,0,Friendly,4
Brazil,Wales,3,1,Friendly,2
Belgium,Italy,1,3,Friendly,2
Brazil,Wales,3,1,Friendly,2
Yugoslavia,German DR,3,1,Friendly,2
Peru,England,0,4,Friendly,4
Jamaica,Haiti,1,3,Friendly,2
German DR,Denmark,4,1,Friendly,3
Jamaica,Haiti,2,5,Friendly,3
Poland,Belgium,2,0,Friendly,2
Brazil,Mexico,2,0,FIFA World Cup,2
Chile,Switzerland,3,1,FIFA World Cup,2
Russia,Yugoslavia,2,0,FIFA World Cup,2
Argentina,England,1,3,FIFA World Cup,2
Chile,Italy,2,0,FIFA World Cup,2
New Zealand,New Caledonia,4,1,Friendly,3
Uruguay,Yugoslavia,1,3,FIFA World Cup,2
Bulgaria,Hungary,1,6,FIFA World Cup,5
New Zealand,New Caledonia,4,2,Friendly,2
Chile,Germany,0,2,FIFA World Cup,2
Colombia,Yugoslavia,0,5,FIFA World Cup,5
Czechoslovakia,Mexico,1,3,FIFA World Cup,2
Italy,Switzerland,3,0,FIFA World Cup,3
Singapore,Hong Kong,2,6,Friendly,4
Brazil,England,3,1,FIFA World Cup,2
Denmark,Norway,6,1,Nordic Championship,5
Chile,Brazil,2,4,FIFA World Cup,2
Czechoslovakia,Yugoslavia,3,1,FIFA World Cup,2
Brazil,Czechoslovakia,3,1,FIFA World Cup,2
Finland,Sweden,0,3,Nordic Championship,3
Norway,Sweden,0,2,UEFA Euro qualification,2
Denmark,Malta,6,1,UEFA Euro qualification,5
Norway,Malta,5,0,Friendly,5
Kenya,Zanzibar,5,0,Friendly,5
Iceland,Norway,1,3,Friendly,2
Gabon,Congo,3,1,Friendly,2
Thailand,Taiwan,4,0,Friendly,4
Bolivia,Paraguay,3,1,Copa Paz del Chaco,2
Republic of Ireland,Iceland,4,2,UEFA Euro qualification,2
Argentina,Uruguay,3,1,Copa Lipton,2
Suriname,Guadeloupe,3,1,Friendly,2
Uganda,Kenya,3,1,Friendly,2
Poland,Hungary,0,2,Friendly,2
Netherlands,Curaçao,8,0,Friendly,8
Denmark,Curaçao,3,1,Friendly,2
Indonesia,Singapore,2,0,Merdeka Tournament,2
Indonesia,Philippines,9,0,Merdeka Tournament,9
Philippines,Singapore,0,5,Merdeka Tournament,5
Myanmar,Japan,3,1,Merdeka Tournament,2
Austria,Czechoslovakia,0,6,Friendly,6
Congo,Gabon,3,1,Friendly,2
Finland,Denmark,1,6,Nordic Championship,5
Philippines,Vietnam Republic,0,6,Merdeka Tournament,6
Yugoslavia,Ethiopia,5,2,Friendly,3
Denmark,Netherlands,4,1,Friendly,3
Ghana,Kenya,6,3,Friendly,3
Romania,Morocco,4,0,Friendly,4
Poland,Northern Ireland,0,2,UEFA Euro qualification,2
Turkey,Ethiopia,3,0,Friendly,3
Uganda,Ghana,1,4,Friendly,3
Kenya,Ghana,0,4,Friendly,4
South Korea,Indonesia,2,0,Friendly,2
Belgium,Netherlands,2,0,Friendly,2
South Korea,Indonesia,2,0,Friendly,2
Malawi,Ghana,0,12,Friendly,12
Suriname,French Guiana,4,2,Friendly,2
Tanzania,Ghana,2,6,Friendly,4
Northern Ireland,England,1,3,British Home Championship,2
Vietnam Republic,Indonesia,4,0,Vietnam Independence Cup,4
Malaysia,Thailand,4,2,Vietnam Independence Cup,2
Hungary,Austria,2,0,Friendly,2
Sweden,Denmark,4,2,Nordic Championship,2
Indonesia,Thailand,7,0,Vietnam Independence Cup,7
Vietnam Republic,Malaysia,2,0,Vietnam Independence Cup,2
Vietnam Republic,Indonesia,2,0,Vietnam Independence Cup,2
Spain,Romania,6,0,UEFA Euro qualification,6
Tanzania,Uganda,3,1,Friendly,2
Kenya,Uganda,4,1,Friendly,3
Bulgaria,Portugal,3,1,UEFA Euro qualification,2
Hungary,Wales,3,1,UEFA Euro qualification,2
Scotland,Northern Ireland,5,1,British Home Championship,4
Guadeloupe,Martinique,3,1,Friendly,2
Netherlands,Switzerland,3,1,UEFA Euro qualification,2
Puerto Rico,Martinique,1,6,Friendly,5
England,Wales,4,0,British Home Championship,4
Puerto Rico,Guadeloupe,0,3,Friendly,3
Israel,Turkey,0,2,Friendly,2
Romania,Spain,3,1,UEFA Euro qualification,2
Indonesia,Sweden,0,3,Friendly,3
Northern Ireland,Poland,2,0,UEFA Euro qualification,2
Italy,Turkey,6,0,UEFA Euro qualification,6
Malta,Denmark,1,3,UEFA Euro qualification,2
Nigeria,Cameroon,3,1,Friendly,2
Tanzania,Malawi,6,2,Friendly,4
Tanzania,Zanzibar,6,0,Friendly,6
Portugal,Bulgaria,3,1,UEFA Euro qualification,2
Germany,Switzerland,5,1,Friendly,4
Morocco,Romania,3,1,Friendly,2
Central African Republic,Cameroon,1,4,Friendly,3
Congo,Madagascar,6,1,Friendly,5
Cameroon,Congo,0,3,Friendly,3
Central African Republic,Madagascar,4,1,Friendly,3
Myanmar,China PR,0,3,Friendly,3
Uganda,Zanzibar,8,0,Friendly,8
Nigeria,Benin,4,1,Friendly,3
Pakistan,China PR,0,2,Friendly,2
Paraguay,Bolivia,3,0,Copa Paz del Chaco,3
Paraguay,Bolivia,5,1,Copa Paz del Chaco,4
Mali,Senegal,3,1,Friendly,2
France,England,5,2,UEFA Euro qualification,3
Nigeria,Senegal,4,0,Friendly,4
Ghana,Mali,4,0,Friendly,4
Jamaica,Haiti,0,3,Friendly,3
Argentina,Colombia,4,2,Copa América,2
Ivory Coast,Tunisia,3,0,Friendly,3
Brazil,Colombia,5,1,Copa América,4
Ecuador,Paraguay,1,3,Copa América,2
Brazil,Paraguay,0,2,Copa América,2
Argentina,Ecuador,4,2,Copa América,2
El Salvador,Nicaragua,6,1,CONCACAF Championship,5
Argentina,Brazil,3,0,Copa América,3
Bolivia,Paraguay,2,0,Copa América,2
Costa Rica,Jamaica,6,0,CONCACAF Championship,6
Uganda,Ethiopia,1,7,Friendly,6
Guatemala,Nicaragua,3,1,CONCACAF Championship,2
Paraguay,Peru,4,1,Copa América,3
Jamaica,Mexico,0,8,CONCACAF Championship,8
Nicaragua,Panama,0,5,CONCACAF Championship,5
Lebanon,Kuwait,6,0,Arab Cup,6
Syria,Jordan,4,0,Arab Cup,4
Suriname,Trinidad and Tobago,3,1,Friendly,2
Kuwait,Jordan,4,0,Arab Cup,4
Honduras,Curaçao,1,4,CONCACAF Championship,3
El Salvador,Costa Rica,1,4,CONCACAF Championship,3
Northern Ireland,Wales,1,4,British Home Championship,3
Jordan,Tunisia,0,4,Arab Cup,4
El Salvador,Honduras,3,0,CONCACAF Championship,3
Kuwait,Tunisia,1,5,Arab Cup,4
Lebanon,Jordan,5,0,Arab Cup,5
Kuwait,Syria,0,4,Arab Cup,4
Brazil,Argentina,5,2,Copa Roca,3
Guadeloupe,Martinique,3,0,Friendly,3
Guadeloupe,Puerto Rico,3,0,Friendly,3
Austria,Czechoslovakia,3,1,Friendly,2
Belgium,Brazil,5,1,Friendly,4
Indonesia,Egypt,1,3,Friendly,2
Cambodia,China PR,0,6,Friendly,6
Egypt,China PR,2,0,Friendly,2
Indonesia,North Vietnam,3,1,Friendly,2
Tanzania,Ethiopia,0,2,Friendly,2
Scotland,Austria,4,1,Friendly,3
Italy,Brazil,3,0,Friendly,3
Norway,Poland,2,5,Friendly,3
Hungary,Denmark,6,0,Friendly,6
Israel,Brazil,0,5,Friendly,5
Poland,Greece,4,0,Friendly,4
Zanzibar,Ethiopia,0,4,Friendly,4
Czechoslovakia,England,2,4,Friendly,2
Switzerland,England,1,8,Friendly,7
Tunisia,Lebanon,2,0,Friendly,2
Spain,Scotland,2,6,Friendly,4
Ethiopia,Sudan,4,0,Friendly,4
Tunisia,Morocco,4,1,African Cup of Nations qualification,3
Finland,Norway,2,0,Nordic Championship,2
Denmark,Albania,4,0,UEFA Euro qualification,4
Sudan,Kenya,5,0,African Cup of Nations qualification,5
Morocco,Tunisia,4,2,African Cup of Nations qualification,2
Zambia,Malawi,5,1,Friendly,4
Thailand,Japan,1,4,Merdeka Tournament,3
South Korea,Thailand,5,1,Merdeka Tournament,4
Malaysia,Vietnam Republic,0,5,Merdeka Tournament,5
Vietnam Republic,Japan,1,5,Merdeka Tournament,4
South Korea,Vietnam Republic,3,1,Merdeka Tournament,2
Taiwan,Japan,2,0,Merdeka Tournament,2
Malaysia,South Korea,3,0,Merdeka Tournament,3
Fiji,Papua New Guinea,3,1,South Pacific Games,2
Solomon Islands,Vanuatu,6,3,South Pacific Games,3
Fiji,Solomon Islands,5,0,South Pacific Games,5
China PR,Myanmar,4,0,Friendly,4
Poland,Norway,9,0,Friendly,9
Solomon Islands,Tahiti,0,18,South Pacific Games,18
Fiji,New Caledonia,2,8,South Pacific Games,6
Mauritius,Réunion,0,2,Friendly,2
Madagascar,Réunion,6,1,Friendly,5
Norway,Denmark,0,4,Nordic Championship,4
Martinique,Puerto Rico,6,0,Friendly,6
Germany,Turkey,3,0,Friendly,3
Kenya,Tanzania,4,1,Friendly,3
Uganda,Zanzibar,2,0,Friendly,2
Yugoslavia,Hungary,2,0,Friendly,2
Wales,England,0,4,British Home Championship,4
Russia,Italy,2,0,UEFA Euro qualification,2
Paraguay,Argentina,0,4,Copa Chevallier Boutell,4
Greece,Poland,3,1,Friendly,2
France,Bulgaria,3,1,UEFA Euro qualification,2
Nigeria,Liberia,3,0,Friendly,3
Switzerland,Norway,0,2,Friendly,2
Yugoslavia,Czechoslovakia,2,0,Friendly,2
Scotland,Norway,6,1,Friendly,5
North Korea,Somalia,14,0,Friendly,14
China PR,Mali,3,1,Friendly,2
Egypt,North Vietnam,4,1,Friendly,3
Laos,North Vietnam,1,9,Friendly,8
Egypt,Laos,15,0,Friendly,15
Egypt,Saudi Arabia,7,0,Friendly,7
Indonesia,North Korea,1,5,Friendly,4
North Korea,North Vietnam,2,0,Friendly,2
England,Northern Ireland,8,3,British Home Championship,5
Egypt,Nigeria,6,3,African Cup of Nations,3
Ghana,Ethiopia,2,0,African Cup of Nations,2
Cyprus,Greece,3,1,Friendly,2
Ethiopia,Tunisia,4,2,African Cup of Nations,2
Nigeria,Sudan,0,4,African Cup of Nations,4
Egypt,Ethiopia,3,0,African Cup of Nations,3
Ghana,Sudan,3,0,African Cup of Nations,3
Kenya,Tanzania,6,2,Friendly,4
Vietnam Republic,Malaysia,5,3,AFC Asian Cup qualification,2
Malaysia,Thailand,3,1,AFC Asian Cup qualification,2
Vietnam Republic,Hong Kong,1,4,AFC Asian Cup qualification,3
Tanzania,Uganda,0,5,Friendly,5
Vietnam Republic,Thailand,3,0,AFC Asian Cup qualification,3
Philippines,Taiwan,0,7,Friendly,7
Myanmar,German DR,1,5,Friendly,4
Morocco,Germany,1,4,Friendly,3
Cameroon,Guinea,1,5,Friendly,4
Algeria,Germany,2,0,Friendly,2
Hong Kong,Israel,0,3,Friendly,3
Saint Lucia,Dominica,4,2,Windward Islands Tournament,2
Sri Lanka,German DR,1,12,Friendly,11
Saint Lucia,Dominica,5,0,Windward Islands Tournament,5
Cameroon,Benin,2,4,Friendly,2
Cameroon,Congo,7,1,Friendly,6
Ghana,German DR,3,0,Friendly,3
Sri Lanka,Indonesia,3,9,Friendly,6
Sri Lanka,Indonesia,1,4,Friendly,3
Spain,Republic of Ireland,5,1,UEFA Euro qualification,4
Congo,Chad,11,0,Friendly,11
Republic of Ireland,Spain,0,2,UEFA Euro qualification,2
Guyana,Trinidad and Tobago,1,6,Friendly,5
Guyana,Trinidad and Tobago,1,4,Friendly,3
Switzerland,Belgium,2,0,Friendly,2
France,Hungary,1,3,UEFA Euro qualification,2
Northern Ireland,Uruguay,3,0,Friendly,3
Poland,Republic of Ireland,3,1,Friendly,2
Switzerland,Italy,1,3,Friendly,2
Greece,Ethiopia,3,1,Friendly,2
Norway,Republic of Ireland,1,4,Friendly,3
Austria,Uruguay,0,2,Friendly,2
Republic of Ireland,England,1,3,Friendly,2
Netherlands,Albania,2,0,FIFA World Cup qualification,2
India,South Korea,2,0,AFC Asian Cup,2
Russia,Sweden,3,1,UEFA Euro qualification,2
United States,England,0,10,Friendly,10
Israel,India,2,0,AFC Asian Cup,2
Brazil,England,5,1,Friendly,4
Argentina,Portugal,2,0,Friendly,2
Hong Kong,India,1,3,AFC Asian Cup,2
Brazil,Argentina,0,3,Friendly,3
French Guiana,Suriname,3,1,Friendly,2
Brazil,Portugal,4,1,Friendly,3
Finland,Germany,1,4,Friendly,3
Denmark,Russia,0,3,UEFA Euro,3
Hungary,Denmark,3,1,UEFA Euro,2
Sweden,Denmark,4,1,Nordic Championship,3
Zambia,Tanzania,3,0,Friendly,3
Malawi,Zambia,0,5,Friendly,5
Cameroon,Congo,3,1,Friendly,2
Norway,Finland,2,0,Nordic Championship,2
Malaysia,Thailand,3,0,Merdeka Tournament,3
Cambodia,Taiwan,0,4,Merdeka Tournament,4
Iceland,Finland,0,2,Friendly,2
Cambodia,India,0,4,Merdeka Tournament,4
Malaysia,Myanmar,0,3,Merdeka Tournament,3
Myanmar,Taiwan,2,4,Merdeka Tournament,2
Malaysia,Taiwan,5,2,Merdeka Tournament,3
India,Taiwan,6,4,Friendly,2
Kenya,Zanzibar,5,1,Friendly,4
Tahiti,New Caledonia,0,2,Friendly,2
Martinique,Puerto Rico,4,0,Friendly,4
Guadeloupe,Puerto Rico,4,0,Friendly,4
Argentina,Chile,5,0,Copa Carlos Dittborn,5
Tahiti,New Caledonia,4,1,Friendly,3
Yugoslavia,Luxembourg,3,1,FIFA World Cup qualification,2
Tanzania,Zanzibar,3,1,Friendly,2
Tanzania,Uganda,3,0,Friendly,3
Luxembourg,France,0,2,FIFA World Cup qualification,2
Switzerland,Hungary,0,2,Friendly,2
Uganda,Burundi,7,5,Friendly,2
Denmark,Norway,2,0,Nordic Championship,2
Zambia,Uganda,0,2,Friendly,2
Ghana,Kenya,7,1,Friendly,6
Scotland,Finland,3,1,FIFA World Cup qualification,2
Ghana,Uganda,2,0,Friendly,2
Albania,Netherlands,0,2,FIFA World Cup qualification,2
Israel,Yugoslavia,2,0,Friendly,2
Turkey,Tunisia,4,1,Friendly,3
Italy,Finland,6,1,FIFA World Cup qualification,5
Luxembourg,Norway,0,2,FIFA World Cup qualification,2
Kuwait,Jordan,2,0,Arab Cup,2
Jordan,Libya,2,5,Arab Cup,3
Paraguay,Argentina,3,0,Copa Chevallier Boutell,3
Greece,Denmark,4,2,FIFA World Cup qualification,2
Belgium,France,3,0,Friendly,3
Italy,Denmark,3,1,Friendly,2
Argentina,Paraguay,8,1,Copa Chevallier Boutell,7
Greece,Wales,2,0,FIFA World Cup qualification,2
Kenya,Zambia,4,2,Friendly,2
Kenya,Zambia,2,8,Friendly,6
Uruguay,German DR,0,2,Friendly,2
Togo,DR Congo,0,3,Friendly,3
Jamaica,Cuba,2,0,FIFA World Cup qualification,2
Ivory Coast,DR Congo,2,0,African Cup of Nations qualification,2
Jamaica,Curaçao,2,0,FIFA World Cup qualification,2
Portugal,Turkey,5,1,FIFA World Cup qualification,4
Congo,DR Congo,0,3,Friendly,3
Trinidad and Tobago,Suriname,4,1,FIFA World Cup qualification,3
Costa Rica,Trinidad and Tobago,4,0,FIFA World Cup qualification,4
Senegal,Guinea,2,0,African Cup of Nations qualification,2
Suriname,Costa Rica,1,3,FIFA World Cup qualification,2
Mexico,Honduras,3,0,FIFA World Cup qualification,3
El Salvador,Nicaragua,4,0,CONCACAF Championship qualification,4
Guatemala,Paraguay,1,4,Friendly,3
Hong Kong,Japan,1,4,Friendly,3
Honduras,Nicaragua,0,2,CONCACAF Championship qualification,2
Kuwait,Morocco,0,2,Friendly,2
Mexico,United States,2,0,FIFA World Cup qualification,2
El Salvador,Honduras,3,1,CONCACAF Championship qualification,2
Guatemala,Paraguay,0,3,Friendly,3
Libya,Kuwait,4,1,Friendly,3
Suriname,Trinidad and Tobago,6,1,FIFA World Cup qualification,5
Wales,Greece,4,1,FIFA World Cup qualification,3
Cyprus,Lebanon,2,0,Friendly,2
Republic of Ireland,Belgium,0,2,Friendly,2
Singapore,Japan,1,4,Friendly,3
Costa Rica,Curaçao,6,0,CONCACAF Championship,6
El Salvador,Mexico,0,2,CONCACAF Championship,2
Guatemala,Haiti,3,0,CONCACAF Championship,3
Costa Rica,Haiti,3,1,CONCACAF Championship,2
Guinea,Senegal,3,1,African Cup of Nations qualification,2
Northern Ireland,Wales,0,5,British Home Championship,5
Mexico,Curaçao,5,0,CONCACAF Championship,5
Guatemala,El Salvador,4,1,CONCACAF Championship,3
Haiti,Mexico,0,3,CONCACAF Championship,3
Albania,Switzerland,0,2,FIFA World Cup qualification,2
El Salvador,Haiti,3,1,CONCACAF Championship,2
Ghana,DR Congo,4,1,Friendly,3
Chile,Peru,4,1,Copa del Pacífico,3
Ethiopia,Uganda,2,0,African Cup of Nations qualification,2
Mali,Senegal,0,2,African Cup of Nations qualification,2
Germany,Cyprus,5,0,FIFA World Cup qualification,5
Indonesia,Sri Lanka,5,0,Friendly,5
Italy,Wales,4,1,Friendly,3
Uganda,Sudan,1,3,African Cup of Nations qualification,2
Uruguay,Paraguay,4,0,Copa Artigas,4
Romania,Turkey,3,0,FIFA World Cup qualification,3
Senegal,Mali,3,1,African Cup of Nations qualification,2
Sweden,Cyprus,3,0,FIFA World Cup qualification,3
Mexico,Jamaica,8,0,FIFA World Cup qualification,8
Northern Ireland,Albania,4,1,FIFA World Cup qualification,3
Bulgaria,Turkey,4,1,Friendly,3
Costa Rica,Jamaica,7,0,FIFA World Cup qualification,7
Norway,Thailand,7,0,Friendly,7
Russia,Greece,3,1,FIFA World Cup qualification,2
Uruguay,Venezuela,5,0,FIFA World Cup qualification,5
Norway,Luxembourg,4,2,FIFA World Cup qualification,2
Venezuela,Uruguay,1,3,FIFA World Cup qualification,2
Brazil,Belgium,5,0,Friendly,5
Venezuela,Peru,3,6,FIFA World Cup qualification,3
Brazil,Germany,2,0,Friendly,2
Denmark,Finland,3,1,Nordic Championship,2
Bulgaria,Israel,4,0,FIFA World Cup qualification,4
Norway,Yugoslavia,3,0,FIFA World Cup qualification,3
Algeria,Brazil,0,3,Friendly,3
Finland,Italy,0,2,FIFA World Cup qualification,2
Congo,Benin,1,6,Friendly,5
Russia,Denmark,6,0,FIFA World Cup qualification,6
Russia,Brazil,0,3,Friendly,3
Iceland,Denmark,1,3,Friendly,2
Pakistan,Turkey,1,3,Friendly,2
Iran,Pakistan,4,1,Friendly,3
Ecuador,Colombia,2,0,FIFA World Cup qualification,2
Paraguay,Bolivia,2,0,FIFA World Cup qualification,2
Suriname,French Guiana,7,0,Friendly,7
Suriname,French Guiana,5,0,Friendly,5
Argentina,Paraguay,3,0,FIFA World Cup qualification,3
Chile,Colombia,7,2,FIFA World Cup qualification,5
China PR,Indonesia,3,0,Friendly,3
Guinea,Indonesia,3,1,Friendly,2
North Korea,China PR,3,0,Friendly,3
Jamaica,Trinidad and Tobago,4,0,Friendly,4
Cambodia,China PR,1,3,Friendly,2
Colombia,Chile,2,0,FIFA World Cup qualification,2
North Korea,Guinea,3,0,Friendly,3
Finland,Norway,4,0,Nordic Championship,4
North Korea,Indonesia,3,0,Friendly,3
China PR,Guinea,2,0,Friendly,2
North Korea,Cambodia,4,0,Friendly,4
Myanmar,Hong Kong,4,2,Merdeka Tournament,2
Vietnam Republic,Taiwan,5,2,Merdeka Tournament,3
Argentina,Bolivia,4,1,FIFA World Cup qualification,3
Malaysia,South Korea,0,2,Merdeka Tournament,2
Japan,Taiwan,0,4,Merdeka Tournament,4
Japan,Myanmar,3,1,Merdeka Tournament,2
Malaysia,India,0,3,Merdeka Tournament,3
Chile,Ecuador,3,1,FIFA World Cup qualification,2
Sudan,Uganda,4,1,African Cup of Nations qualification,3
Malaysia,Hong Kong,1,3,Merdeka Tournament,2
Myanmar,Taiwan,3,1,Merdeka Tournament,2
India,Vietnam Republic,2,0,Merdeka Tournament,2
Gabon,Nigeria,1,4,Friendly,3
DR Congo,Ivory Coast,4,2,African Cup of Nations qualification,2
Hungary,Austria,3,0,FIFA World Cup qualification,3
Brazil,Uruguay,3,0,Friendly,3
New Caledonia,Tahiti,4,1,Friendly,3
Czechoslovakia,Romania,3,1,FIFA World Cup qualification,2
Luxembourg,Yugoslavia,2,5,FIFA World Cup qualification,3
Ivory Coast,Liberia,4,0,African Cup of Nations qualification,4
Uganda,Zanzibar,4,1,Friendly,3
Bulgaria,Belgium,3,0,FIFA World Cup qualification,3
Kenya,Tanzania,0,2,Friendly,2
Finland,Poland,2,0,FIFA World Cup qualification,2
Tanzania,Zanzibar,3,0,Friendly,3
Kenya,Zanzibar,5,1,Friendly,4
Greece,Russia,1,4,FIFA World Cup qualification,3
Germany,Austria,4,1,Friendly,3
Turkey,Czechoslovakia,0,6,FIFA World Cup qualification,6
Ghana,Congo,5,0,Friendly,5
Denmark,Russia,1,3,FIFA World Cup qualification,2
Kenya,Tanzania,4,2,Friendly,2
Poland,Finland,7,0,FIFA World Cup qualification,7
Belgium,Bulgaria,5,0,FIFA World Cup qualification,5
Spain,Republic of Ireland,4,1,FIFA World Cup qualification,3
Nigeria,Ghana,0,4,Friendly,4
Italy,Poland,6,1,FIFA World Cup qualification,5
France,Luxembourg,4,1,FIFA World Cup qualification,3
Cyprus,Sweden,0,5,FIFA World Cup qualification,5
Ghana,Nigeria,3,0,Friendly,3
Israel,Belgium,0,5,FIFA World Cup qualification,5
DR Congo,Ghana,2,5,African Cup of Nations,3
Tunisia,Ethiopia,4,0,African Cup of Nations,4
Vietnam Republic,Thailand,4,0,Vietnam Independence Cup,4
DR Congo,Ivory Coast,0,3,African Cup of Nations,3
Cyprus,Germany,0,6,FIFA World Cup qualification,6
Ethiopia,Senegal,1,5,African Cup of Nations,4
Ghana,Ivory Coast,4,1,African Cup of Nations,3
Brazil,Hungary,5,3,Friendly,2
Czechoslovakia,Turkey,3,1,FIFA World Cup qualification,2
Dominica,Grenada,2,0,Windward Islands Tournament,2
North Korea,Australia,6,1,FIFA World Cup qualification,5
Romania,Portugal,2,0,FIFA World Cup qualification,2
Australia,North Korea,1,3,FIFA World Cup qualification,2
Scotland,Wales,4,1,British Home Championship,3
Ivory Coast,Mali,1,3,Friendly,2
Saint Vincent and the Grenadines,Dominica,3,1,Windward Islands Tournament,2
Wales,Denmark,4,2,FIFA World Cup qualification,2
Australia,Taiwan,3,1,Friendly,2
Uruguay,Russia,1,3,Friendly,2
Italy,Scotland,3,0,FIFA World Cup qualification,3
Malaysia,Australia,0,3,Friendly,3
Spain,England,0,2,Friendly,2
Kenya,Ghana,2,13,Friendly,11
Bermuda,Jamaica,0,3,Friendly,3
Panama,Nicaragua,3,1,Friendly,2
Chile,Russia,0,2,Friendly,2
Guinea,Senegal,5,0,Friendly,5
Libya,Morocco,4,0,Friendly,4
Libya,Iraq,0,2,Friendly,2
Netherlands,Germany,2,4,Friendly,2
Wales,Northern Ireland,1,4,British Home Championship,3
Iraq,Kuwait,3,1,Arab Cup,2
Syria,Yemen,4,1,Arab Cup,3
Lebanon,Bahrain,6,1,Arab Cup,5
Libya,Oman,21,0,Arab Cup,21
Palestine,Yemen,7,0,Arab Cup,7
Iraq,Bahrain,10,1,Arab Cup,9
Israel,Finland,7,1,Friendly,6
Libya,Yemen,13,0,Arab Cup,13
Palestine,Syria,1,3,Arab Cup,2
Bahrain,Jordan,1,5,Arab Cup,4
Jordan,Kuwait,0,4,Arab Cup,4
Iraq,Libya,3,1,Arab Cup,2
Benin,Ghana,2,5,Friendly,3
Libya,Lebanon,6,1,Arab Cup,5
Netherlands,Belgium,3,1,Friendly,2
France,Belgium,0,3,Friendly,3
Mexico,Paraguay,7,0,Friendly,7
German DR,Sweden,4,1,Friendly,3
England,Yugoslavia,2,0,Friendly,2
Republic of Ireland,Germany,0,4,Friendly,4
Northern Ireland,Germany,0,2,Friendly,2
Finland,Israel,0,3,Friendly,3
Yugoslavia,Hungary,2,0,Friendly,2
Scotland,Netherlands,0,3,Friendly,3
Brazil,Wales,3,1,Friendly,2
Uruguay,Paraguay,3,1,Copa Artigas,2
Chile,Wales,2,0,Friendly,2
Lithuania,Libya,6,0,Friendly,6
Yugoslavia,Bulgaria,0,2,Friendly,2
Brazil,Peru,4,0,Friendly,4
Brazil,Poland,4,1,Friendly,3
Hungary,Switzerland,3,1,Friendly,2
Brazil,Peru,3,1,Friendly,2
Haiti,Guadeloupe,3,0,Friendly,3
Portugal,Norway,4,0,Friendly,4
Haiti,Suriname,1,4,Friendly,3
Italy,Bulgaria,6,1,Friendly,5
Guadeloupe,Suriname,0,4,Friendly,4
Trinidad and Tobago,Jamaica,4,1,Friendly,3
Haiti,Curaçao,3,0,Friendly,3
Jamaica,Suriname,3,5,Friendly,2
Guadeloupe,Curaçao,0,4,Friendly,4
Denmark,Portugal,1,3,Friendly,2
Haiti,Jamaica,3,0,Friendly,3
Italy,Argentina,3,0,Friendly,3
Northern Ireland,Mexico,4,1,Friendly,3
Germany,Yugoslavia,2,0,Friendly,2
Finland,England,0,3,Friendly,3
Portugal,Uruguay,3,0,Friendly,3
China PR,Tanzania,10,4,Friendly,6
Italy,Mexico,5,0,Friendly,5
Norway,England,1,6,Friendly,5
DR Congo,Ghana,0,3,Friendly,3
Zambia,Malawi,4,1,Friendly,3
German DR,Chile,5,2,Friendly,3
Denmark,England,0,2,Friendly,2
Malawi,Zambia,0,3,Friendly,3
Madagascar,Zambia,0,3,Friendly,3
Malawi,Zambia,0,6,Friendly,6
Ethiopia,Uganda,5,0,Friendly,5
Malawi,Zambia,1,5,Friendly,4
Malawi,Madagascar,1,6,Friendly,5
Brazil,Bulgaria,2,0,FIFA World Cup,2
Germany,Switzerland,5,0,FIFA World Cup,5
North Korea,Russia,0,3,FIFA World Cup,3
Chile,Italy,0,2,FIFA World Cup,2
Hungary,Portugal,1,3,FIFA World Cup,2
Brazil,Hungary,1,3,FIFA World Cup,2
Bulgaria,Portugal,0,3,FIFA World Cup,3
England,Mexico,2,0,FIFA World Cup,2
Argentina,Switzerland,2,0,FIFA World Cup,2
Brazil,Portugal,1,3,FIFA World Cup,2
Bulgaria,Hungary,1,3,FIFA World Cup,2
England,France,2,0,FIFA World Cup,2
China PR,Syria,6,0,Friendly,6
Germany,Uruguay,4,0,FIFA World Cup,4
North Korea,Portugal,3,5,FIFA World Cup,2
England,Germany,4,2,FIFA World Cup,2
DR Congo,Central African Republic,5,0,Friendly,5
Malaysia,Vietnam Republic,5,2,Merdeka Tournament,3
Hong Kong,India,0,2,Merdeka Tournament,2
South Korea,Japan,2,0,Merdeka Tournament,2
Myanmar,Thailand,3,0,Merdeka Tournament,3
Taiwan,Vietnam Republic,0,3,Merdeka Tournament,3
India,Japan,3,0,Merdeka Tournament,3
Singapore,Taiwan,4,1,Merdeka Tournament,3
Japan,Taiwan,5,2,Merdeka Tournament,3
Ghana,Togo,6,2,Friendly,4
Hong Kong,Myanmar,0,2,Merdeka Tournament,2
Japan,Vietnam Republic,0,2,Merdeka Tournament,2
Myanmar,South Korea,2,0,Merdeka Tournament,2
China PR,Mali,4,0,Friendly,4
Guinea,Mali,5,0,Friendly,5
Singapore,South Korea,1,3,Friendly,2
German DR,Egypt,6,0,Friendly,6
German DR,Poland,2,0,Friendly,2
Norway,Sweden,2,4,Nordic Championship,2
German DR,Romania,2,0,Friendly,2
Hungary,Denmark,6,0,UEFA Euro qualification,6
Zanzibar,Kenya,1,3,Friendly,2
Tanzania,Uganda,0,3,Friendly,3
Hungary,France,4,2,Friendly,2
Zanzibar,Tanzania,0,4,Friendly,4
Poland,Luxembourg,4,0,UEFA Euro qualification,4
Sweden,Austria,4,1,Friendly,3
Israel,Yugoslavia,1,3,Friendly,2
Turkey,Germany,0,2,Friendly,2
French Guiana,Suriname,0,3,Friendly,3
Russia,Turkey,0,2,Friendly,2
Northern Ireland,England,0,2,British Home Championship,2
Denmark,Israel,3,1,Friendly,2
Hungary,Austria,3,1,Friendly,2
Cameroon,Togo,2,0,Friendly,2
Romania,Switzerland,4,2,UEFA Euro qualification,2
Vietnam Republic,Thailand,4,1,Vietnam Independence Cup,3
Bulgaria,Yugoslavia,6,1,Friendly,5
Grenada,Saint Lucia,7,1,Windward Islands Tournament,6
Dominica,Saint Lucia,5,3,Windward Islands Tournament,2
Grenada,Saint Vincent and the Grenadines,1,3,Windward Islands Tournament,2
Bulgaria,Norway,4,2,UEFA Euro qualification,2
England,Wales,5,1,British Home Championship,4
Germany,Norway,3,0,Friendly,3
Liberia,Sierra Leone,2,0,Friendly,2
Palestine,Yemen,5,3,GaNEFo,2
Cambodia,North Korea,0,2,GaNEFo,2
China PR,Palestine,7,0,GaNEFo,7
Italy,Romania,3,1,UEFA Euro qualification,2
Luxembourg,France,0,3,UEFA Euro qualification,3
North Vietnam,Yemen,9,0,GaNEFo,9
Cambodia,China PR,0,4,GaNEFo,4
Palestine,North Vietnam,0,4,GaNEFo,4
Cambodia,Yemen,8,0,GaNEFo,8
Palestine,North Korea,1,5,GaNEFo,4
Chile,Colombia,5,2,Copa América,3
China PR,North Vietnam,2,0,GaNEFo,2
North Korea,Yemen,14,0,GaNEFo,14
Netherlands,Denmark,2,0,UEFA Euro qualification,2
Central African Republic,DR Congo,1,4,Friendly,3
Cyprus,Romania,1,5,UEFA Euro qualification,4
China PR,Yemen,6,0,GaNEFo,6
North Korea,North Vietnam,3,1,GaNEFo,2
Spain,Republic of Ireland,2,0,UEFA Euro qualification,2
Tahiti,Wallis Islands and Futuna,5,0,South Pacific Games,5
New Caledonia,Vanuatu,5,0,South Pacific Games,5
New Caledonia,Solomon Islands,8,0,South Pacific Games,8
Papua New Guinea,Wallis Islands and Futuna,9,1,South Pacific Games,8
New Caledonia,Papua New Guinea,4,0,South Pacific Games,4
Tahiti,Vanuatu,3,0,South Pacific Games,3
New Caledonia,Tahiti,0,2,South Pacific Games,2
Papua New Guinea,Vanuatu,2,5,South Pacific Games,3
Paraguay,Ecuador,3,1,Copa América,2
Mexico,Switzerland,3,0,Friendly,3
Mexico,Switzerland,0,2,Friendly,2
Haiti,Trinidad and Tobago,4,2,CONCACAF Championship qualification,2
Uruguay,Bolivia,4,0,Copa América,4
Argentina,Paraguay,4,1,Copa América,3
Chile,Venezuela,2,0,Copa América,2
Guatemala,Honduras,3,1,Friendly,2
Egypt,German DR,0,3,Friendly,3
Uruguay,Venezuela,4,0,Copa América,4
Chile,Paraguay,4,2,Copa América,2
DR Congo,Congo,4,1,Friendly,3
Argentina,Venezuela,5,1,Copa América,4
Argentina,Chile,2,0,Copa América,2
Bolivia,Venezuela,0,3,Copa América,3
Uruguay,Paraguay,2,0,Copa América,2
Niger,Congo,1,3,Friendly,2
Venezuela,Paraguay,3,5,Copa América,2
Mali,Algeria,0,3,African Cup of Nations qualification,3
Tunisia,Cameroon,4,0,African Cup of Nations qualification,4
Nicaragua,Panama,3,1,CONCACAF Championship qualification,2
Ghana,Nigeria,2,0,Friendly,2
Guatemala,Panama,3,1,CONCACAF Championship qualification,2
Guatemala,Nicaragua,3,1,CONCACAF Championship qualification,2
Greece,Libya,4,0,Friendly,4
Togo,DR Congo,2,4,Friendly,2
Ethiopia,Kenya,2,0,Friendly,2
Germany,Morocco,5,1,Friendly,4
Kenya,Tanzania,2,0,Friendly,2
Uganda,DR Congo,0,5,Friendly,5
Guinea,Senegal,3,0,African Cup of Nations qualification,3
Sudan,Ethiopia,5,3,Friendly,2
France,Corsica,0,2,Friendly,2
Mexico,Nicaragua,4,0,CONCACAF Championship,4
Mexico,Trinidad and Tobago,4,0,CONCACAF Championship,4
Trinidad and Tobago,Guatemala,0,2,CONCACAF Championship,2
Nicaragua,Trinidad and Tobago,1,3,CONCACAF Championship,2
Honduras,Haiti,2,0,CONCACAF Championship,2
Congo,Ghana,3,1,Friendly,2
Guatemala,Nicaragua,2,0,CONCACAF Championship,2
Luxembourg,Belgium,0,5,UEFA Euro qualification,5
Senegal,Guinea,4,1,African Cup of Nations qualification,3
Cyprus,Italy,0,2,UEFA Euro qualification,2
Hong Kong,Vietnam Republic,2,0,AFC Asian Cup qualification,2
Gabon,Ivory Coast,0,3,Friendly,3
Vietnam Republic,Malaysia,0,2,AFC Asian Cup qualification,2
Guinea,Liberia,3,0,African Cup of Nations qualification,3
Vietnam Republic,Singapore,3,0,AFC Asian Cup qualification,3
Germany,Albania,6,0,UEFA Euro qualification,6
Algeria,Burkina Faso,3,1,African Cup of Nations qualification,2
Nigeria,Togo,4,2,African Cup of Nations qualification,2
Congo,DR Congo,3,1,Friendly,2
Romania,Cyprus,7,0,UEFA Euro qualification,7
Ivory Coast,Togo,3,0,African Cup of Nations qualification,3
Ivory Coast,Nigeria,2,0,African Cup of Nations qualification,2
Scotland,Russia,0,2,Friendly,2
Albania,Yugoslavia,0,2,UEFA Euro qualification,2
Suriname,French Guiana,6,1,Friendly,5
Suriname,French Guiana,3,0,Friendly,3
Congo,Tanzania,6,1,Friendly,5
Republic of Ireland,Czechoslovakia,0,2,UEFA Euro qualification,2
Poland,Belgium,3,1,UEFA Euro qualification,2
Denmark,Hungary,0,2,UEFA Euro qualification,2
England,Spain,2,0,Friendly,2
Ghana,DR Congo,2,0,Friendly,2
Switzerland,Romania,7,1,UEFA Euro qualification,6
Russia,Mexico,2,0,Friendly,2
Spain,Turkey,2,0,UEFA Euro qualification,2
Finland,Norway,0,2,Nordic Championship,2
France,Russia,2,4,Friendly,2
Sweden,Bulgaria,0,2,UEFA Euro qualification,2
Czechoslovakia,Turkey,3,0,UEFA Euro qualification,3
Uganda,Zambia,1,3,Friendly,2
Senegal,Liberia,4,1,African Cup of Nations qualification,3
Russia,Greece,4,0,UEFA Euro qualification,4
Guyana,Suriname,0,2,Friendly,2
Japan,Philippines,2,0,AFC Asian Cup qualification,2
South Korea,Philippines,7,0,AFC Asian Cup qualification,7
Indonesia,Philippines,6,0,AFC Asian Cup qualification,6
Sweden,Finland,2,0,Nordic Championship,2
Indonesia,South Korea,1,3,Merdeka Tournament,2
Hong Kong,Vietnam Republic,0,5,Merdeka Tournament,5
India,Western Australia,3,1,Merdeka Tournament,2
Indonesia,Singapore,4,1,Merdeka Tournament,3
Malaysia,Hong Kong,3,0,Merdeka Tournament,3
Myanmar,Singapore,3,0,Merdeka Tournament,3
Thailand,Western Australia,1,3,Merdeka Tournament,2
Hong Kong,India,0,4,Merdeka Tournament,4
Togo,Ivory Coast,0,2,African Cup of Nations qualification,2
Vietnam Republic,Western Australia,3,0,Merdeka Tournament,3
Myanmar,Indonesia,5,0,Merdeka Tournament,5
Thailand,Vietnam Republic,2,5,Merdeka Tournament,3
South Korea,Singapore,3,0,Merdeka Tournament,3
Myanmar,Vietnam Republic,3,0,Merdeka Tournament,3
Denmark,Iceland,14,2,Friendly,12
Malaysia,South Korea,1,3,Merdeka Tournament,2
Singapore,Western Australia,3,5,Merdeka Tournament,2
Hong Kong,Taiwan,2,4,Merdeka Tournament,2
India,Indonesia,0,3,Merdeka Tournament,3
Russia,Finland,2,0,UEFA Euro qualification,2
DR Congo,Ghana,0,2,Friendly,2
Norway,Sweden,3,1,UEFA Euro qualification,2
Austria,Hungary,1,3,Friendly,2
Finland,Russia,2,5,UEFA Euro qualification,3
Poland,France,1,4,UEFA Euro qualification,3
Norway,Denmark,0,5,Nordic Championship,5
Germany,France,5,1,Friendly,4
Hungary,German DR,3,1,UEFA Euro qualification,2
Mali,Burkina Faso,4,0,African Cup of Nations qualification,4
Kenya,Uganda,3,1,Friendly,2
Ghana,Burkina Faso,5,2,Friendly,3
Greece,Austria,4,1,UEFA Euro qualification,3
Kenya,Zanzibar,6,0,Friendly,6
Uganda,Zanzibar,2,0,Friendly,2
Germany,Yugoslavia,3,1,UEFA Euro qualification,2
Singapore,Hong Kong,4,0,Friendly,4
Belgium,Poland,2,4,UEFA Euro qualification,2
Kenya,Tanzania,5,3,Friendly,2
El Salvador,Haiti,2,0,Friendly,2
Tanzania,Zanzibar,0,3,Friendly,3
Liberia,DR Congo,1,4,Friendly,3
Wales,England,0,3,British Home Championship,3
Denmark,Finland,3,0,Nordic Championship,3
El Salvador,Costa Rica,3,1,Friendly,2
Italy,Cyprus,5,0,UEFA Euro qualification,5
Vietnam Republic,Singapore,2,0,Vietnam Independence Cup,2
Australia,New Zealand,5,3,Vietnam Independence Cup,2
El Salvador,Guatemala,1,3,Friendly,2
Puerto Rico,Martinique,3,6,Friendly,3
Sweden,Norway,5,2,UEFA Euro qualification,3
South Korea,Thailand,3,1,Vietnam Independence Cup,2
Chile,Argentina,3,1,Friendly,2
Hong Kong,Malaysia,0,2,Vietnam Independence Cup,2
New Caledonia,New Zealand,4,0,Friendly,4
New Zealand,Singapore,3,1,Vietnam Independence Cup,2
Puerto Rico,Guadeloupe,2,4,Friendly,2
Switzerland,Cyprus,5,0,UEFA Euro qualification,5
Hong Kong,Thailand,1,5,Vietnam Independence Cup,4
Vietnam Republic,New Zealand,5,1,Vietnam Independence Cup,4
Australia,Singapore,5,1,Vietnam Independence Cup,4
Bulgaria,Sweden,3,0,UEFA Euro qualification,3
Myanmar,India,2,0,AFC Asian Cup qualification,2
Vietnam Republic,South Korea,0,3,Vietnam Independence Cup,3
Yugoslavia,Albania,4,0,UEFA Euro qualification,4
Vietnam Republic,Malaysia,4,1,Vietnam Independence Cup,3
Malaysia,New Zealand,2,8,Friendly,6
Myanmar,Pakistan,2,0,AFC Asian Cup qualification,2
Belgium,Luxembourg,3,0,UEFA Euro qualification,3
England,Northern Ireland,2,0,British Home Championship,2
Benin,DR Congo,2,5,Friendly,3
Dominica,Saint Lucia,2,4,Windward Islands Tournament,2
Pakistan,Turkey,4,7,Friendly,3
Netherlands,Russia,3,1,Friendly,2
Dominica,Grenada,2,4,Windward Islands Tournament,2
Mauritius,Ethiopia,0,2,Friendly,2
Mexico,Hungary,0,2,Friendly,2
Saudi Arabia,Tunisia,4,0,Friendly,4
Chile,Russia,1,4,Friendly,3
Kenya,Zambia,1,5,Friendly,4
France,Luxembourg,3,1,UEFA Euro qualification,2
Italy,Switzerland,4,0,UEFA Euro qualification,4
Ethiopia,Kenya,2,0,Friendly,2
Israel,Belgium,0,2,Friendly,2
Algeria,Ivory Coast,0,3,African Cup of Nations,3
Congo,DR Congo,0,3,African Cup of Nations,3
Algeria,Uganda,4,0,African Cup of Nations,4
Congo,Ghana,1,3,African Cup of Nations,2
Ethiopia,Algeria,3,1,African Cup of Nations,2
Nigeria,Sierra Leone,4,1,Friendly,3
Israel,Sweden,0,3,Friendly,3
Burkina Faso,Guinea,2,0,Friendly,2
Spain,Sweden,3,1,Friendly,2
Wales,Northern Ireland,2,0,British Home Championship,2
Belgium,Germany,1,3,Friendly,2
Mexico,Japan,4,0,Friendly,4
Australia,Japan,3,1,Friendly,2
Guinea,Burkina Faso,3,1,Friendly,2
Guinea,Burkina Faso,1,3,Friendly,2
Australia,Japan,1,3,Friendly,2
Barbados,Suriname,0,2,Friendly,2
Benin,Guinea,2,5,Friendly,3
Martinique,Suriname,1,3,Friendly,2
Italy,Bulgaria,2,0,UEFA Euro qualification,2
Poland,Turkey,8,0,Friendly,8
Yugoslavia,France,5,1,UEFA Euro qualification,4
Czechoslovakia,Yugoslavia,3,0,Friendly,3
Eswatini,Malawi,2,0,Friendly,2
Hungary,Russia,2,0,UEFA Euro qualification,2
El Salvador,Guatemala,3,0,Friendly,3
Iran,Hong Kong,2,0,AFC Asian Cup,2
Russia,Hungary,3,0,UEFA Euro qualification,3
Hong Kong,Israel,1,6,AFC Asian Cup,5
Iran,Taiwan,4,0,AFC Asian Cup,4
Paraguay,Argentina,2,0,Friendly,2
Iran,Myanmar,3,1,AFC Asian Cup,2
Israel,Taiwan,4,1,AFC Asian Cup,3
Myanmar,Hong Kong,2,0,AFC Asian Cup,2
Austria,Cyprus,7,1,FIFA World Cup qualification,6
England,Sweden,3,1,Friendly,2
Finland,Denmark,1,3,Nordic Championship,2
Argentina,Uruguay,2,0,Copa Lipton,2
England,Russia,2,0,UEFA Euro,2
Brazil,Uruguay,2,0,Copa Rio Branco,2
Norway,Poland,1,6,Friendly,5
Italy,Yugoslavia,2,0,UEFA Euro,2
Brazil,Uruguay,4,0,Copa Rio Branco,4
Russia,Austria,3,1,Friendly,2
Poland,Brazil,3,6,Friendly,3
Denmark,Norway,5,1,Nordic Championship,4
Yugoslavia,Brazil,0,2,Friendly,2
Portugal,Brazil,0,2,Friendly,2
Mexico,Brazil,0,2,Friendly,2
Malawi,Botswana,8,1,Friendly,7
Peru,Brazil,0,4,Friendly,4
Iceland,Norway,0,4,Friendly,4
Eswatini,Malawi,2,0,Friendly,2
Paraguay,Brazil,0,4,Copa Oswaldo Cruz,4
Brazil,Argentina,4,1,Friendly,3
Myanmar,Vietnam Republic,3,0,Merdeka Tournament,3
South Korea,Western Australia,0,3,Merdeka Tournament,3
Singapore,Taiwan,0,2,Merdeka Tournament,2
Myanmar,Hong Kong,3,0,Merdeka Tournament,3
Malaysia,Vietnam Republic,4,0,Merdeka Tournament,4
Indonesia,Singapore,4,0,Merdeka Tournament,4
Malaysia,Thailand,4,1,Merdeka Tournament,3
Myanmar,India,1,3,Merdeka Tournament,2
Indonesia,South Korea,4,2,Merdeka Tournament,2
Hong Kong,Vietnam Republic,1,3,Merdeka Tournament,2
Norway,Finland,4,1,Nordic Championship,3
Indonesia,Taiwan,10,1,Merdeka Tournament,9
Indonesia,Western Australia,1,3,Merdeka Tournament,2
Malaysia,Myanmar,3,0,Merdeka Tournament,3
India,Indonesia,1,3,Friendly,2
India,Vietnam Republic,0,2,Friendly,2
Netherlands,Luxembourg,2,0,FIFA World Cup qualification,2
Finland,Sweden,0,3,Nordic Championship,3
New Zealand,Fiji,5,0,Friendly,5
Ghana,Benin,3,0,Friendly,3
Denmark,Czechoslovakia,0,3,FIFA World Cup qualification,3
United States,Israel,0,4,Friendly,4
Yugoslavia,Finland,9,1,FIFA World Cup qualification,8
Tanzania,Uganda,0,2,Friendly,2
Kenya,Zanzibar,3,0,Friendly,3
Mexico,Ethiopia,3,0,Friendly,3
Uganda,Zanzibar,2,0,Friendly,2
Tanzania,Zanzibar,3,0,Friendly,3
Canada,Bermuda,4,0,FIFA World Cup qualification,4
Suriname,Martinique,7,0,Friendly,7
New Zealand,New Caledonia,1,3,Friendly,2
Belgium,Finland,6,1,FIFA World Cup qualification,5
Sweden,Norway,5,0,FIFA World Cup qualification,5
Turkey,Bulgaria,0,2,Friendly,2
Austria,Germany,0,2,FIFA World Cup qualification,2
Canada,United States,4,2,FIFA World Cup qualification,2
Ethiopia,Thailand,6,0,Friendly,6
Belgium,Yugoslavia,3,0,FIFA World Cup qualification,3
France,Spain,1,3,Friendly,2
Haiti,United States,3,6,Friendly,3
Haiti,United States,5,2,Friendly,3
Zambia,Tanzania,7,1,Friendly,6
Chile,Mexico,3,1,Friendly,2
Northern Ireland,Turkey,4,1,FIFA World Cup qualification,3
Uruguay,Mexico,0,2,Friendly,2
Bulgaria,Netherlands,2,0,FIFA World Cup qualification,2
Portugal,Romania,3,0,FIFA World Cup qualification,3
Zambia,Sudan,4,2,FIFA World Cup qualification,2
Nigeria,Thailand,7,2,Friendly,5
United States,Bermuda,6,2,FIFA World Cup qualification,4
Sudan,Zambia,4,2,FIFA World Cup qualification,2
Bermuda,United States,0,2,FIFA World Cup qualification,2
Guadeloupe,Martinique,3,1,Friendly,2
Costa Rica,El Salvador,3,0,Friendly,3
Guadeloupe,Puerto Rico,2,0,Friendly,2
Martinique,Puerto Rico,7,0,Friendly,7
Guatemala,Trinidad and Tobago,4,0,FIFA World Cup qualification,4
Saint Lucia,Dominica,4,0,Windward Islands Tournament,4
Myanmar,Laos,3,0,King's Cup,3
Denmark,Luxembourg,5,1,Friendly,4
Dominica,Grenada,2,6,Windward Islands Tournament,4
Thailand,Singapore,3,0,King's Cup,3
Myanmar,Singapore,2,0,King's Cup,2
Haiti,Trinidad and Tobago,4,0,FIFA World Cup qualification,4
Romania,Switzerland,2,0,FIFA World Cup qualification,2
Myanmar,Indonesia,1,3,King's Cup,2
Laos,Malaysia,0,5,King's Cup,5
Suriname,Curaçao,6,0,FIFA World Cup qualification,6
Haiti,Trinidad and Tobago,2,4,FIFA World Cup qualification,2
Indonesia,Singapore,7,0,King's Cup,7
Argentina,Chile,4,0,Copa Carlos Dittborn,4
Costa Rica,Jamaica,3,0,FIFA World Cup qualification,3
Indonesia,Malaysia,6,1,King's Cup,5
Cameroon,Tunisia,4,2,Friendly,2
Costa Rica,Jamaica,3,1,FIFA World Cup qualification,2
El Salvador,Suriname,6,0,FIFA World Cup qualification,6
Ghana,Senegal,2,0,Friendly,2
Thailand,Malaysia,6,0,King's Cup,6
Curaçao,Suriname,2,0,FIFA World Cup qualification,2
Honduras,Jamaica,3,1,FIFA World Cup qualification,2
Haiti,Guatemala,2,0,FIFA World Cup qualification,2
Honduras,Jamaica,2,0,FIFA World Cup qualification,2
Cyprus,Scotland,0,5,FIFA World Cup qualification,5
Greece,Portugal,4,2,FIFA World Cup qualification,2
Turkey,Northern Ireland,0,3,FIFA World Cup qualification,3
Suriname,El Salvador,4,1,FIFA World Cup qualification,3
Ethiopia,Somalia,7,0,Friendly,7
Somalia,Uganda,1,7,Friendly,6
Sudan,Tanzania,3,0,Friendly,3
Ethiopia,Uganda,4,0,Friendly,4
Bermuda,Denmark,1,5,Friendly,4
Mexico,Denmark,3,0,Friendly,3
DR Congo,Senegal,4,0,Friendly,4
Libya,Ethiopia,2,0,FIFA World Cup qualification,2
Cameroon,Uganda,2,0,African Cup of Nations qualification,2
Haiti,Jamaica,3,0,Friendly,3
Zimbabwe,Malawi,4,0,Friendly,4
Ethiopia,Libya,5,1,FIFA World Cup qualification,4
Morocco,Hungary,1,4,Friendly,3
Morocco,Senegal,2,0,FIFA World Cup qualification,2
Colombia,Russia,1,3,Friendly,2
Algeria,Morocco,2,0,African Cup of Nations qualification,2
England,France,5,0,Friendly,5
Iran,Pakistan,9,1,Friendly,8
Morocco,Algeria,2,0,African Cup of Nations qualification,2
Netherlands,Luxembourg,4,0,FIFA World Cup qualification,4
Belgium,Mexico,2,0,Friendly,2
Netherlands,Czechoslovakia,2,0,Friendly,2
Portugal,Switzerland,0,2,FIFA World Cup qualification,2
Haiti,United States,2,0,FIFA World Cup qualification,2
Poland,Luxembourg,8,1,FIFA World Cup qualification,7
Malta,Austria,1,3,Friendly,2
Turkey,Poland,1,3,Friendly,2
Northern Ireland,England,1,3,British Home Championship,2
Wales,Scotland,3,5,British Home Championship,2
Denmark,Mexico,3,1,Friendly,2
Colombia,Peru,1,3,Friendly,2
Norway,Mexico,0,2,Friendly,2
England,Scotland,4,1,British Home Championship,3
Sudan,Ethiopia,3,1,FIFA World Cup qualification,2
El Salvador,Peru,1,4,Friendly,3
Scotland,Cyprus,8,0,FIFA World Cup qualification,8
Germany,Cyprus,12,0,FIFA World Cup qualification,12
Guinea,Gambia,6,2,Friendly,4
Mexico,Peru,3,0,Friendly,3
Sweden,Finland,4,0,Nordic Championship,4
Ethiopia,Tanzania,7,0,African Cup of Nations qualification,7
Hungary,Czechoslovakia,2,0,FIFA World Cup qualification,2
Denmark,Republic of Ireland,2,0,FIFA World Cup qualification,2
Sweden,Norway,4,2,Nordic Championship,2
Mexico,England,0,4,Friendly,4
Finland,Yugoslavia,1,5,FIFA World Cup qualification,4
Bulgaria,Poland,4,1,FIFA World Cup qualification,3
El Salvador,Honduras,3,0,FIFA World Cup qualification,3
Norway,Sweden,2,5,FIFA World Cup qualification,3
Ecuador,Colombia,4,1,Friendly,3
Finland,Spain,2,0,FIFA World Cup qualification,2
Denmark,Bermuda,6,0,Friendly,6
Madagascar,Malawi,3,0,Friendly,3
Norway,Bermuda,3,0,Friendly,3
Ecuador,Uruguay,0,2,FIFA World Cup qualification,2
Malawi,Eswatini,3,0,Friendly,3
German DR,Egypt,7,0,Friendly,7
Congo,Tunisia,4,1,Friendly,3
Finland,Iceland,3,1,Friendly,2
Bolivia,Argentina,3,1,FIFA World Cup qualification,2
Chile,Ecuador,4,1,FIFA World Cup qualification,3
Colombia,Venezuela,3,0,FIFA World Cup qualification,3
New Caledonia,New Zealand,2,0,Friendly,2
Colombia,Brazil,0,2,FIFA World Cup qualification,2
Venezuela,Paraguay,0,2,FIFA World Cup qualification,2
Uruguay,Chile,2,0,FIFA World Cup qualification,2
Venezuela,Brazil,0,5,FIFA World Cup qualification,5
Guinea,Togo,4,0,African Cup of Nations qualification,4
Fiji,Solomon Islands,5,1,South Pacific Games,4
Papua New Guinea,New Caledonia,1,4,South Pacific Games,3
Papua New Guinea,Tahiti,1,3,South Pacific Games,2
Fiji,Vanuatu,5,2,South Pacific Games,3
Fiji,Tahiti,0,2,South Pacific Games,2
Papua New Guinea,Solomon Islands,4,0,South Pacific Games,4
New Caledonia,Vanuatu,2,0,South Pacific Games,2
Ghana,Niger,6,0,African Cup of Nations qualification,6
Paraguay,Brazil,0,3,FIFA World Cup qualification,3
Peru,Bolivia,3,0,FIFA World Cup qualification,3
Fiji,New Caledonia,0,11,South Pacific Games,11
Solomon Islands,Tahiti,0,7,South Pacific Games,7
Vanuatu,Solomon Islands,7,2,South Pacific Games,5
Brazil,Colombia,6,2,FIFA World Cup qualification,4
Brazil,Venezuela,6,0,FIFA World Cup qualification,6
Sweden,Israel,3,1,Friendly,2
Poland,Norway,6,1,Friendly,5
Zambia,Malawi,4,0,Friendly,4
Zambia,Malawi,5,0,Friendly,5
Zambia,Malawi,7,0,Friendly,7
Denmark,Finland,5,2,Nordic Championship,3
Norway,France,1,3,FIFA World Cup qualification,2
Turkey,Pakistan,4,2,Friendly,2
Iran,Pakistan,4,2,Friendly,2
Singapore,New Zealand,0,2,Friendly,2
Turkey,Iran,4,0,Friendly,4
Niger,Ghana,1,9,African Cup of Nations qualification,8
Norway,Denmark,2,0,Nordic Championship,2
Sweden,Hungary,2,0,Friendly,2
Turkey,Switzerland,3,0,Friendly,3
Yugoslavia,Russia,1,3,Friendly,2
Uganda,Tanzania,3,0,Friendly,3
El Salvador,Haiti,0,3,FIFA World Cup qualification,3
Israel,New Zealand,4,0,FIFA World Cup qualification,4
Uganda,Zanzibar,7,0,Friendly,7
Israel,New Zealand,2,0,FIFA World Cup qualification,2
Kenya,Tanzania,0,3,Friendly,3
Tanzania,Zanzibar,3,0,Friendly,3
Czechoslovakia,Republic of Ireland,3,0,FIFA World Cup qualification,3
Uganda,Ethiopia,4,0,Friendly,4
Japan,Australia,1,3,FIFA World Cup qualification,2
Luxembourg,Poland,1,5,FIFA World Cup qualification,4
Dominica,Suriname,1,3,Friendly,2
Greece,Switzerland,4,1,FIFA World Cup qualification,3
Russia,Turkey,3,0,FIFA World Cup qualification,3
Spain,Finland,6,0,FIFA World Cup qualification,6
Sweden,France,2,0,FIFA World Cup qualification,2
Dominica,Suriname,1,9,Friendly,8
South Korea,Japan,2,0,FIFA World Cup qualification,2
Yugoslavia,Belgium,4,0,FIFA World Cup qualification,4
Mexico,Bermuda,3,0,CONCACAF Championship qualification,3
Hungary,Denmark,3,0,FIFA World Cup qualification,3
Russia,Northern Ireland,2,0,FIFA World Cup qualification,2
Wales,German DR,1,3,FIFA World Cup qualification,2
Algeria,Palestine,2,0,Friendly,2
Ivory Coast,Mali,4,0,African Cup of Nations qualification,4
Morocco,Sudan,3,0,FIFA World Cup qualification,3
Myanmar,Singapore,3,1,Merdeka Tournament,2
France,Sweden,3,0,FIFA World Cup qualification,3
Indonesia,Thailand,4,0,Merdeka Tournament,4
Indonesia,South Korea,3,0,Merdeka Tournament,3
Myanmar,India,6,0,Merdeka Tournament,6
Egypt,Sudan,3,1,Friendly,2
Singapore,Western Australia,4,2,Merdeka Tournament,2
Malaysia,South Korea,4,1,Merdeka Tournament,3
Myanmar,Western Australia,5,2,Merdeka Tournament,3
India,Singapore,3,0,Merdeka Tournament,3
Italy,Wales,4,1,FIFA World Cup qualification,3
Austria,Scotland,2,0,FIFA World Cup qualification,2
Hungary,Republic of Ireland,4,0,FIFA World Cup qualification,4
South Korea,Thailand,3,0,Merdeka Tournament,3
Indonesia,Singapore,9,2,Merdeka Tournament,7
Malaysia,Myanmar,3,1,Merdeka Tournament,2
Nigeria,Morocco,2,0,FIFA World Cup qualification,2
Myanmar,Singapore,9,0,Merdeka Tournament,9
Poland,Bulgaria,3,0,FIFA World Cup qualification,3
Grenada,Saint Lucia,6,0,Windward Islands Tournament,6
Mexico,Norway,4,0,Friendly,4
Singapore,India,7,3,Friendly,4
Guatemala,Norway,1,3,Friendly,2
Dominica,Saint Lucia,1,3,Windward Islands Tournament,2
Turkey,Russia,1,3,FIFA World Cup qualification,2
South Korea,Laos,2,0,King's Cup,2
Vietnam Republic,Western Australia,3,1,King's Cup,2
South Korea,Malaysia,2,0,King's Cup,2
DR Congo,Zambia,10,1,Friendly,9
Indonesia,Vietnam Republic,3,1,King's Cup,2
Italy,German DR,3,0,FIFA World Cup qualification,3
Singapore,Western Australia,1,3,King's Cup,2
Costa Rica,Jamaica,3,0,CONCACAF Championship,3
Indonesia,Western Australia,3,1,King's Cup,2
Indonesia,Laos,3,0,King's Cup,3
South Korea,Vietnam Republic,3,0,King's Cup,3
Jamaica,Mexico,0,2,CONCACAF Championship,2
Mexico,Jamaica,2,0,CONCACAF Championship,2
Laos,Vietnam Republic,0,7,King's Cup,7
Guatemala,Curaçao,6,1,CONCACAF Championship,5
Zimbabwe,Australia,1,3,FIFA World Cup qualification,2
Costa Rica,Mexico,2,0,CONCACAF Championship,2
Curaçao,Trinidad and Tobago,3,1,CONCACAF Championship,2
Czechoslovakia,Hungary,4,1,FIFA World Cup qualification,3
Costa Rica,Trinidad and Tobago,5,0,CONCACAF Championship,5
Algeria,North Korea,1,3,Friendly,2
Luxembourg,Bulgaria,1,3,FIFA World Cup qualification,2
DR Congo,Nigeria,5,0,Friendly,5
Egypt,German DR,1,3,Friendly,2
Morocco,Bulgaria,3,0,Friendly,3
Peru,Czechoslovakia,0,2,Friendly,2
Sudan,Ethiopia,3,0,African Cup of Nations,3
DR Congo,Ghana,0,2,African Cup of Nations,2
Egypt,Guinea,4,1,African Cup of Nations,3
Ethiopia,Ivory Coast,1,6,African Cup of Nations,5
Spain,Germany,2,0,Friendly,2
Egypt,Ivory Coast,3,1,African Cup of Nations,2
Mexico,Bulgaria,2,0,Friendly,2
Peru,Russia,0,2,Friendly,2
Peru,Bulgaria,1,3,Friendly,2
El Salvador,Russia,0,2,Friendly,2
Peru,Bulgaria,5,3,Friendly,2
Belgium,England,1,3,Friendly,2
Costa Rica,El Salvador,2,0,Friendly,2
Brazil,Argentina,0,2,Friendly,2
Mexico,Peru,3,1,Friendly,2
Brazil,Chile,5,0,Friendly,5
Ethiopia,Israel,1,5,Friendly,4
Guinea,Ivory Coast,4,2,Friendly,2
Saudi Arabia,Kuwait,1,3,Gulf Cup,2
Kuwait,Qatar,4,2,Gulf Cup,2
Uruguay,Peru,2,0,Friendly,2
Bahrain,Kuwait,1,3,Gulf Cup,2
Austria,Czechoslovakia,1,3,Friendly,2
Ghana,Ivory Coast,3,0,Friendly,3
England,Northern Ireland,3,1,British Home Championship,2
Peru,El Salvador,3,0,Friendly,3
France,Romania,2,0,Friendly,2
Mexico,Ecuador,4,2,Friendly,2
Hungary,Poland,2,0,Friendly,2
Norway,Czechoslovakia,0,2,Friendly,2
Guinea,Senegal,3,1,Friendly,2
Guinea,Senegal,4,0,Friendly,4
Denmark,Poland,0,2,Friendly,2
Colombia,England,0,4,Friendly,4
Ecuador,England,0,2,Friendly,2
Israel,Uruguay,0,2,FIFA World Cup,2
Belgium,El Salvador,3,0,FIFA World Cup,3
Brazil,Czechoslovakia,4,1,FIFA World Cup,3
Belgium,Russia,1,4,FIFA World Cup,3
Morocco,Peru,0,3,FIFA World Cup,3
Bulgaria,Germany,2,5,FIFA World Cup,3
Mexico,El Salvador,4,0,FIFA World Cup,4
El Salvador,Russia,0,2,FIFA World Cup,2
Germany,Peru,3,1,FIFA World Cup,2
Brazil,Peru,4,2,FIFA World Cup,2
Mexico,Italy,1,4,FIFA World Cup,3
Brazil,Uruguay,3,1,FIFA World Cup,2
Norway,Finland,2,0,Nordic Championship,2
Malaysia,Singapore,5,0,Indonesia Tournament,5
Brazil,Italy,4,1,FIFA World Cup,3
South Korea,Singapore,8,0,Indonesia Tournament,8
Indonesia,Western Australia,3,1,Indonesia Tournament,2
Hong Kong,Western Australia,3,1,Indonesia Tournament,2
South Korea,Malaysia,0,2,Indonesia Tournament,2
DR Congo,Sudan,3,0,Friendly,3
Tahiti,New Caledonia,3,1,Friendly,2
Tahiti,New Caledonia,0,2,Friendly,2
Iceland,Norway,2,0,Friendly,2
Poland,Iraq,2,0,Friendly,2
German DR,Iraq,5,0,Friendly,5
Malaysia,India,1,3,Merdeka Tournament,2
Cameroon,Gabon,0,3,Friendly,3
Indonesia,Singapore,3,1,Merdeka Tournament,2
Hong Kong,Thailand,2,0,Merdeka Tournament,2
Myanmar,India,2,0,Merdeka Tournament,2
Vietnam Republic,Western Australia,1,3,Merdeka Tournament,2
Malaysia,Taiwan,3,1,Merdeka Tournament,2
Hong Kong,Indonesia,1,3,Merdeka Tournament,2
South Korea,Singapore,4,0,Merdeka Tournament,4
Myanmar,Vietnam Republic,4,2,Merdeka Tournament,2
India,Western Australia,2,0,Merdeka Tournament,2
Malaysia,Western Australia,4,1,Merdeka Tournament,3
Taiwan,Western Australia,1,3,Merdeka Tournament,2
Indonesia,Thailand,6,3,Merdeka Tournament,3
Japan,Singapore,4,0,Merdeka Tournament,4
Malawi,Lesotho,6,1,Friendly,5
Myanmar,Hong Kong,5,0,Merdeka Tournament,5
Thailand,Western Australia,2,0,Merdeka Tournament,2
Singapore,Vietnam Republic,0,4,Merdeka Tournament,4
Malaysia,Indonesia,4,0,Merdeka Tournament,4
Singapore,India,3,8,Friendly,5
Poland,Denmark,5,0,Friendly,5
France,Czechoslovakia,3,0,Friendly,3
German DR,Poland,5,0,Friendly,5
Iran,Pakistan,7,0,Friendly,7
Germany,Hungary,3,1,Friendly,2
Pakistan,Turkey,1,3,Friendly,2
Republic of Ireland,Poland,0,2,Friendly,2
Tunisia,Libya,2,0,Friendly,2
Tanzania,Kenya,2,0,Friendly,2
Tanzania,Uganda,1,4,Friendly,3
Chile,Brazil,1,5,Friendly,4
Norway,Hungary,1,3,UEFA Euro qualification,2
Suriname,Curaçao,5,1,Friendly,4
Romania,Finland,3,0,UEFA Euro qualification,3
Luxembourg,Yugoslavia,0,2,UEFA Euro qualification,2
Poland,Albania,3,0,UEFA Euro qualification,3
New Caledonia,Australia,1,3,Friendly,2
Togo,Senegal,3,0,Friendly,3
Russia,Yugoslavia,4,0,Friendly,4
Macau,Australia,0,9,Friendly,9
Malaysia,Thailand,1,4,Vietnam Independence Cup,3
Vietnam Republic,Indonesia,3,1,Vietnam Independence Cup,2
Indonesia,Malaysia,1,3,Vietnam Independence Cup,2
Zambia,Tanzania,5,1,African Cup of Nations qualification,4
Uganda,DR Congo,1,4,African Cup of Nations qualification,3
Hong Kong,South Korea,0,3,King's Cup,3
Thailand,Singapore,3,1,King's Cup,2
France,Norway,3,1,UEFA Euro qualification,2
Indonesia,Vietnam Republic,5,3,King's Cup,2
Spain,Northern Ireland,3,0,UEFA Euro qualification,3
South Korea,Laos,4,0,King's Cup,4
Indonesia,Malaysia,3,0,King's Cup,3
Laos,Singapore,3,0,King's Cup,3
Cyprus,Russia,1,3,UEFA Euro qualification,2
Indonesia,Cambodia,4,1,King's Cup,3
Luxembourg,German DR,0,5,UEFA Euro qualification,5
Hong Kong,Laos,4,2,King's Cup,2
South Korea,Singapore,4,0,King's Cup,4
South Korea,Malaysia,2,0,King's Cup,2
Yugoslavia,Germany,2,0,Friendly,2
Indonesia,Malaysia,1,3,King's Cup,2
Kenya,Ethiopia,2,0,African Cup of Nations qualification,2
Greece,Germany,1,3,Friendly,2
Grenada,Saint Vincent and the Grenadines,5,3,Windward Islands Tournament,2
Belgium,Denmark,2,0,UEFA Euro qualification,2
England,German DR,3,1,Friendly,2
Grenada,Saint Lucia,6,1,Windward Islands Tournament,5
Mauritius,Madagascar,4,1,African Cup of Nations qualification,3
Netherlands,Romania,2,0,Friendly,2
Italy,Republic of Ireland,3,0,UEFA Euro qualification,3
Algeria,Morocco,3,1,African Cup of Nations qualification,2
Senegal,Malawi,4,1,Friendly,3
Mali,Niger,3,1,African Cup of Nations qualification,2
Morocco,Algeria,3,0,African Cup of Nations qualification,3
Argentina,France,2,0,Friendly,2
Kuwait,Iraq,0,2,Friendly,2
Belgium,Scotland,3,0,UEFA Euro qualification,3
Cyprus,Northern Ireland,0,3,UEFA Euro qualification,3
Uruguay,German DR,0,3,Friendly,3
Belgium,Portugal,3,0,UEFA Euro qualification,3
Netherlands,Luxembourg,6,0,UEFA Euro qualification,6
Senegal,Cameroon,3,0,Friendly,3
Cameroon,Congo,7,1,Friendly,6
Malawi,Zambia,1,3,Friendly,2
Malawi,Zambia,0,3,Friendly,3
Togo,Liberia,0,2,Friendly,2
Madagascar,Mauritius,3,0,Friendly,3
Austria,Hungary,0,2,Friendly,2
Yugoslavia,Netherlands,2,0,UEFA Euro qualification,2
Haiti,Bahamas,8,0,Friendly,8
England,Greece,3,0,UEFA Euro qualification,3
Northern Ireland,Cyprus,5,0,UEFA Euro qualification,5
Portugal,Scotland,2,0,UEFA Euro qualification,2
Switzerland,Malta,5,0,UEFA Euro qualification,5
Wales,Czechoslovakia,1,3,UEFA Euro qualification,2
Sierra Leone,Gambia,3,1,Friendly,2
Turkey,Germany,0,3,UEFA Euro qualification,3
Guinea,Gambia,4,2,Friendly,2
Indonesia,Vietnam Republic,9,1,Korea Cup,8
Ivory Coast,Ghana,2,6,Friendly,4
Myanmar,Taiwan,2,0,Korea Cup,2
Cambodia,Malaysia,1,3,Korea Cup,2
Switzerland,Poland,2,4,Friendly,2
Myanmar,Vietnam Republic,2,0,Korea Cup,2
South Korea,Malaysia,5,1,Korea Cup,4
Myanmar,Indonesia,3,1,Korea Cup,2
Malaysia,Thailand,4,1,Korea Cup,3
Cyprus,Spain,0,2,UEFA Euro qualification,2
South Korea,Cambodia,2,0,Korea Cup,2
Myanmar,Malaysia,6,1,Korea Cup,5
South Korea,Indonesia,3,0,Korea Cup,3
England,Malta,5,0,UEFA Euro qualification,5
Portugal,Denmark,5,0,UEFA Euro qualification,5
Indonesia,Malaysia,4,2,Korea Cup,2
Malaysia,Thailand,0,3,Friendly,3
Bulgaria,Hungary,3,0,UEFA Euro qualification,3
Luxembourg,Belgium,0,4,Friendly,4
Sweden,Finland,4,1,Nordic Championship,3
England,Scotland,3,1,British Home Championship,2
Malaysia,Brunei,8,0,AFC Asian Cup qualification,8
Thailand,Brunei,10,0,AFC Asian Cup qualification,10
Norway,Iceland,3,1,Friendly,2
Indonesia,Brunei,9,0,AFC Asian Cup qualification,9
Cambodia,Indonesia,2,0,AFC Asian Cup qualification,2
Republic of Ireland,Austria,1,4,UEFA Euro qualification,3
Malaysia,Indonesia,3,0,AFC Asian Cup qualification,3
Thailand,Cambodia,4,2,AFC Asian Cup qualification,2
Zambia,Ethiopia,5,1,Friendly,4
Indonesia,Singapore,3,0,Indonesia Tournament,3
Russia,Cyprus,6,1,UEFA Euro qualification,5
Myanmar,Singapore,6,0,Indonesia Tournament,6
Norway,Bulgaria,1,4,UEFA Euro qualification,3
Myanmar,Malaysia,5,1,Indonesia Tournament,4
Cambodia,Thailand,3,0,Indonesia Tournament,3
Germany,Albania,2,0,UEFA Euro qualification,2
Myanmar,Cambodia,8,0,Indonesia Tournament,8
Finland,Czechoslovakia,0,4,UEFA Euro qualification,4
Greece,Malta,2,0,UEFA Euro qualification,2
Denmark,Sweden,1,3,Nordic Championship,2
Norway,Germany,1,7,Friendly,6
Hong Kong,Thailand,6,0,Friendly,6
Denmark,Germany,1,3,Friendly,2
Zambia,Cyprus,3,0,Friendly,3
Malawi,Uganda,3,1,Friendly,2
Zambia,Cyprus,3,0,Friendly,3
Zambia,Cyprus,3,0,Friendly,3
Libya,Egypt,0,2,Friendly,2
Libya,Sudan,4,6,Friendly,2
Libya,Egypt,2,0,Friendly,2
New Caledonia,New Zealand,4,2,Friendly,2
Zambia,Guinea,4,2,Friendly,2
Zambia,Guinea,1,5,Friendly,4
Malaysia,Vietnam Republic,2,0,Merdeka Tournament,2
India,Philippines,5,1,Merdeka Tournament,4
India,Indonesia,1,3,Merdeka Tournament,2
Malaysia,Thailand,0,2,Merdeka Tournament,2
Paraguay,Chile,2,0,Friendly,2
Sweden,Norway,3,0,Nordic Championship,3
Taiwan,Thailand,4,0,Merdeka Tournament,4
Thailand,Vietnam Republic,2,4,Merdeka Tournament,2
Myanmar,Hong Kong,4,0,Merdeka Tournament,4
Indonesia,Philippines,3,1,Merdeka Tournament,2
Myanmar,Philippines,2,0,Merdeka Tournament,2
Iceland,Japan,0,2,Friendly,2
Indonesia,Singapore,4,0,Merdeka Tournament,4
Myanmar,India,9,1,Merdeka Tournament,8
Hong Kong,Indonesia,0,3,Merdeka Tournament,3
Paraguay,Peru,2,0,Friendly,2
Philippines,Thailand,3,1,Merdeka Tournament,2
Hong Kong,Vietnam Republic,1,3,Merdeka Tournament,2
Saint Lucia,Saint Vincent and the Grenadines,1,5,Friendly,4
Singapore,Malaysia,2,4,Friendly,2
India,Malaysia,6,0,Friendly,6
Tahiti,Fiji,5,2,Friendly,3
Germany,Mexico,5,0,Friendly,5
Norway,France,1,3,UEFA Euro qualification,2
Fiji,New Caledonia,1,5,South Pacific Games,4
South Korea,Iran,2,0,Friendly,2
Cook Islands,Papua New Guinea,1,16,South Pacific Games,15
Fiji,Vanuatu,4,6,South Pacific Games,2
South Korea,Iran,0,2,Friendly,2
Tahiti,Cook Islands,30,0,South Pacific Games,30
Cook Islands,Fiji,1,15,South Pacific Games,14
Suriname,Guyana,4,1,CONCACAF Championship qualification,3
New Caledonia,Papua New Guinea,4,0,South Pacific Games,4
Russia,India,5,0,Friendly,5
Tahiti,Papua New Guinea,8,1,South Pacific Games,7
New Caledonia,Vanuatu,7,1,South Pacific Games,6
Finland,Romania,0,4,UEFA Euro qualification,4
Poland,Turkey,5,1,UEFA Euro qualification,4
Yugoslavia,Mexico,4,0,Friendly,4
Hungary,Bulgaria,2,0,UEFA Euro qualification,2
Italy,Mexico,2,0,Friendly,2
Norway,Denmark,1,4,Nordic Championship,3
Switzerland,Turkey,4,0,Friendly,4
Uganda,Zanzibar,3,1,Friendly,2
Kenya,Zanzibar,4,0,Friendly,4
Kenya,Uganda,2,0,Friendly,2
Bermuda,Mexico,0,2,CONCACAF Championship qualification,2
Mexico,Bermuda,4,0,CONCACAF Championship qualification,4
France,Hungary,0,2,UEFA Euro qualification,2
Italy,Sweden,3,0,UEFA Euro qualification,3
Austria,Republic of Ireland,6,0,UEFA Euro qualification,6
Lesotho,Malawi,0,2,Friendly,2
Poland,Germany,1,3,UEFA Euro qualification,2
Morocco,Egypt,3,0,African Cup of Nations qualification,3
Wales,Finland,3,0,UEFA Euro qualification,3
Zambia,Kenya,0,2,Friendly,2
Zambia,Kenya,3,1,Friendly,2
DR Congo,Zambia,3,0,African Cup of Nations qualification,3
Congo,Ivory Coast,2,0,African Cup of Nations qualification,2
Mali,Guinea,3,1,African Cup of Nations qualification,2
Hungary,Norway,4,0,UEFA Euro qualification,4
Uruguay,Chile,3,0,Copa Juan Pinto Durán,3
Vietnam Republic,Thailand,3,0,Vietnam Independence Cup,3
Singapore,Thailand,3,1,Vietnam Independence Cup,2
Chile,Uruguay,5,0,Copa Juan Pinto Durán,5
Thailand,Singapore,2,0,King's Cup,2
Indonesia,Malaysia,2,0,King's Cup,2
Albania,Turkey,3,0,UEFA Euro qualification,3
Malta,Hungary,0,2,FIFA World Cup qualification,2
Netherlands,Luxembourg,8,0,UEFA Euro qualification,8
Iraq,Kuwait,3,1,Friendly,2
Cuba,Costa Rica,0,3,CONCACAF Championship,3
Australia,Israel,1,3,Friendly,2
Cuba,Honduras,3,1,CONCACAF Championship,2
Romania,Wales,2,0,UEFA Euro qualification,2
Spain,Cyprus,7,0,UEFA Euro qualification,7
Trinidad and Tobago,Mexico,0,2,CONCACAF Championship,2
Grenada,Saint Lucia,5,2,Windward Islands Tournament,3
Nigeria,Burkina Faso,4,0,Friendly,4
Dominica,Saint Vincent and the Grenadines,3,0,Windward Islands Tournament,3
Trinidad and Tobago,Haiti,1,6,CONCACAF Championship,5
Barbados,Curaçao,1,3,Friendly,2
Greece,England,0,2,UEFA Euro qualification,2
Guinea,Nigeria,3,0,Friendly,3
Haiti,Honduras,3,1,CONCACAF Championship,2
Dominica,Grenada,3,0,Windward Islands Tournament,3
Trinidad and Tobago,Costa Rica,3,1,CONCACAF Championship,2
Tanzania,Burundi,4,1,Friendly,3
Bahrain,Lebanon,3,0,AFC Asian Cup qualification,3
Kenya,Zambia,0,2,Friendly,2
Iraq,Sri Lanka,5,0,AFC Asian Cup qualification,5
Iraq,Jordan,2,0,AFC Asian Cup qualification,2
Senegal,Mali,4,1,Friendly,3
Bahrain,Sri Lanka,3,0,AFC Asian Cup qualification,3
Kuwait,Jordan,2,0,AFC Asian Cup qualification,2
Iraq,Lebanon,4,1,AFC Asian Cup qualification,3
Lebanon,Jordan,2,0,AFC Asian Cup qualification,2
Algeria,Palestine,2,0,Palestine Cup,2
Algeria,Qatar,3,0,Palestine Cup,3
Palestine,Syria,1,3,Palestine Cup,2
Egypt,Kuwait,2,0,Palestine Cup,2
Iraq,Libya,3,0,Palestine Cup,3
Iraq,Kuwait,3,1,Palestine Cup,2
Senegal,Congo,0,2,Friendly,2
Algeria,Yemen DPR,4,1,Palestine Cup,3
Palestine,Qatar,7,2,Palestine Cup,5
Iraq,Algeria,3,1,Palestine Cup,2
Egypt,Syria,4,2,Palestine Cup,2
Algeria,Syria,3,1,Palestine Cup,2
Iraq,Egypt,1,3,Palestine Cup,2
Somalia,China PR,1,3,Friendly,2
Togo,Benin,4,0,Friendly,4
Mexico,Chile,2,0,Friendly,2
Greece,Netherlands,0,5,Friendly,5
Senegal,Morocco,1,3,Friendly,2
Nigeria,Morocco,3,0,Friendly,3
Cameroon,Togo,2,0,African Cup of Nations,2
Congo,DR Congo,0,2,African Cup of Nations,2
Congo,Sudan,4,2,African Cup of Nations,2
Cameroon,DR Congo,5,2,African Cup of Nations,3
Guinea,Algeria,5,1,FIFA World Cup qualification,4
Bahrain,Kuwait,0,2,Gulf Cup,2
Saudi Arabia,United Arab Emirates,4,0,Gulf Cup,4
Bahrain,Qatar,6,2,Gulf Cup,4
Kuwait,United Arab Emirates,7,0,Gulf Cup,7
Saudi Arabia,Qatar,4,0,Gulf Cup,4
Bahrain,United Arab Emirates,2,0,Gulf Cup,2
Kuwait,Qatar,5,0,Gulf Cup,5
Hungary,Germany,0,2,Friendly,2
Portugal,Cyprus,4,0,FIFA World Cup qualification,4
Jamaica,Cuba,2,0,Friendly,2
Czechoslovakia,Austria,2,0,Friendly,2
Romania,France,2,0,Friendly,2
Haiti,Puerto Rico,7,0,CONCACAF Championship qualification,7
Russia,Peru,2,0,Friendly,2
Puerto Rico,Haiti,0,5,CONCACAF Championship qualification,5
Czechoslovakia,Luxembourg,6,0,Friendly,6
Scotland,Peru,2,0,Friendly,2
England,Germany,1,3,UEFA Euro qualification,2
Austria,Malta,4,0,FIFA World Cup qualification,4
Netherlands,Peru,3,0,Friendly,3
Hungary,Malta,3,0,FIFA World Cup qualification,3
Iran,Cambodia,2,0,AFC Asian Cup,2
Thailand,Kuwait,0,2,AFC Asian Cup,2
Iran,Iraq,3,0,AFC Asian Cup,3
Cambodia,South Korea,1,4,AFC Asian Cup,3
Russia,Yugoslavia,3,0,UEFA Euro qualification,3
Cambodia,Kuwait,4,0,AFC Asian Cup,4
Kenya,Madagascar,1,3,Friendly,2
Belgium,Iceland,4,0,FIFA World Cup qualification,4
Scotland,Northern Ireland,2,0,British Home Championship,2
Wales,England,0,3,British Home Championship,3
Belgium,Iceland,4,0,FIFA World Cup qualification,4
Spain,Uruguay,2,0,Friendly,2
Germany,Russia,4,1,Friendly,3
Mauritius,Uganda,1,3,Friendly,2
Liberia,Guinea,0,2,Friendly,2
Sierra Leone,Ghana,3,1,Friendly,2
Zambia,Lesotho,6,1,FIFA World Cup qualification,5
Tunisia,Algeria,3,1,Friendly,2
Cambodia,Singapore,3,0,Indonesia Tournament,3
Denmark,Finland,3,0,Nordic Championship,3
Cambodia,Thailand,2,0,Indonesia Tournament,2
Philippines,Singapore,2,0,Indonesia Tournament,2
Myanmar,Sri Lanka,4,2,Indonesia Tournament,2
Austria,Sweden,2,0,FIFA World Cup qualification,2
Kenya,Uganda,2,0,Friendly,2
Bolivia,Peru,0,3,Brazil Independence Cup,3
Myanmar,Laos,6,1,Indonesia Tournament,5
Ecuador,Portugal,0,3,Brazil Independence Cup,3
Paraguay,Venezuela,4,1,Brazil Independence Cup,3
Laos,Sri Lanka,1,3,Indonesia Tournament,2
Iran,Portugal,0,3,Brazil Independence Cup,3
Venezuela,Yugoslavia,0,10,Brazil Independence Cup,10
Benin,Congo,5,3,Friendly,2
Benin,Ghana,0,5,FIFA World Cup qualification,5
Chile,Portugal,1,4,Brazil Independence Cup,3
Germany,Russia,3,0,UEFA Euro,3
Myanmar,Cambodia,0,3,Indonesia Tournament,3
DR Congo,Togo,4,0,FIFA World Cup qualification,4
Argentina,Colombia,4,1,Brazil Independence Cup,3
Singapore,Sri Lanka,3,1,Friendly,2
Bolivia,Paraguay,1,6,Brazil Independence Cup,5
Argentina,Portugal,1,3,Brazil Independence Cup,2
Sweden,Denmark,2,0,Nordic Championship,2
Brazil,Yugoslavia,3,0,Brazil Independence Cup,3
DR Congo,Guinea,6,0,Friendly,6
Ghana,Benin,5,1,FIFA World Cup qualification,4
Iceland,Denmark,2,5,Friendly,3
Tanzania,Sudan,3,0,Friendly,3
Malawi,Lesotho,4,0,Friendly,4
Argentina,Yugoslavia,2,4,Brazil Independence Cup,2
Uganda,Sudan,4,0,Friendly,4
Zanzibar,Nigeria,1,4,Friendly,3
Iceland,Faroe Islands,3,0,Friendly,3
Malaysia,Sri Lanka,4,1,Merdeka Tournament,3
Japan,Cambodia,4,1,Merdeka Tournament,3
Singapore,Thailand,0,2,Merdeka Tournament,2
Japan,Sri Lanka,5,0,Merdeka Tournament,5
Kenya,Sudan,2,0,FIFA World Cup qualification,2
Hong Kong,Singapore,4,1,Merdeka Tournament,3
South Korea,Thailand,2,0,Merdeka Tournament,2
Japan,Philippines,5,1,Merdeka Tournament,4
Malaysia,Cambodia,6,1,Merdeka Tournament,5
South Korea,Singapore,4,1,Merdeka Tournament,3
Philippines,Sri Lanka,4,1,Merdeka Tournament,3
Cambodia,Sri Lanka,6,1,Merdeka Tournament,5
Malaysia,Japan,3,1,Merdeka Tournament,2
Indonesia,South Korea,0,2,Merdeka Tournament,2
Singapore,Sri Lanka,6,1,Merdeka Tournament,5
Japan,South Korea,0,3,Merdeka Tournament,3
Philippines,Thailand,0,4,Merdeka Tournament,4
Indonesia,Philippines,3,0,Friendly,3
Singapore,Sri Lanka,6,1,Friendly,5
Norway,Iceland,4,1,FIFA World Cup qualification,3
Japan,Philippines,4,1,Friendly,3
Singapore,Hong Kong,0,2,Friendly,2
Cambodia,Indonesia,0,5,Friendly,5
Chile,Mexico,0,2,Friendly,2
Greece,France,1,3,Friendly,2
Mexico,United States,3,1,CONCACAF Championship qualification,2
New Zealand,New Caledonia,4,1,Friendly,3
Norway,Sweden,1,3,Nordic Championship,2
Italy,Yugoslavia,3,1,Friendly,2
South Korea,Thailand,3,0,Korea Cup,3
Myanmar,Philippines,4,0,Korea Cup,4
South Korea,Cambodia,3,1,Korea Cup,2
Philippines,Singapore,0,5,Korea Cup,5
South Korea,Malaysia,2,0,Korea Cup,2
Indonesia,Malaysia,3,1,Korea Cup,2
Singapore,Thailand,1,4,Korea Cup,3
Myanmar,Indonesia,3,1,Korea Cup,2
Costa Rica,El Salvador,2,0,Friendly,2
Norway,Belgium,0,2,FIFA World Cup qualification,2
German DR,Finland,5,0,FIFA World Cup qualification,5
Indonesia,Australia,1,4,Friendly,3
Luxembourg,Italy,0,4,FIFA World Cup qualification,4
Australia,New Zealand,3,1,Friendly,2
Saint Kitts and Nevis,Trinidad and Tobago,0,3,Friendly,3
Mexico,Costa Rica,3,1,Friendly,2
China PR,Nepal,6,2,Friendly,4
New Caledonia,New Zealand,3,1,Friendly,2
Poland,Czechoslovakia,3,0,Friendly,3
Sweden,Malta,7,0,FIFA World Cup qualification,7
Bulgaria,Northern Ireland,3,0,FIFA World Cup qualification,3
Denmark,Scotland,1,4,FIFA World Cup qualification,3
Luxembourg,Turkey,2,0,FIFA World Cup qualification,2
South Korea,Australia,0,2,Friendly,2
Peru,Argentina,0,2,Copa Ramón Castilla,2
Ivory Coast,Sierra Leone,2,0,FIFA World Cup qualification,2
Philippines,Australia,0,6,Friendly,6
Romania,Albania,2,0,FIFA World Cup qualification,2
Vietnam Republic,Singapore,4,1,Vietnam Independence Cup,3
Czechoslovakia,German DR,1,3,Friendly,2
Malaysia,Singapore,1,3,Vietnam Independence Cup,2
Netherlands,Norway,9,0,FIFA World Cup qualification,9
Trinidad and Tobago,Antigua and Barbuda,11,1,CONCACAF Championship qualification,10
Germany,Switzerland,5,1,Friendly,4
Scotland,Denmark,2,0,FIFA World Cup qualification,2
South Korea,Malaysia,4,1,King's Cup,3
Thailand,Singapore,4,0,King's Cup,4
Cyprus,Bulgaria,0,4,FIFA World Cup qualification,4
Thailand,Malaysia,0,2,King's Cup,2
Malaysia,Singapore,2,0,King's Cup,2
South Korea,Singapore,2,0,King's Cup,2
Liberia,Nigeria,1,3,Friendly,2
Thailand,Indonesia,3,0,King's Cup,3
Malta,Austria,0,2,FIFA World Cup qualification,2
Indonesia,Malaysia,0,2,King's Cup,2
Antigua and Barbuda,Suriname,0,6,CONCACAF Championship qualification,6
Nigeria,Mali,3,0,Friendly,3
Antigua and Barbuda,Suriname,1,3,CONCACAF Championship qualification,2
Ethiopia,Tanzania,3,0,FIFA World Cup qualification,3
Mauritius,Kenya,1,3,FIFA World Cup qualification,2
Turkey,Luxembourg,3,0,FIFA World Cup qualification,3
Nigeria,Sierra Leone,4,0,Friendly,4
Haiti,Curaçao,3,0,Friendly,3
Panama,Puerto Rico,5,0,Friendly,5
Haiti,Curaçao,4,1,Friendly,3
Tunisia,Egypt,2,0,FIFA World Cup qualification,2
Nigeria,Benin,3,0,Friendly,3
Bermuda,Jamaica,0,3,Friendly,3
Uganda,Congo,3,1,Friendly,2
Cyprus,Bulgaria,0,3,Friendly,3
Guyana,Haiti,1,3,Friendly,2
Indonesia,Bulgaria,0,4,Friendly,4
Tunisia,Yugoslavia,0,5,Friendly,5
Haiti,Trinidad and Tobago,4,2,Friendly,2
Mexico,Argentina,2,0,Friendly,2
New Caledonia,Bulgaria,3,5,Friendly,2
Chile,Tahiti,10,1,Friendly,9
Scotland,England,0,5,Friendly,5
Turkey,Algeria,4,0,Friendly,4
Colombia,German DR,0,2,Friendly,2
Australia,Bulgaria,1,3,Friendly,2
Morocco,Senegal,3,1,Friendly,2
New Zealand,Fiji,5,1,Oceania Nations Cup,4
Australia,Bulgaria,0,2,Friendly,2
New Caledonia,Vanuatu,4,1,Oceania Nations Cup,3
Fiji,New Caledonia,0,2,Oceania Nations Cup,2
Spain,Greece,3,1,FIFA World Cup qualification,2
Fiji,Tahiti,0,4,Oceania Nations Cup,4
New Zealand,Vanuatu,3,1,Oceania Nations Cup,2
New Zealand,Tahiti,2,0,Oceania Nations Cup,2
Morocco,Guinea,2,0,FIFA World Cup qualification,2
DR Congo,Cameroon,2,0,FIFA World Cup qualification,2
Peru,Guatemala,5,1,Friendly,4
Australia,Iraq,3,1,FIFA World Cup qualification,2
Iraq,New Zealand,2,0,FIFA World Cup qualification,2
Bermuda,United States,4,0,Friendly,4
Poland,United States,4,0,Friendly,4
Australia,Indonesia,6,0,FIFA World Cup qualification,6
Iraq,New Zealand,4,0,FIFA World Cup qualification,4
Peru,Bolivia,2,0,Friendly,2
Germany,Czechoslovakia,3,0,Friendly,3
Wales,Poland,2,0,FIFA World Cup qualification,2
Italy,Luxembourg,5,0,FIFA World Cup qualification,5
Central African Republic,Ivory Coast,4,2,African Cup of Nations qualification,2
German DR,Albania,2,0,FIFA World Cup qualification,2
Tanzania,Ethiopia,3,0,African Cup of Nations qualification,3
Kuwait,Qatar,9,0,Friendly,9
Burkina Faso,DR Congo,0,5,African Cup of Nations qualification,5
Zambia,Ethiopia,4,2,FIFA World Cup qualification,2
Kuwait,Qatar,4,1,Friendly,3
Belgium,German DR,3,0,Friendly,3
Russia,Romania,2,0,Friendly,2
Turkey,Bulgaria,5,2,Balkan Cup,3
Mauritius,Lesotho,5,1,African Cup of Nations qualification,4
DR Congo,Burkina Faso,4,1,African Cup of Nations qualification,3
Peru,Panama,4,0,Friendly,4
Mali,Sierra Leone,4,2,African Cup of Nations qualification,2
Peru,Chile,2,0,FIFA World Cup qualification,2
Albania,Romania,1,4,FIFA World Cup qualification,3
Northern Ireland,Cyprus,3,0,FIFA World Cup qualification,3
Syria,Kuwait,2,0,FIFA World Cup qualification,2
Germany,Bulgaria,3,0,Friendly,3
Wales,Scotland,0,2,British Home Championship,2
Chile,Peru,2,0,FIFA World Cup qualification,2
Iran,Kuwait,2,0,FIFA World Cup qualification,2
North Korea,Syria,3,0,FIFA World Cup qualification,3
England,Wales,3,0,British Home Championship,3
North Korea,Kuwait,0,2,FIFA World Cup qualification,2
Poland,Republic of Ireland,2,0,Friendly,2
Israel,Malaysia,3,0,FIFA World Cup qualification,3
South Korea,Thailand,4,0,FIFA World Cup qualification,4
Vietnam Republic,Japan,0,4,FIFA World Cup qualification,4
Israel,Thailand,6,0,FIFA World Cup qualification,6
Thailand,Malaysia,0,2,FIFA World Cup qualification,2
South Korea,Hong Kong,3,1,FIFA World Cup qualification,2
Russia,France,2,0,FIFA World Cup qualification,2
Brazil,Bolivia,5,0,Friendly,5
Czechoslovakia,Denmark,6,0,FIFA World Cup qualification,6
Algeria,Brazil,0,2,Friendly,2
Morocco,Ivory Coast,4,1,FIFA World Cup qualification,3
Zambia,Madagascar,3,1,African Cup of Nations qualification,2
Finland,German DR,1,5,FIFA World Cup qualification,4
Poland,England,2,0,FIFA World Cup qualification,2
Tunisia,Brazil,1,4,Friendly,3
Faroe Islands,Iceland,0,4,Friendly,4
Italy,Brazil,2,0,Friendly,2
China PR,Pakistan,7,4,Friendly,3
DR Congo,Cameroon,2,0,African Cup of Nations qualification,2
Indonesia,Malaysia,2,0,Indonesia Tournament,2
Italy,England,2,0,Friendly,2
China PR,Somalia,7,4,Friendly,3
South Korea,Japan,2,0,Friendly,2
Peru,Colombia,3,1,Friendly,2
Malawi,Mauritius,4,1,Friendly,3
Uruguay,Ecuador,4,0,FIFA World Cup qualification,4
Bolivia,Peru,2,0,Friendly,2
Ghana,Ivory Coast,0,3,African Cup of Nations qualification,3
Zambia,Nigeria,5,1,African Cup of Nations qualification,4
Egypt,Tanzania,10,1,Friendly,9
Chile,Argentina,3,1,Copa Carlos Dittborn,2
Iceland,German DR,0,2,Friendly,2
Chile,Bolivia,3,0,Friendly,3
Norway,North Korea,3,0,Friendly,3
Argentina,Peru,3,1,Copa Ramón Castilla,2
Kuwait,Singapore,2,0,Merdeka Tournament,2
Ivory Coast,Central African Republic,5,1,African Cup of Nations qualification,4
India,Thailand,2,0,Merdeka Tournament,2
Canada,Poland,1,3,Friendly,2
Iceland,Norway,0,4,FIFA World Cup qualification,4
China PR,Guinea,5,2,Friendly,3
Malaysia,India,4,0,Merdeka Tournament,4
India,Cambodia,3,0,Merdeka Tournament,3
Myanmar,Kuwait,2,0,Merdeka Tournament,2
Canada,United States,0,2,Friendly,2
Cambodia,Thailand,1,4,Merdeka Tournament,3
Bangladesh,Myanmar,0,6,Merdeka Tournament,6
Cambodia,Singapore,0,3,Merdeka Tournament,3
United States,Poland,0,4,Friendly,4
Bangladesh,Thailand,0,2,Merdeka Tournament,2
Egypt,Yemen DPR,6,1,Palestine Cup,5
Malaysia,Kuwait,3,1,Merdeka Tournament,2
Zambia,Kenya,2,0,FIFA World Cup qualification,2
Algeria,United Arab Emirates,2,0,Palestine Cup,2
Iraq,Yemen,2,0,Palestine Cup,2
Syria,Tunisia,1,4,Palestine Cup,3
Libya,Yemen,10,0,Palestine Cup,10
Syria,Yemen DPR,7,1,Palestine Cup,6
Egypt,Palestine,2,0,Palestine Cup,2
Algeria,Yemen,15,1,Palestine Cup,14
Australia,Iran,3,0,FIFA World Cup qualification,3
Bulgaria,Poland,0,2,Friendly,2
DR Congo,Ghana,4,1,FIFA World Cup qualification,3
Tunisia,Yemen DPR,2,0,Palestine Cup,2
Egypt,Syria,0,2,Palestine Cup,2
Iraq,United Arab Emirates,3,1,Palestine Cup,2
Libya,Algeria,0,2,Palestine Cup,2
Palestine,Tunisia,2,6,Palestine Cup,4
Netherlands,Iceland,5,0,FIFA World Cup qualification,5
Iraq,Tunisia,0,2,Palestine Cup,2
Iran,Australia,2,0,FIFA World Cup qualification,2
Syria,Tunisia,0,4,Palestine Cup,4
Netherlands,Iceland,8,1,FIFA World Cup qualification,7
France,Greece,3,1,Friendly,2
Argentina,Bolivia,4,0,FIFA World Cup qualification,4
South Korea,Cambodia,6,0,Korea Cup,6
Uganda,Somalia,6,1,CECAFA Cup,5
Kenya,Zanzibar,2,0,CECAFA Cup,2
South Korea,Indonesia,3,1,Korea Cup,2
Malaysia,Thailand,5,1,Korea Cup,4
Somalia,Zambia,1,6,CECAFA Cup,5
Myanmar,Malaysia,1,3,Korea Cup,2
England,Austria,7,0,Friendly,7
German DR,Romania,2,0,FIFA World Cup qualification,2
Poland,Wales,3,0,FIFA World Cup qualification,3
Cambodia,Malaysia,2,0,Korea Cup,2
Malta,Canada,2,0,Friendly,2
Italy,Sweden,2,0,Friendly,2
South Korea,Malaysia,2,0,Korea Cup,2
Paraguay,Bolivia,4,0,FIFA World Cup qualification,4
Argentina,Paraguay,3,1,FIFA World Cup qualification,2
Luxembourg,Canada,0,2,Friendly,2
Germany,Austria,4,0,Friendly,4
Trinidad and Tobago,Martinique,2,0,Friendly,2
Romania,Finland,9,0,FIFA World Cup qualification,9
Mexico,United States,2,0,Friendly,2
Italy,Switzerland,2,0,FIFA World Cup qualification,2
Zambia,Morocco,4,0,FIFA World Cup qualification,4
Algeria,Morocco,2,0,Friendly,2
Belgium,Norway,2,0,FIFA World Cup qualification,2
Vietnam Republic,Malaysia,1,5,Vietnam Independence Cup,4
Vietnam Republic,Singapore,4,2,Vietnam Independence Cup,2
Zambia,DR Congo,0,2,FIFA World Cup qualification,2
Barbados,Suriname,0,2,Friendly,2
Guadeloupe,Martinique,0,2,Friendly,2
Dominica,Grenada,4,2,Windward Islands Tournament,2
Guyana,Suriname,0,2,Friendly,2
Haiti,Canada,5,1,Friendly,4
Saint Vincent and the Grenadines,Grenada,4,1,Windward Islands Tournament,3
Albania,German DR,1,4,FIFA World Cup qualification,3
Israel,United States,3,1,Friendly,2
Israel,United States,2,0,Friendly,2
Saint Lucia,Grenada,1,3,Windward Islands Tournament,2
Bulgaria,Cyprus,2,0,FIFA World Cup qualification,2
Turkey,Switzerland,2,0,FIFA World Cup qualification,2
France,Denmark,3,0,Friendly,3
Saint Vincent and the Grenadines,Saint Lucia,2,0,Windward Islands Tournament,2
Morocco,Zambia,2,0,FIFA World Cup qualification,2
Grenada,Saint Lucia,2,0,Windward Islands Tournament,2
Haiti,Curaçao,3,0,CONCACAF Championship,3
Panama,Nicaragua,2,0,Friendly,2
Mexico,Curaçao,8,0,CONCACAF Championship,8
DR Congo,Morocco,3,0,FIFA World Cup qualification,3
Uganda,Zambia,2,0,Friendly,2
Kenya,Zambia,3,1,Friendly,2
Mexico,Trinidad and Tobago,0,4,CONCACAF Championship,4
Cambodia,South Korea,0,5,King's Cup,5
Myanmar,Singapore,6,1,King's Cup,5
Curaçao,Trinidad and Tobago,0,4,CONCACAF Championship,4
Thailand,Laos,5,0,King's Cup,5
Greece,Yugoslavia,2,4,FIFA World Cup qualification,2
Thailand,Singapore,3,0,King's Cup,3
Myanmar,South Korea,0,2,King's Cup,2
Uganda,Congo,0,2,Friendly,2
Mauritius,Malawi,4,1,Friendly,3
Cyprus,Bulgaria,1,4,Friendly,3
Kuwait,Bulgaria,1,3,Friendly,2
Ghana,Guinea,5,2,Friendly,3
Ghana,Guinea,3,1,Friendly,2
Kuwait,Morocco,0,2,Friendly,2
Tunisia,German DR,0,4,Friendly,4
Algeria,German DR,1,3,Friendly,2
Congo,Mauritius,2,0,African Cup of Nations,2
Egypt,Zambia,3,1,African Cup of Nations,2
Egypt,Ivory Coast,2,0,African Cup of Nations,2
Togo,Denmark,0,2,Friendly,2
Mauritius,DR Congo,1,4,African Cup of Nations,3
Congo,Zambia,2,4,African Cup of Nations,2
Benin,Denmark,2,0,Friendly,2
Egypt,Congo,4,0,African Cup of Nations,4
Réunion,Seychelles,2,0,Friendly,2
DR Congo,Zambia,2,0,African Cup of Nations,2
Kuwait,United Arab Emirates,2,0,Gulf Cup,2
Bahrain,Oman,4,0,Gulf Cup,4
Qatar,Saudi Arabia,0,2,Gulf Cup,2
Bahrain,United Arab Emirates,0,4,Gulf Cup,4
Kuwait,Oman,5,0,Gulf Cup,5
Bahrain,Saudi Arabia,1,4,Gulf Cup,3
Oman,Qatar,0,4,Gulf Cup,4
Saudi Arabia,United Arab Emirates,2,0,Gulf Cup,2
Kuwait,United Arab Emirates,6,0,Gulf Cup,6
Qatar,Saudi Arabia,1,3,Gulf Cup,2
Jamaica,Uruguay,0,3,Friendly,3
Kuwait,Saudi Arabia,4,0,Gulf Cup,4
Hungary,Bulgaria,3,1,Friendly,2
Morocco,Algeria,2,0,Friendly,2
Haiti,Poland,1,3,Friendly,2
Brazil,Romania,2,0,Friendly,2
Germany,Hungary,5,0,Friendly,5
Brazil,Haiti,4,0,Friendly,4
Germany,Sweden,2,0,Friendly,2
Yemen DPR,Iraq,2,0,Friendly,2
China PR,Sierra Leone,4,1,Friendly,3
Bulgaria,Turkey,5,1,Balkan Cup,4
Uruguay,Republic of Ireland,2,0,Friendly,2
Wales,England,0,2,British Home Championship,2
Brazil,Paraguay,2,0,Friendly,2
Scotland,Wales,2,0,British Home Championship,2
Poland,Greece,2,0,Friendly,2
South Korea,Myanmar,3,0,Korea Cup,3
Scotland,England,2,0,British Home Championship,2
Myanmar,Cambodia,6,0,Korea Cup,6
Bulgaria,North Korea,6,1,Friendly,5
Netherlands,Argentina,4,1,Friendly,3
Romania,Greece,3,1,Balkan Cup,2
Indonesia,Myanmar,2,4,Indonesia Tournament,2
Myanmar,Malaysia,3,0,Indonesia Tournament,3
Denmark,Sweden,0,2,Nordic Championship,2
DR Congo,Scotland,0,2,FIFA World Cup,2
German DR,Australia,2,0,FIFA World Cup,2
Italy,Haiti,3,1,FIFA World Cup,2
Uruguay,Netherlands,0,2,FIFA World Cup,2
Germany,Australia,3,0,FIFA World Cup,3
Yugoslavia,DR Congo,9,0,FIFA World Cup,9
Haiti,Poland,0,7,FIFA World Cup,7
DR Congo,Brazil,0,3,FIFA World Cup,3
Argentina,Haiti,4,1,FIFA World Cup,3
Bulgaria,Netherlands,1,4,FIFA World Cup,3
Sweden,Uruguay,3,0,FIFA World Cup,3
Germany,Yugoslavia,2,0,FIFA World Cup,2
Netherlands,Argentina,4,0,FIFA World Cup,4
German DR,Netherlands,0,2,FIFA World Cup,2
Germany,Sweden,4,2,FIFA World Cup,2
Netherlands,Brazil,2,0,FIFA World Cup,2
China PR,Togo,4,2,Friendly,2
Malawi,Ivory Coast,5,1,Friendly,4
Nigeria,Ivory Coast,2,0,Friendly,2
Silesia,Tanzania,7,2,Friendly,5
India,Thailand,4,2,Merdeka Tournament,2
Malaysia,India,4,1,Merdeka Tournament,3
Indonesia,Singapore,5,0,Merdeka Tournament,5
Somalia,Burundi,0,2,African Cup of Nations qualification,2
China PR,Senegal,5,2,Friendly,3
Iraq,Bahrain,4,0,Friendly,4
Denmark,Indonesia,9,0,Friendly,9
Poland,German DR,1,3,Friendly,2
Sweden,Netherlands,1,5,Friendly,4
Mexico,United States,3,1,Friendly,2
Libya,DR Congo,0,2,Friendly,2
Poland,France,0,2,Friendly,2
Iceland,Belgium,0,2,UEFA Euro qualification,2
Czechoslovakia,German DR,3,1,Friendly,2
Finland,Netherlands,1,3,UEFA Euro qualification,2
Syria,Palestine,2,0,Kuneitra Cup,2
Algeria,Lebanon,4,1,Kuneitra Cup,3
Japan,South Korea,4,1,Friendly,3
Yemen,Sudan,0,6,Kuneitra Cup,6
Algeria,Jordan,6,0,Kuneitra Cup,6
Libya,Yemen,9,1,Kuneitra Cup,8
Palestine,Sudan,1,3,Kuneitra Cup,2
Morocco,Tunisia,3,1,Kuneitra Cup,2
Libya,Sudan,1,3,Kuneitra Cup,2
Syria,Yemen,6,0,Kuneitra Cup,6
Palestine,Yemen,7,1,Kuneitra Cup,6
Morocco,Sudan,2,0,Kuneitra Cup,2
German DR,Canada,2,0,Friendly,2
Poland,Finland,3,0,UEFA Euro qualification,3
Sudan,Tunisia,1,3,Kuneitra Cup,2
Czechoslovakia,Sweden,4,0,Friendly,4
Luxembourg,Hungary,2,4,UEFA Euro qualification,2
England,Czechoslovakia,3,0,UEFA Euro qualification,3
Republic of Ireland,Russia,3,0,UEFA Euro qualification,3
Scotland,German DR,3,0,Friendly,3
Sweden,Northern Ireland,0,2,UEFA Euro qualification,2
Wales,Hungary,2,0,UEFA Euro qualification,2
Yugoslavia,Norway,3,1,UEFA Euro qualification,2
Poland,Canada,2,0,Friendly,2
Chile,Argentina,0,2,Copa Carlos Dittborn,2
Switzerland,Portugal,3,0,Friendly,3
Greece,Cyprus,3,1,Friendly,2
Netherlands,Italy,3,1,UEFA Euro qualification,2
Wales,Luxembourg,5,0,UEFA Euro qualification,5
Liberia,Togo,0,2,African Cup of Nations qualification,2
Morocco,Gambia,3,0,African Cup of Nations qualification,3
Saint Lucia,Dominica,0,3,Windward Islands Tournament,3
Gambia,Morocco,0,3,African Cup of Nations qualification,3
Laos,Singapore,0,2,King's Cup,2
Thailand,Malaysia,0,2,King's Cup,2
Thailand,Laos,6,1,King's Cup,5
Cambodia,Vietnam Republic,2,0,King's Cup,2
Thailand,Malaysia,4,1,King's Cup,3
Cambodia,Malaysia,0,3,King's Cup,3
Thailand,South Korea,1,3,King's Cup,2
Indonesia,South Korea,1,3,Friendly,2
Bermuda,Suriname,1,3,Friendly,2
Kuwait,Tunisia,2,0,Friendly,2
Bermuda,Suriname,2,5,Friendly,3
Cuba,Canada,4,0,Friendly,4
Iraq,Libya,3,1,Friendly,2
Mali,Guinea,0,2,Friendly,2
Guinea,Cameroon,3,0,Friendly,3
Liberia,Cameroon,2,0,Friendly,2
Malawi,Mauritius,3,0,Friendly,3
Italy,Norway,4,1,Friendly,3
Burkina Faso,Niger,4,1,Friendly,3
Malta,Greece,2,0,UEFA Euro qualification,2
Tanzania,Malawi,3,1,Friendly,2
Tanzania,Malawi,2,0,Friendly,2
Zanzibar,Malawi,2,7,Friendly,5
England,Germany,2,0,Friendly,2
Thailand,Indonesia,3,1,AFC Asian Cup qualification,2
Thailand,Vietnam Republic,4,0,AFC Asian Cup qualification,4
Morocco,Senegal,4,0,African Cup of Nations qualification,4
Niger,Guinea,2,4,African Cup of Nations qualification,2
Uganda,Mauritius,4,0,African Cup of Nations qualification,4
Ghana,Burkina Faso,3,1,Friendly,2
Malaysia,Vietnam Republic,3,0,AFC Asian Cup qualification,3
Kenya,Sudan,0,2,African Cup of Nations qualification,2
Burundi,Egypt,0,3,African Cup of Nations qualification,3
France,Hungary,2,0,Friendly,2
Poland,United States,7,0,Friendly,7
Ghana,Mali,4,0,African Cup of Nations qualification,4
Malawi,Zambia,1,6,African Cup of Nations qualification,5
Guadeloupe,Suriname,4,2,Friendly,2
Italy,United States,10,0,Friendly,10
Russia,Turkey,3,0,UEFA Euro qualification,3
Saudi Arabia,Afghanistan,2,0,AFC Asian Cup qualification,2
Iraq,Afghanistan,4,0,AFC Asian Cup qualification,4
Guinea,Niger,3,0,African Cup of Nations qualification,3
Iraq,Qatar,3,0,AFC Asian Cup qualification,3
Saudi Arabia,Afghanistan,6,0,AFC Asian Cup qualification,6
Mali,Ghana,3,1,African Cup of Nations qualification,2
Cameroon,Togo,3,0,African Cup of Nations qualification,3
Iraq,Afghanistan,3,1,AFC Asian Cup qualification,2
England,Cyprus,5,0,UEFA Euro qualification,5
Egypt,Burundi,2,0,African Cup of Nations qualification,2
Togo,Cameroon,4,0,African Cup of Nations qualification,4
Czechoslovakia,Cyprus,4,0,UEFA Euro qualification,4
France,Portugal,0,2,Friendly,2
Ivory Coast,Togo,0,3,Friendly,3
Czechoslovakia,Portugal,5,0,UEFA Euro qualification,5
Luxembourg,Wales,1,3,UEFA Euro qualification,2
Martinique,Guadeloupe,8,2,Friendly,6
Romania,Denmark,6,1,UEFA Euro qualification,5
Myanmar,Thailand,4,1,Korea Cup,3
Finland,Norway,3,5,Nordic Championship,2
Sweden,Algeria,4,0,Friendly,4
Scotland,Northern Ireland,3,0,British Home Championship,3
China PR,Equatorial Guinea,6,2,Friendly,4
England,Scotland,5,1,British Home Championship,4
Greece,Malta,4,0,UEFA Euro qualification,4
Cyprus,Portugal,0,2,UEFA Euro qualification,2
Norway,Yugoslavia,1,3,UEFA Euro qualification,2
Bulgaria,Malta,5,0,UEFA Euro qualification,5
Myanmar,South Korea,0,2,Indonesia Tournament,2
Indonesia,Thailand,5,0,Indonesia Tournament,5
Indonesia,Malaysia,3,1,Indonesia Tournament,2
Indonesia,Myanmar,0,2,Indonesia Tournament,2
Myanmar,Malaysia,2,0,Indonesia Tournament,2
China PR,Brunei,10,1,AFC Asian Cup qualification,9
Ecuador,Peru,6,0,Friendly,6
Iceland,Faroe Islands,6,0,Friendly,6
United States,Poland,0,4,Friendly,4
Chile,Uruguay,1,3,Copa Juan Pinto Durán,2
Denmark,Finland,2,0,Nordic Championship,2
North Korea,China PR,2,0,AFC Asian Cup qualification,2
Ghana,Morocco,2,0,African Cup of Nations qualification,2
Sweden,Norway,3,1,UEFA Euro qualification,2
Peru,Ecuador,2,0,Friendly,2
Canada,Poland,1,8,Friendly,7
Canada,Poland,1,4,Friendly,3
Malawi,Kenya,3,1,Friendly,2
Peru,Paraguay,2,0,Friendly,2
Morocco,Ghana,2,0,African Cup of Nations qualification,2
Guinea,Togo,2,0,African Cup of Nations qualification,2
New Zealand,China PR,2,0,Friendly,2
Ecuador,Colombia,1,3,Copa América,2
Fiji,China PR,1,4,Friendly,3
Bangladesh,Indonesia,0,4,Merdeka Tournament,4
Canada,German DR,0,3,Friendly,3
Malaysia,South Korea,1,3,Merdeka Tournament,2
Hong Kong,Japan,2,0,Merdeka Tournament,2
Canada,German DR,1,7,Friendly,6
Venezuela,Brazil,0,4,Copa América,4
Malaysia,Hong Kong,3,1,Merdeka Tournament,2
Myanmar,Indonesia,2,0,Merdeka Tournament,2
Panama,Guatemala,2,0,Friendly,2
New Caledonia,Tahiti,3,0,South Pacific Games,3
Vanuatu,Papua New Guinea,3,0,South Pacific Games,3
Guam,Solomon Islands,1,5,South Pacific Games,4
Malaysia,Japan,2,0,Merdeka Tournament,2
Venezuela,Argentina,1,5,Copa América,4
Bangladesh,Japan,0,3,Merdeka Tournament,3
New Caledonia,Vanuatu,3,1,South Pacific Games,2
Papua New Guinea,Tahiti,2,4,South Pacific Games,2
Guam,Fiji,0,11,South Pacific Games,11
New Caledonia,Papua New Guinea,5,1,South Pacific Games,4
Vanuatu,Tahiti,0,3,South Pacific Games,3
Myanmar,Hong Kong,5,0,Merdeka Tournament,5
Ghana,Ivory Coast,3,1,Friendly,2
Malaysia,Bangladesh,3,0,Merdeka Tournament,3
Colombia,Ecuador,2,0,Copa América,2
Fiji,Tahiti,0,3,South Pacific Games,3
Indonesia,Japan,1,4,Merdeka Tournament,3
South Korea,Thailand,6,0,Merdeka Tournament,6
New Caledonia,Solomon Islands,4,0,South Pacific Games,4
Peru,Bolivia,3,1,Copa América,2
Bangladesh,Myanmar,1,7,Merdeka Tournament,6
Japan,South Korea,1,3,Merdeka Tournament,2
Argentina,Venezuela,11,0,Copa América,11
Bangladesh,Hong Kong,1,9,Merdeka Tournament,8
Paraguay,Ecuador,3,1,Copa América,2
Indonesia,South Korea,1,5,Merdeka Tournament,4
Japan,Thailand,4,0,Merdeka Tournament,4
Brazil,Venezuela,6,0,Copa América,6
Chile,Bolivia,4,0,Copa América,4
Norway,Sweden,0,2,UEFA Euro qualification,2
Myanmar,Japan,0,2,Merdeka Tournament,2
Uganda,Zambia,3,0,African Cup of Nations qualification,3
Bangladesh,South Korea,0,4,Merdeka Tournament,4
Hong Kong,Thailand,3,0,Merdeka Tournament,3
Panama,Haiti,2,0,Friendly,2
Mexico,Costa Rica,7,0,Friendly,7
Costa Rica,United States,3,1,Friendly,2
Peru,Chile,3,1,Copa América,2
Argentina,United States,6,0,Friendly,6
Mexico,United States,2,0,Friendly,2
Ghana,Nigeria,3,0,Friendly,3
Austria,Germany,0,2,Friendly,2
France,Iceland,3,0,UEFA Euro qualification,3
Netherlands,Finland,4,1,UEFA Euro qualification,3
Mali,Nigeria,4,1,Friendly,3
South Korea,Japan,3,0,Friendly,3
Poland,Netherlands,4,1,UEFA Euro qualification,3
Colombia,Uruguay,3,0,Copa América,3
Haiti,Guadeloupe,3,0,Friendly,3
Brazil,Peru,1,3,Copa América,2
Peru,Brazil,0,2,Copa América,2
Poland,Hungary,4,2,Friendly,2
Spain,Denmark,2,0,UEFA Euro qualification,2
Austria,Luxembourg,6,2,UEFA Euro qualification,4
Netherlands,Poland,3,0,UEFA Euro qualification,3
Yugoslavia,Sweden,3,0,UEFA Euro qualification,3
Hungary,Luxembourg,8,1,UEFA Euro qualification,7
Peru,Colombia,2,0,Copa América,2
Zambia,Mozambique,3,0,Friendly,3
Republic of Ireland,Turkey,4,0,UEFA Euro qualification,4
Northern Ireland,Norway,3,0,UEFA Euro qualification,3
Scotland,Denmark,3,1,UEFA Euro qualification,2
Malawi,Tanzania,3,1,CECAFA Cup,2
Malawi,Zanzibar,4,2,CECAFA Cup,2
Tanzania,Zanzibar,4,0,CECAFA Cup,4
Russia,Switzerland,4,1,UEFA Euro qualification,3
Cyprus,Czechoslovakia,0,3,UEFA Euro qualification,3
Egypt,Yemen DPR,5,0,Palestine Cup,5
Tunisia,United Arab Emirates,3,0,Palestine Cup,3
Malawi,Eswatini,2,0,Friendly,2
Turkey,Germany,0,5,Friendly,5
Myanmar,South Korea,1,3,King's Cup,2
Iraq,United Arab Emirates,5,0,Palestine Cup,5
Malta,Bulgaria,0,2,UEFA Euro qualification,2
Myanmar,Singapore,6,0,King's Cup,6
Bermuda,Suriname,1,5,Friendly,4
Egypt,Sudan,3,1,Palestine Cup,2
Iraq,Syria,4,0,Palestine Cup,4
South Korea,Singapore,5,0,King's Cup,5
South Korea,Malaysia,4,0,King's Cup,4
Saudi Arabia,Algeria,1,3,Friendly,2
Gambia,Guinea-Bissau,3,1,Friendly,2
Gambia,Mali,0,3,Friendly,3
Mauritania,Senegal,1,4,Friendly,3
Guinea,Mauritania,4,0,Friendly,4
Chad,Gabon,4,0,Friendly,4
Japan,Bulgaria,1,3,Friendly,2
Japan,Bulgaria,0,3,Friendly,3
Malawi,Lesotho,4,1,Friendly,3
Zambia,Nigeria,1,3,Friendly,2
Saudi Arabia,Morocco,0,2,Friendly,2
Germany,Malta,8,0,UEFA Euro qualification,8
Ethiopia,Uganda,2,0,African Cup of Nations,2
Nigeria,DR Congo,4,2,African Cup of Nations,2
Algeria,Sweden,0,2,Friendly,2
Australia,New Zealand,3,1,Friendly,2
Morocco,Nigeria,3,1,African Cup of Nations,2
Sierra Leone,Niger,5,1,FIFA World Cup qualification,4
Egypt,Guinea,2,4,African Cup of Nations,2
Ghana,Togo,4,0,Friendly,4
Ivory Coast,Senegal,4,1,Friendly,3
Bulgaria,Russia,0,3,Friendly,3
Republic of Ireland,Norway,3,0,Friendly,3
Hungary,Argentina,2,0,Friendly,2
Iraq,Oman,4,0,Gulf Cup,4
Gabon,Ivory Coast,0,3,Friendly,3
Mauritania,Burkina Faso,0,2,FIFA World Cup qualification,2
Qatar,Kuwait,0,4,Gulf Cup,4
Bahrain,Iraq,1,4,Gulf Cup,3
Saudi Arabia,United Arab Emirates,2,0,Gulf Cup,2
Kuwait,Oman,8,0,Gulf Cup,8
Iraq,Saudi Arabia,7,1,Gulf Cup,6
Qatar,United Arab Emirates,3,1,Gulf Cup,2
Dominican Republic,Haiti,0,3,CONCACAF Championship qualification,3
Oman,Saudi Arabia,1,3,Gulf Cup,2
Bahrain,Kuwait,2,5,Gulf Cup,3
Iraq,United Arab Emirates,4,0,Gulf Cup,4
Italy,Portugal,3,1,Friendly,2
Qatar,Oman,4,1,Gulf Cup,3
Argentina,Uruguay,4,1,Copa Lipton,3
Qatar,Bahrain,3,0,Gulf Cup,3
Kuwait,Saudi Arabia,3,1,Gulf Cup,2
Iraq,Kuwait,2,4,Gulf Cup,2
Haiti,Dominican Republic,3,0,CONCACAF Championship qualification,3
Ivory Coast,Gabon,1,3,Friendly,2
Congo,Cuba,3,1,Friendly,2
German DR,Algeria,5,0,Friendly,5
Czechoslovakia,Russia,2,0,UEFA Euro qualification,2
France,Poland,2,0,Friendly,2
Yugoslavia,Wales,2,0,UEFA Euro qualification,2
Netherlands,Belgium,5,0,UEFA Euro qualification,5
Gabon,São Tomé and Príncipe,6,1,Friendly,5
Bulgaria,North Korea,3,0,Friendly,3
China PR,Malaysia,2,0,Friendly,2
Scotland,Wales,3,1,British Home Championship,2
Scotland,Northern Ireland,3,0,British Home Championship,3
Zambia,Malawi,4,0,FIFA World Cup qualification,4
England,Northern Ireland,4,0,British Home Championship,4
Brazil,Argentina,2,0,Copa Roca,2
Germany,Spain,2,0,UEFA Euro qualification,2
Cyprus,Denmark,1,5,FIFA World Cup qualification,4
Poland,Republic of Ireland,0,2,Friendly,2
Brazil,Italy,4,1,Friendly,3
Finland,Sweden,0,2,Nordic Championship,2
Kuwait,Malaysia,2,0,AFC Asian Cup,2
Iran,Iraq,2,0,AFC Asian Cup,2
Mexico,Brazil,0,3,Friendly,3
Italy,Romania,4,2,Friendly,2
Myanmar,Malaysia,3,1,Indonesia Tournament,2
Iran,Yemen DPR,8,0,AFC Asian Cup,8
Brazil,Paraguay,3,1,Copa Oswaldo Cruz,2
Uruguay,Argentina,0,3,Copa Newton,3
Iran,China PR,2,0,AFC Asian Cup,2
Hungary,Austria,2,0,Friendly,2
Finland,England,1,4,FIFA World Cup qualification,3
Czechoslovakia,Netherlands,3,1,UEFA Euro,2
Faroe Islands,Iceland,1,6,Friendly,5
Sweden,Norway,2,0,FIFA World Cup qualification,2
Yugoslavia,Germany,2,4,UEFA Euro,2
Réunion,Kenya,1,3,Friendly,2
Seychelles,Réunion,1,4,Friendly,3
Réunion,Mauritius,0,2,Friendly,2
Rwanda,DR Congo,1,6,Friendly,5
Seychelles,Kenya,1,4,Friendly,3
Guyana,Suriname,2,0,CONCACAF Championship qualification,2
Malawi,Sierra Leone,4,2,Friendly,2
Costa Rica,Panama,3,0,CONCACAF Championship qualification,3
Myanmar,Indonesia,5,1,Merdeka Tournament,4
India,Japan,1,5,Merdeka Tournament,4
Malaysia,India,5,1,Merdeka Tournament,4
India,South Korea,0,8,Merdeka Tournament,8
Indonesia,Japan,0,6,Merdeka Tournament,6
El Salvador,Panama,4,1,CONCACAF Championship qualification,3
Sweden,Finland,6,0,Nordic Championship,6
Indonesia,South Korea,0,2,Merdeka Tournament,2
Malaysia,Indonesia,7,1,Merdeka Tournament,6
Haiti,Curaçao,7,0,CONCACAF Championship qualification,7
India,Thailand,2,6,Merdeka Tournament,4
Indonesia,India,1,3,Merdeka Tournament,2
Jamaica,Cuba,1,3,CONCACAF Championship qualification,2
Malaysia,Myanmar,3,1,Merdeka Tournament,2
Australia,Hong Kong,2,0,Friendly,2
Iceland,Luxembourg,3,1,Friendly,2
Malaysia,Japan,2,0,Merdeka Tournament,2
Denmark,Norway,3,0,Nordic Championship,3
Cuba,Jamaica,2,0,CONCACAF Championship qualification,2
Suriname,Guyana,3,0,CONCACAF Championship qualification,3
Scotland,Finland,6,0,Friendly,6
Ivory Coast,Ghana,3,1,Friendly,2
Myanmar,New Zealand,0,2,Korea Cup,2
Saudi Arabia,Morocco,0,2,Friendly,2
South Korea,India,4,0,Korea Cup,4
Malawi,Botswana,7,1,Friendly,6
Malaysia,Singapore,4,1,Korea Cup,3
Barbados,Trinidad and Tobago,1,3,CONCACAF Championship qualification,2
Myanmar,Thailand,2,0,Korea Cup,2
South Korea,Singapore,7,0,Korea Cup,7
Malawi,Botswana,3,0,Friendly,3
Panama,Guatemala,2,4,CONCACAF Championship qualification,2
New Zealand,Thailand,3,1,Korea Cup,2
India,Malaysia,0,4,Korea Cup,4
Austria,Switzerland,3,1,Friendly,2
Finland,Luxembourg,7,1,FIFA World Cup qualification,6
South Korea,New Zealand,2,0,Korea Cup,2
Italy,Yugoslavia,3,0,Friendly,3
Guatemala,Panama,7,0,CONCACAF Championship qualification,7
Ivory Coast,Burkina Faso,2,0,FIFA World Cup qualification,2
Wales,Germany,0,2,Friendly,2
Uganda,Burundi,2,0,Friendly,2
Albania,Algeria,3,0,Friendly,3
Ethiopia,Mauritius,3,0,Friendly,3
Argentina,Chile,2,0,Copa Carlos Dittborn,2
Austria,Hungary,2,4,Friendly,2
Czechoslovakia,Scotland,2,0,FIFA World Cup qualification,2
Mexico,United States,3,0,CONCACAF Championship qualification,3
Luxembourg,Italy,1,4,FIFA World Cup qualification,3
Portugal,Poland,0,2,FIFA World Cup qualification,2
United States,Canada,2,0,CONCACAF Championship qualification,2
Iraq,Libya,3,1,Friendly,2
Hong Kong,Australia,0,2,Friendly,2
Uganda,Ethiopia,4,1,Friendly,3
Bulgaria,German DR,0,4,Friendly,4
Denmark,Cyprus,5,0,FIFA World Cup qualification,5
Peru,Argentina,1,3,Copa Ramón Castilla,2
Egypt,Ethiopia,3,0,FIFA World Cup qualification,3
Nigeria,Sierra Leone,6,2,FIFA World Cup qualification,4
Poland,Cyprus,5,0,FIFA World Cup qualification,5
Turkey,Malta,4,0,FIFA World Cup qualification,4
Algeria,Libya,2,0,Friendly,2
Tunisia,Libya,3,0,Friendly,3
Zanzibar,Zambia,0,3,CECAFA Cup,3
Somalia,Uganda,0,2,CECAFA Cup,2
Somalia,Zambia,2,4,CECAFA Cup,2
Belgium,Northern Ireland,2,0,FIFA World Cup qualification,2
Greece,Austria,0,3,Friendly,3
Kenya,Zambia,0,2,CECAFA Cup,2
Saudi Arabia,Syria,2,0,FIFA World Cup qualification,2
Uganda,Zambia,2,0,CECAFA Cup,2
France,Republic of Ireland,2,0,FIFA World Cup qualification,2
Germany,Czechoslovakia,2,0,Friendly,2
Italy,England,2,0,FIFA World Cup qualification,2
Brazil,Russia,2,0,Friendly,2
Guatemala,El Salvador,3,1,CONCACAF Championship qualification,2
Israel,Austria,1,3,Friendly,2
South Korea,Singapore,4,0,King's Cup,4
Bangladesh,Malaysia,0,6,King's Cup,6
El Salvador,Guatemala,2,0,CONCACAF Championship qualification,2
Thailand,Singapore,6,0,King's Cup,6
Canada,United States,3,0,CONCACAF Championship qualification,3
Panama,Cuba,0,5,Friendly,5
Cuba,Haiti,0,2,CONCACAF Championship qualification,2
Saudi Arabia,Iran,0,3,FIFA World Cup qualification,3
Paraguay,Ecuador,2,0,Friendly,2
Guinea,Ghana,2,0,FIFA World Cup qualification,2
Chile,Paraguay,4,0,Friendly,4
Ecuador,Colombia,4,1,Friendly,3
Gambia,Denmark,1,4,Friendly,3
Uruguay,Chile,3,0,Copa Juan Pinto Durán,3
Mexico,Yugoslavia,5,1,Friendly,4
France,Romania,2,0,Friendly,2
Paraguay,Chile,2,0,Friendly,2
Tunisia,Algeria,2,0,FIFA World Cup qualification,2
England,Netherlands,0,2,Friendly,2
Togo,Guinea,0,2,FIFA World Cup qualification,2
Nigeria,Benin,7,0,Friendly,7
Singapore,South Korea,0,4,Friendly,4
Turkey,Bulgaria,2,0,Balkan Cup,2
Bahrain,South Korea,1,4,Friendly,3
Algeria,Kenya,4,1,African Cup of Nations qualification,3
Panama,Paraguay,0,4,Friendly,4
Argentina,Hungary,5,1,Friendly,4
Botswana,China PR,0,2,Friendly,2
Congo,Ivory Coast,1,3,FIFA World Cup qualification,2
Singapore,Thailand,2,0,FIFA World Cup qualification,2
Zambia,Uganda,4,2,FIFA World Cup qualification,2
Hong Kong,Indonesia,4,1,FIFA World Cup qualification,3
Malaysia,Thailand,6,4,FIFA World Cup qualification,2
New Zealand,New Caledonia,3,0,Friendly,3
Israel,Japan,2,0,FIFA World Cup qualification,2
Venezuela,Bolivia,1,3,FIFA World Cup qualification,2
Guadeloupe,Martinique,1,3,Friendly,2
New Zealand,New Caledonia,4,0,Friendly,4
Austria,Greece,2,0,Friendly,2
Brazil,Colombia,6,0,FIFA World Cup qualification,6
Singapore,Indonesia,0,4,FIFA World Cup qualification,4
Israel,Japan,2,0,FIFA World Cup qualification,2
Bahrain,Kuwait,0,2,FIFA World Cup qualification,2
Peru,Ecuador,4,0,FIFA World Cup qualification,4
Cameroon,Congo,2,0,African Cup of Nations qualification,2
Guinea,Libya,3,0,African Cup of Nations qualification,3
Nigeria,Sierra Leone,2,0,African Cup of Nations qualification,2
Australia,Taiwan,3,0,FIFA World Cup qualification,3
Bolivia,Venezuela,2,0,FIFA World Cup qualification,2
Qatar,Bahrain,2,0,FIFA World Cup qualification,2
Iran,Hungary,0,2,Friendly,2
Qatar,Kuwait,0,2,FIFA World Cup qualification,2
Uruguay,Venezuela,2,0,FIFA World Cup qualification,2
Qatar,Bahrain,0,3,FIFA World Cup qualification,3
Chile,Ecuador,3,0,FIFA World Cup qualification,3
South Korea,Israel,3,1,FIFA World Cup qualification,2
New Zealand,Taiwan,6,0,FIFA World Cup qualification,6
Tunisia,Russia,0,3,Friendly,3
Qatar,Kuwait,1,4,FIFA World Cup qualification,3
New Zealand,Taiwan,6,0,FIFA World Cup qualification,6
Czechoslovakia,Greece,4,0,Friendly,4
Romania,Turkey,4,0,Balkan Cup,4
Syria,Morocco,0,2,Friendly,2
Yugoslavia,Russia,2,4,Friendly,2
Libya,Guinea,0,2,African Cup of Nations qualification,2
Belgium,Netherlands,0,2,FIFA World Cup qualification,2
Peru,Chile,2,0,FIFA World Cup qualification,2
Zambia,Malawi,8,1,Friendly,7
Australia,New Zealand,3,1,FIFA World Cup qualification,2
Ivory Coast,Burkina Faso,4,1,African Cup of Nations qualification,3
England,Luxembourg,5,0,FIFA World Cup qualification,5
Wales,Czechoslovakia,3,0,FIFA World Cup qualification,3
Morocco,Gabon,5,1,Friendly,4
Guinea-Bissau,Mali,1,3,Friendly,2
South Africa,Zimbabwe,7,0,Friendly,7
Bulgaria,Denmark,3,1,Friendly,2
Hungary,Czechoslovakia,2,0,Friendly,2
Iran,Saudi Arabia,2,0,FIFA World Cup qualification,2
Switzerland,France,0,4,Friendly,4
Russia,Greece,2,0,FIFA World Cup qualification,2
Germany,Northern Ireland,5,0,Friendly,5
Scotland,Sweden,3,1,Friendly,2
Austria,Malta,9,0,FIFA World Cup qualification,9
Algeria,Senegal,2,0,Friendly,2
Hong Kong,Macau,2,0,Friendly,2
Yugoslavia,Romania,0,2,FIFA World Cup qualification,2
Cyprus,Poland,1,3,FIFA World Cup qualification,2
Russia,Hungary,2,0,FIFA World Cup qualification,2
Hungary,Greece,3,0,FIFA World Cup qualification,3
Argentina,Poland,3,1,Friendly,2
Togo,Ghana,0,2,Friendly,2
Mozambique,Cuba,0,2,Friendly,2
Norway,Denmark,0,2,Friendly,2
Scotland,Northern Ireland,3,0,British Home Championship,3
Congo,Cameroon,4,0,African Cup of Nations qualification,4
Argentina,Germany,1,3,Friendly,2
Finland,Italy,0,3,FIFA World Cup qualification,3
Uruguay,Germany,0,2,Friendly,2
Algeria,Zambia,2,0,African Cup of Nations qualification,2
Peru,Poland,1,3,Friendly,2
Senegal,Nigeria,3,1,African Cup of Nations qualification,2
Ghana,Togo,2,0,Friendly,2
Zambia,Cuba,2,0,Friendly,2
Chile,Scotland,2,4,Friendly,2
Brazil,Poland,3,1,Friendly,2
Hong Kong,Iran,0,2,FIFA World Cup qualification,2
Tunisia,Guinea,3,1,FIFA World Cup qualification,2
Brazil,Scotland,2,0,Friendly,2
Zambia,Algeria,2,0,African Cup of Nations qualification,2
Nigeria,Senegal,3,0,African Cup of Nations qualification,3
Australia,Hong Kong,3,0,FIFA World Cup qualification,3
Nigeria,Ivory Coast,4,0,FIFA World Cup qualification,4
Argentina,German DR,2,0,Friendly,2
Brazil,Bolivia,8,0,FIFA World Cup qualification,8
Egypt,Zambia,2,0,FIFA World Cup qualification,2
South Korea,Libya,4,0,Merdeka Tournament,4
Peru,Bolivia,5,0,FIFA World Cup qualification,5
Malaysia,Thailand,3,0,Merdeka Tournament,3
South Korea,Thailand,4,1,Merdeka Tournament,3
Myanmar,Iraq,0,3,Merdeka Tournament,3
Afghanistan,India,0,3,Friendly,3
Myanmar,South Korea,0,4,Merdeka Tournament,4
Iraq,Thailand,5,0,Merdeka Tournament,5
Myanmar,Libya,3,1,Merdeka Tournament,2
Iran,DR Congo,1,3,Beijing International Friendship Tournament,2
Czechoslovakia,Romania,1,3,Friendly,2
Netherlands,Iceland,4,1,FIFA World Cup qualification,3
Paraguay,Argentina,2,0,Copa Félix Bogado,2
India,Thailand,0,4,Korea Cup,4
Belgium,Iceland,4,0,FIFA World Cup qualification,4
South Korea,Thailand,5,1,Korea Cup,4
South Korea,India,3,0,Korea Cup,3
Russia,Poland,4,1,Friendly,3
Bahrain,Malaysia,1,3,Korea Cup,2
South Korea,Malaysia,3,0,Korea Cup,3
China PR,Thailand,5,2,Friendly,3
Guatemala,United States,3,1,Friendly,2
Réunion,Mauritius,0,2,Friendly,2
Bulgaria,Turkey,3,1,Balkan Cup,2
Northern Ireland,Iceland,2,0,FIFA World Cup qualification,2
Poland,Denmark,4,1,FIFA World Cup qualification,3
Romania,Greece,6,1,Friendly,5
Scotland,Czechoslovakia,3,1,FIFA World Cup qualification,2
Guatemala,United States,2,0,Friendly,2
Guyana,Trinidad and Tobago,0,2,Friendly,2
Mexico,United States,3,0,Friendly,3
Botswana,Malawi,0,2,Friendly,2
Botswana,Malawi,1,5,Friendly,4
Tunisia,Guinea,3,0,African Cup of Nations qualification,3
Hong Kong,Kuwait,1,3,FIFA World Cup qualification,2
Zambia,India,3,1,Friendly,2
Switzerland,Finland,2,0,Friendly,2
Nigeria,Egypt,4,0,FIFA World Cup qualification,4
Denmark,Portugal,2,4,FIFA World Cup qualification,2
Mexico,Haiti,4,1,CONCACAF Championship,3
Zambia,India,3,1,Friendly,2
Hungary,Sweden,3,0,Friendly,3
Luxembourg,England,0,2,FIFA World Cup qualification,2
Mexico,El Salvador,3,1,CONCACAF Championship,2
Wales,Scotland,0,2,FIFA World Cup qualification,2
Italy,Finland,6,1,FIFA World Cup qualification,5
Mexico,Suriname,8,1,CONCACAF Championship,7
Egypt,Nigeria,3,1,FIFA World Cup qualification,2
Guyana,Barbados,2,0,Friendly,2
Mexico,Canada,3,1,CONCACAF Championship,2
Spain,Romania,2,0,FIFA World Cup qualification,2
Thailand,Singapore,2,0,King's Cup,2
German DR,Malta,9,0,FIFA World Cup qualification,9
Hungary,Bolivia,6,0,FIFA World Cup qualification,6
Hong Kong,Australia,2,5,FIFA World Cup qualification,3
Jamaica,China PR,0,3,Friendly,3
India,Malaysia,0,3,King's Cup,3
Malawi,Lesotho,3,0,Friendly,3
Kuwait,Hong Kong,4,0,FIFA World Cup qualification,4
Malawi,Lesotho,6,1,Friendly,5
Romania,Yugoslavia,4,6,FIFA World Cup qualification,2
Singapore,Australia,0,2,Friendly,2
England,Italy,2,0,FIFA World Cup qualification,2
France,Bulgaria,3,1,FIFA World Cup qualification,2
Germany,Switzerland,4,1,Friendly,3
Northern Ireland,Belgium,3,0,FIFA World Cup qualification,3
Portugal,Cyprus,4,0,FIFA World Cup qualification,4
Iran,Hong Kong,3,0,FIFA World Cup qualification,3
Iraq,Morocco,3,0,Friendly,3
Malta,Turkey,0,3,FIFA World Cup qualification,3
Tanzania,Zambia,2,4,CECAFA Cup,2
Kenya,Uganda,1,3,CECAFA Cup,2
Kenya,Zanzibar,3,0,CECAFA Cup,3
Italy,Luxembourg,3,0,FIFA World Cup qualification,3
South Korea,Hong Kong,5,2,FIFA World Cup qualification,3
Kenya,Zambia,2,4,CECAFA Cup,2
Tunisia,Egypt,4,1,FIFA World Cup qualification,3
Puerto Rico,Martinique,0,2,Friendly,2
Ghana,Sierra Leone,4,0,Friendly,4
Cyprus,Greece,0,2,Friendly,2
Ghana,Gambia,7,1,Friendly,6
Sudan,Kenya,3,0,Friendly,3
Zambia,Zanzibar,6,1,Friendly,5
Zambia,Zanzibar,5,0,Friendly,5
Zambia,Eswatini,11,2,Friendly,9
Israel,Denmark,2,0,Friendly,2
Benin,Burkina Faso,0,2,Friendly,2
El Salvador,Mexico,1,5,Friendly,4
Ghana,Ivory Coast,3,1,Friendly,2
Iraq,Algeria,3,0,Friendly,3
Burkina Faso,Benin,3,0,Friendly,3
Martinique,Antigua and Barbuda,5,0,Friendly,5
Nigeria,Burkina Faso,4,2,African Cup of Nations,2
Congo,Uganda,1,3,African Cup of Nations,2
Burkina Faso,Zambia,0,2,African Cup of Nations,2
France,Portugal,2,0,Friendly,2
German DR,Switzerland,3,1,Friendly,2
Tunisia,Uganda,3,1,African Cup of Nations,2
Ghana,Burkina Faso,3,0,African Cup of Nations,3
Morocco,Uganda,0,3,African Cup of Nations,3
Ghana,Uganda,2,0,African Cup of Nations,2
Luxembourg,Poland,1,3,Friendly,2
Peru,Argentina,1,3,Copa Ramón Castilla,2
Argentina,Bulgaria,3,1,Friendly,2
Spain,Norway,3,0,Friendly,3
Argentina,Romania,2,0,Friendly,2
Republic of Ireland,Turkey,4,2,Friendly,2
Poland,Greece,5,2,Friendly,3
Russia,Finland,10,2,Friendly,8
Tunisia,Netherlands,0,4,Friendly,4
Poland,Republic of Ireland,3,0,Friendly,3
Martinique,Puerto Rico,3,1,Friendly,2
Sweden,Germany,3,1,Friendly,2
Puerto Rico,Martinique,4,1,Friendly,3
Uruguay,Argentina,2,0,Friendly,2
Spain,Mexico,2,0,Friendly,2
Brazil,Peru,3,0,Friendly,3
Argentina,Uruguay,3,0,Friendly,3
Barbados,Guyana,3,0,Friendly,3
Romania,Bulgaria,2,0,Balkan Cup,2
Trinidad and Tobago,Guyana,3,0,Friendly,3
Trinidad and Tobago,Guyana,5,1,Friendly,4
Réunion,Seychelles,4,1,Friendly,3
Wales,England,1,3,British Home Championship,2
Mauritius,Seychelles,2,0,Friendly,2
Brazil,Czechoslovakia,2,0,Friendly,2
Réunion,Mauritius,5,3,Friendly,2
France,Tunisia,2,0,Friendly,2
Iran,Ghana,3,0,Friendly,3
Japan,Thailand,3,0,Kirin Cup,3
England,Hungary,4,1,Friendly,3
Finland,Greece,3,0,UEFA Euro qualification,3
Mexico,Tunisia,1,3,FIFA World Cup,2
Iran,Netherlands,0,3,FIFA World Cup,3
Peru,Scotland,3,1,FIFA World Cup,2
Germany,Mexico,6,0,FIFA World Cup,6
Hungary,Italy,1,3,FIFA World Cup,2
France,Hungary,3,1,FIFA World Cup,2
Mexico,Poland,1,3,FIFA World Cup,2
Iran,Peru,1,4,FIFA World Cup,3
Macau,Hong Kong,0,4,Friendly,4
Indonesia,Malaysia,3,0,Indonesia Tournament,3
Argentina,Poland,2,0,FIFA World Cup,2
Austria,Netherlands,1,5,FIFA World Cup,4
Brazil,Peru,3,0,FIFA World Cup,3
Singapore,Thailand,1,3,Indonesia Tournament,2
Argentina,Peru,6,0,FIFA World Cup,6
Brazil,Poland,3,1,FIFA World Cup,2
Indonesia,South Korea,1,3,Indonesia Tournament,2
Argentina,Netherlands,3,1,FIFA World Cup,2
Malawi,Sierra Leone,5,0,Friendly,5
Guyana,Suriname,0,2,CFU Caribbean Cup qualification,2
Malawi,Sierra Leone,4,2,Friendly,2
Malaysia,South Korea,1,3,Merdeka Tournament,2
Malaysia,Singapore,6,0,Merdeka Tournament,6
South Korea,Thailand,3,0,Merdeka Tournament,3
Malaysia,Thailand,2,0,Merdeka Tournament,2
South Korea,Singapore,2,0,Merdeka Tournament,2
Indonesia,Iraq,0,4,Merdeka Tournament,4
Japan,South Korea,0,4,Merdeka Tournament,4
Iraq,Singapore,3,0,Merdeka Tournament,3
Syria,Thailand,1,3,Merdeka Tournament,2
Malaysia,Japan,4,1,Merdeka Tournament,3
Indonesia,Thailand,0,3,Merdeka Tournament,3
Iraq,South Korea,0,2,Merdeka Tournament,2
Malaysia,Syria,5,2,Merdeka Tournament,3
Indonesia,South Korea,0,2,Merdeka Tournament,2
Singapore,Syria,4,1,Merdeka Tournament,3
Japan,Thailand,4,0,Merdeka Tournament,4
South Korea,Syria,2,0,Merdeka Tournament,2
Iraq,South Korea,0,2,Merdeka Tournament,2
Vanuatu,Tahiti,2,4,Friendly,2
New Caledonia,Tahiti,2,0,Friendly,2
Trinidad and Tobago,French Guiana,2,4,CFU Caribbean Cup qualification,2
Norway,Austria,0,2,UEFA Euro qualification,2
French Guiana,Trinidad and Tobago,1,4,CFU Caribbean Cup qualification,3
Iceland,Poland,0,2,UEFA Euro qualification,2
Eswatini,Zambia,1,6,Friendly,5
Switzerland,United States,2,0,Friendly,2
Eswatini,Zambia,2,5,Friendly,3
French Guiana,Martinique,4,2,Friendly,2
Indonesia,Thailand,0,2,Korea Cup,2
Lebanon,Mexico,1,7,Korea Cup,6
South Korea,Bahrain,3,1,Korea Cup,2
Libya,Yemen DPR,2,0,Friendly,2
Netherlands,Iceland,3,0,UEFA Euro qualification,3
Russia,Greece,2,0,UEFA Euro qualification,2
Réunion,Mauritius,0,2,Friendly,2
Botswana,Mozambique,1,4,Friendly,3
Curaçao,Suriname,0,2,CFU Caribbean Cup qualification,2
Botswana,Mozambique,0,2,Friendly,2
Singapore,New Zealand,0,2,Friendly,2
German DR,Iceland,3,1,UEFA Euro qualification,2
Sweden,Czechoslovakia,1,3,UEFA Euro qualification,2
Turkey,Russia,0,2,Friendly,2
Luxembourg,France,1,3,UEFA Euro qualification,2
Greece,Finland,8,1,UEFA Euro qualification,7
Hungary,Russia,2,0,UEFA Euro qualification,2
Switzerland,Netherlands,1,3,UEFA Euro qualification,2
Suriname,Curaçao,3,0,CFU Caribbean Cup qualification,3
Haiti,Suriname,0,3,CFU Caribbean Cup,3
Trinidad and Tobago,Antigua and Barbuda,3,1,CFU Caribbean Cup,2
Wales,Malta,7,0,UEFA Euro qualification,7
Antigua and Barbuda,Suriname,0,4,CFU Caribbean Cup,4
Zambia,Algeria,0,3,Friendly,3
Greece,Hungary,4,1,UEFA Euro qualification,3
Malawi,Somalia,3,1,CECAFA Cup,2
Malawi,Uganda,0,2,CECAFA Cup,2
Czechoslovakia,Italy,3,0,Friendly,3
Somalia,Zambia,0,4,CECAFA Cup,4
Burkina Faso,Mali,3,1,Friendly,2
Kenya,Zambia,0,9,CECAFA Cup,9
Netherlands,German DR,3,0,UEFA Euro qualification,3
Poland,Switzerland,2,0,UEFA Euro qualification,2
Yugoslavia,Greece,4,1,Balkan Cup,3
Algeria,Congo,3,0,Friendly,3
Malawi,Kenya,2,0,CECAFA Cup,2
Uganda,Zambia,0,4,CECAFA Cup,4
Japan,Russia,1,4,Friendly,3
Kenya,Uganda,2,0,CECAFA Cup,2
Japan,Russia,1,4,Friendly,3
Grenada,Barbados,2,0,Friendly,2
Japan,Russia,0,3,Friendly,3
Bulgaria,Northern Ireland,0,2,UEFA Euro qualification,2
Antigua and Barbuda,Martinique,0,2,Friendly,2
Spain,Cyprus,5,0,UEFA Euro qualification,5
Malawi,Madagascar,5,1,African Cup of Nations qualification,4
Germany,Netherlands,3,1,Friendly,2
South Korea,Macau,4,1,AFC Asian Cup qualification,3
Philippines,China PR,0,3,AFC Asian Cup qualification,3
Philippines,South Korea,0,5,AFC Asian Cup qualification,5
Guinea-Bissau,Cape Verde,3,0,Amílcar Cabral Cup,3
Gambia,Mauritania,3,1,Amílcar Cabral Cup,2
Guinea,Mauritania,4,1,Amílcar Cabral Cup,3
Guinea-Bissau,Senegal,0,2,Amílcar Cabral Cup,2
Mali,Mauritania,4,2,Amílcar Cabral Cup,2
Guinea,Senegal,1,3,Amílcar Cabral Cup,2
England,Northern Ireland,4,0,UEFA Euro qualification,4
Iraq,Finland,2,0,Friendly,2
Israel,Greece,4,1,Friendly,3
Tunisia,Poland,0,2,Friendly,2
Italy,Netherlands,3,0,Friendly,3
France,Luxembourg,3,0,UEFA Euro qualification,3
Bangladesh,Qatar,1,3,AFC Asian Cup qualification,2
Romania,Greece,3,0,Friendly,3
Iraq,Bahrain,4,0,Gulf Cup,4
Kuwait,Qatar,3,1,Gulf Cup,2
Iraq,Qatar,2,0,Gulf Cup,2
Bahrain,United Arab Emirates,3,0,Gulf Cup,3
Hungary,German DR,3,0,Friendly,3
Netherlands,Switzerland,3,0,UEFA Euro qualification,3
Russia,Bulgaria,3,1,Friendly,2
Saudi Arabia,Oman,4,0,Gulf Cup,4
Bahrain,Oman,3,1,Gulf Cup,2
Iraq,Kuwait,3,1,Gulf Cup,2
Cyprus,Yugoslavia,0,3,UEFA Euro qualification,3
Kuwait,United Arab Emirates,7,0,Gulf Cup,7
Kuwait,Oman,2,0,Gulf Cup,2
Czechoslovakia,France,2,0,UEFA Euro qualification,2
Saudi Arabia,Qatar,7,0,Gulf Cup,7
Iraq,United Arab Emirates,5,0,Gulf Cup,5
Iraq,Oman,7,0,Gulf Cup,7
Iraq,Saudi Arabia,2,0,Gulf Cup,2
Morocco,Mauritania,4,1,African Cup of Nations qualification,3
Bahrain,Kuwait,0,2,Gulf Cup,2
Oman,United Arab Emirates,0,4,Gulf Cup,4
Congo,DR Congo,4,2,African Cup of Nations qualification,2
Malawi,Zambia,0,2,African Cup of Nations qualification,2
Guinea,Cameroon,3,0,African Cup of Nations qualification,3
Togo,Gambia,2,0,African Cup of Nations qualification,2
Russia,Sweden,2,0,Friendly,2
DR Congo,Congo,4,1,African Cup of Nations qualification,3
Tanzania,Mauritius,4,0,African Cup of Nations qualification,4
Ivory Coast,Benin,4,1,African Cup of Nations qualification,3
Cameroon,Guinea,3,0,African Cup of Nations qualification,3
Madagascar,Kenya,4,0,Friendly,4
Zambia,Malawi,2,0,African Cup of Nations qualification,2
Luxembourg,Czechoslovakia,0,3,UEFA Euro qualification,3
Republic of Ireland,Denmark,2,0,UEFA Euro qualification,2
North Korea,Hong Kong,3,0,AFC Asian Cup qualification,3
Northern Ireland,Bulgaria,2,0,UEFA Euro qualification,2
Poland,Netherlands,2,0,UEFA Euro qualification,2
United States,France,0,6,Friendly,6
Wales,Germany,0,2,UEFA Euro qualification,2
Russia,Czechoslovakia,3,0,Friendly,3
Switzerland,German DR,0,2,UEFA Euro qualification,2
North Korea,Indonesia,3,1,AFC Asian Cup qualification,2
Brazil,Paraguay,6,0,Friendly,6
Mozambique,Zimbabwe,0,6,Friendly,6
Northern Ireland,England,0,2,British Home Championship,2
Wales,Scotland,3,0,British Home Championship,3
Republic of Ireland,Germany,1,3,Friendly,2
Switzerland,Iceland,2,0,UEFA Euro qualification,2
Martinique,Trinidad and Tobago,3,1,Friendly,2
England,Scotland,3,1,British Home Championship,2
Iceland,Germany,1,3,Friendly,2
Brazil,Uruguay,5,1,Friendly,4
Japan,Indonesia,4,0,Kirin Cup,4
Malta,Wales,0,2,UEFA Euro qualification,2
Scotland,Argentina,1,3,Friendly,2
Bulgaria,England,0,3,UEFA Euro qualification,3
Denmark,Northern Ireland,4,0,UEFA Euro qualification,4
Norway,Scotland,0,4,UEFA Euro qualification,4
Sweden,Luxembourg,3,0,UEFA Euro qualification,3
Yugoslavia,Italy,4,1,Friendly,3
South Korea,Japan,4,1,Friendly,3
Zambia,DR Congo,4,1,Friendly,3
Algeria,Libya,3,1,African Cup of Nations qualification,2
Morocco,Togo,7,0,African Cup of Nations qualification,7
Sweden,Norway,2,0,Nordic Championship,2
Fiji,New Zealand,0,6,Friendly,6
Japan,Thailand,2,0,Merdeka Tournament,2
Malaysia,Myanmar,4,1,Merdeka Tournament,3
Sudan,Ivory Coast,2,0,African Cup of Nations qualification,2
Kenya,Egypt,3,1,African Cup of Nations qualification,2
Malaysia,Thailand,4,2,Merdeka Tournament,2
Fiji,New Zealand,0,3,Friendly,3
Myanmar,Thailand,2,0,Merdeka Tournament,2
Ivory Coast,Sudan,4,0,African Cup of Nations qualification,4
DR Congo,Togo,4,1,Friendly,3
Malaysia,Singapore,3,0,Merdeka Tournament,3
Bolivia,Paraguay,3,1,Copa Paz del Chaco,2
Myanmar,Singapore,4,1,Merdeka Tournament,3
Myanmar,Indonesia,4,0,Merdeka Tournament,4
Japan,Singapore,3,1,Merdeka Tournament,2
Egypt,Kenya,3,0,African Cup of Nations qualification,3
Malawi,Tanzania,2,0,Friendly,2
Malawi,Tanzania,2,0,Friendly,2
Belarus,Armenia,3,0,Friendly,3
Georgia,Lithuania,5,0,Friendly,5
Liberia,Ghana,3,1,Friendly,2
Benin,DR Congo,0,3,Friendly,3
Lithuania,Ukraine,0,2,Friendly,2
Madagascar,Tanzania,2,4,Friendly,2
Russia,Lithuania,2,0,Friendly,2
Belarus,Lithuania,0,2,Friendly,2
Paraguay,Bolivia,2,0,Copa Paz del Chaco,2
Argentina,Bolivia,3,0,Copa América,3
Norway,Sweden,2,0,Nordic Championship,2
Brazil,Bolivia,2,0,Copa América,2
Guinea,DR Congo,3,1,African Cup of Nations qualification,2
Poland,Libya,5,0,Friendly,5
Colombia,Venezuela,4,0,Copa América,4
Lesotho,Malawi,0,3,Friendly,3
Tunisia,Malta,4,0,Friendly,4
Austria,Norway,4,0,UEFA Euro qualification,4
Chile,Venezuela,7,0,Copa América,7
Guam,Vanuatu,0,4,South Pacific Games,4
Poland,Romania,3,0,Friendly,3
Solomon Islands,Wallis Islands and Futuna,6,0,South Pacific Games,6
Tahiti,Tonga,8,0,South Pacific Games,8
Fiji,Kiribati,24,0,South Pacific Games,24
Guam,New Caledonia,1,10,South Pacific Games,9
Peru,Uruguay,2,0,Friendly,2
Tahiti,Tuvalu,18,0,South Pacific Games,18
Kiribati,Papua New Guinea,0,13,South Pacific Games,13
Solomon Islands,Samoa,12,0,South Pacific Games,12
New Caledonia,Vanuatu,3,0,South Pacific Games,3
Tonga,Tuvalu,3,5,South Pacific Games,2
Wallis Islands and Futuna,Samoa,3,1,South Pacific Games,2
Fiji,Wallis Islands and Futuna,5,0,South Pacific Games,5
New Caledonia,Tuvalu,11,0,South Pacific Games,11
Fiji,Solomon Islands,2,0,South Pacific Games,2
Chile,Colombia,2,0,Copa América,2
Guam,Samoa,4,2,South Pacific Games,2
Iceland,Netherlands,0,4,UEFA Euro qualification,4
Sweden,France,1,3,UEFA Euro qualification,2
Vanuatu,Papua New Guinea,2,0,South Pacific Games,2
Guam,Tuvalu,7,2,South Pacific Games,5
Vanuatu,Tonga,7,1,South Pacific Games,6
New Caledonia,Solomon Islands,1,3,South Pacific Games,2
Fiji,Tahiti,0,3,South Pacific Games,3
South Korea,Sudan,8,0,Korea Cup,8
Indonesia,Thailand,0,2,Korea Cup,2
Bangladesh,Sudan,1,4,Korea Cup,3
Iceland,German DR,0,3,UEFA Euro qualification,3
South Korea,Sri Lanka,6,0,Korea Cup,6
Switzerland,Poland,0,2,UEFA Euro qualification,2
Paraguay,Ecuador,2,0,Copa América,2
South Korea,Bahrain,5,1,Korea Cup,4
South Korea,Bangladesh,9,0,Korea Cup,9
Yugoslavia,Argentina,4,2,Friendly,2
Austria,Hungary,3,1,Friendly,2
Czechoslovakia,Republic of Ireland,4,1,Friendly,3
Senegal,Nigeria,0,2,Friendly,2
Sierra Leone,Gambia,2,0,Friendly,2
Bahrain,New Zealand,0,2,Friendly,2
Bermuda,United States,1,3,Friendly,2
Czechoslovakia,Sweden,4,1,UEFA Euro qualification,3
France,United States,3,0,Friendly,3
Poland,Iceland,2,0,UEFA Euro qualification,2
German DR,Switzerland,5,2,UEFA Euro qualification,3
Russia,Romania,3,1,Friendly,2
Belgium,Portugal,2,0,UEFA Euro qualification,2
Germany,Wales,5,1,UEFA Euro qualification,4
Hungary,Finland,3,1,UEFA Euro qualification,2
Republic of Ireland,Bulgaria,3,0,UEFA Euro qualification,3
Northern Ireland,England,1,5,UEFA Euro qualification,4
Ivory Coast,Togo,3,0,Friendly,3
Guadeloupe,Saint Vincent and the Grenadines,1,3,CFU Caribbean Cup qualification,2
Togo,Burkina Faso,5,3,Friendly,2
Hungary,United States,0,2,Friendly,2
Ivory Coast,Benin,3,1,Friendly,2
Haiti,Jamaica,3,0,CFU Caribbean Cup qualification,3
Bulgaria,Denmark,3,0,UEFA Euro qualification,3
Portugal,Norway,3,1,UEFA Euro qualification,2
Jamaica,Haiti,0,4,CFU Caribbean Cup qualification,4
Malawi,Zanzibar,4,0,CECAFA Cup,4
Nigeria,Benin,5,0,Friendly,5
Kenya,Uganda,3,1,CECAFA Cup,2
Malawi,Sudan,4,0,CECAFA Cup,4
Tanzania,Uganda,5,3,CECAFA Cup,2
Kenya,Zambia,3,1,CECAFA Cup,2
Haiti,Saint Vincent and the Grenadines,3,1,CFU Caribbean Cup,2
Kenya,Zanzibar,2,0,CECAFA Cup,2
Malawi,Tanzania,4,0,CECAFA Cup,4
Malaysia,Sweden,1,3,Friendly,2
Spain,Denmark,1,3,Friendly,2
Yugoslavia,Cyprus,5,0,UEFA Euro qualification,5
Suriname,Trinidad and Tobago,3,0,CFU Caribbean Cup,3
Italy,Switzerland,2,0,Friendly,2
Singapore,Sweden,0,5,Friendly,5
Romania,Cyprus,2,0,UEFA Euro qualification,2
Belgium,Scotland,2,0,UEFA Euro qualification,2
Malaysia,Taiwan,0,3,Friendly,3
Russia,Germany,1,3,Friendly,2
England,Bulgaria,2,0,UEFA Euro qualification,2
Thailand,Sri Lanka,5,1,King's Cup,4
Czechoslovakia,Luxembourg,4,0,UEFA Euro qualification,4
Thailand,Indonesia,3,0,King's Cup,3
Bermuda,Finland,0,2,Friendly,2
Cameroon,Congo,1,3,Friendly,2
Paraguay,Chile,3,0,Copa América,3
Cameroon,Gabon,3,1,Friendly,2
El Salvador,Mexico,0,2,Friendly,2
Cyprus,Spain,1,3,UEFA Euro qualification,2
Scotland,Belgium,1,3,UEFA Euro qualification,2
Germany,Turkey,2,0,UEFA Euro qualification,2
Basque Country,Bulgaria,4,0,Friendly,4
Tunisia,Senegal,3,1,Friendly,2
Sierra Leone,Ghana,2,4,Friendly,2
Congo,Ivory Coast,2,0,Friendly,2
Congo,Ivory Coast,0,2,Friendly,2
Australia,Czechoslovakia,0,4,Friendly,4
Ghana,Tunisia,4,1,Friendly,3
Saudi Arabia,South Korea,1,3,Friendly,2
Congo,Gabon,3,0,Friendly,3
Australia,Czechoslovakia,0,5,Friendly,5
England,Republic of Ireland,2,0,UEFA Euro qualification,2
Gambia,Guinea-Bissau,2,0,Amílcar Cabral Cup,2
Guinea-Bissau,Mali,2,4,Amílcar Cabral Cup,2
Fiji,New Zealand,0,2,Friendly,2
New Caledonia,Australia,0,8,Oceania Nations Cup,8
Fiji,Solomon Islands,3,1,Oceania Nations Cup,2
New Zealand,Tahiti,1,3,Oceania Nations Cup,2
Australia,Papua New Guinea,11,2,Oceania Nations Cup,9
Belgium,Luxembourg,5,0,Friendly,5
Fiji,New Zealand,4,0,Oceania Nations Cup,4
France,Greece,5,1,Friendly,4
Germany,Malta,8,0,UEFA Euro qualification,8
Solomon Islands,Tahiti,1,12,Oceania Nations Cup,11
New Caledonia,Papua New Guinea,8,0,Oceania Nations Cup,8
Fiji,Tahiti,3,6,Oceania Nations Cup,3
New Zealand,Solomon Islands,6,1,Oceania Nations Cup,5
Australia,Tahiti,4,2,Oceania Nations Cup,2
Nigeria,Tanzania,3,1,African Cup of Nations,2
Malaysia,Saudi Arabia,3,0,Friendly,3
Malaysia,China PR,3,1,Friendly,2
Belgium,Uruguay,2,0,Friendly,2
Egypt,Morocco,0,2,African Cup of Nations,2
Nigeria,Algeria,3,0,African Cup of Nations,3
Bulgaria,Russia,1,3,Friendly,2
Scotland,Portugal,4,1,UEFA Euro qualification,3
Spain,England,0,2,Friendly,2
Switzerland,Czechoslovakia,2,0,Friendly,2
Guyana,Grenada,5,2,CONCACAF Championship qualification,3
Yugoslavia,Romania,2,0,Balkan Cup,2
Switzerland,Greece,2,0,Friendly,2
Senegal,Tunisia,0,2,Friendly,2
Ivory Coast,Gabon,4,1,Friendly,3
Mexico,Honduras,5,0,Friendly,5
Guatemala,Mexico,2,4,Friendly,2
German DR,Greece,2,0,Friendly,2
Tanzania,Zambia,0,2,Friendly,2
Zimbabwe,Mozambique,6,0,Friendly,6
Mozambique,Tanzania,0,2,Friendly,2
Malta,Libya,0,3,Friendly,3
Sweden,Russia,1,5,Friendly,4
Republic of Ireland,Switzerland,2,0,Friendly,2
Myanmar,Luxembourg,2,0,Friendly,2
England,Argentina,3,1,Friendly,2
Germany,Poland,3,1,Friendly,2
Haiti,El Salvador,2,0,Friendly,2
South Korea,Luxembourg,3,0,Friendly,3
Wales,England,4,1,British Home Championship,3
Austria,Argentina,1,5,Friendly,4
Finland,Sweden,0,2,Nordic Championship,2
Scotland,England,0,2,British Home Championship,2
Hungary,Scotland,3,1,Friendly,2
Macau,Hong Kong,0,2,Friendly,2
Zambia,Ethiopia,4,0,FIFA World Cup qualification,4
Iceland,Wales,0,4,FIFA World Cup qualification,4
Denmark,Norway,3,1,Nordic Championship,2
El Salvador,Haiti,3,0,Friendly,3
Finland,Bulgaria,0,2,FIFA World Cup qualification,2
Honduras,Haiti,3,1,Friendly,2
Brazil,Mexico,2,0,Friendly,2
Zambia,Zimbabwe,1,3,Friendly,2
Hong Kong,Japan,1,3,Guangzhou International Friendship Tournament,2
Algeria,Sierra Leone,3,1,FIFA World Cup qualification,2
China PR,Hong Kong,7,0,Guangzhou International Friendship Tournament,7
Greece,Czechoslovakia,1,3,UEFA Euro,2
Honduras,Panama,2,0,Friendly,2
Malawi,Zambia,2,0,Friendly,2
Hong Kong,Japan,0,2,Guangzhou International Friendship Tournament,2
Guinea,Lesotho,3,1,FIFA World Cup qualification,2
Poland,Iraq,3,0,Friendly,3
Costa Rica,Cuba,3,0,Friendly,3
Cameroon,Malawi,3,0,FIFA World Cup qualification,3
Tunisia,Nigeria,2,0,FIFA World Cup qualification,2
Zambia,Kenya,5,0,Friendly,5
Faroe Islands,Greenland,6,0,Friendly,6
Mauritania,Senegal,1,3,Friendly,2
Panama,Guatemala,0,2,CONCACAF Championship qualification,2
Iceland,Greenland,4,1,Friendly,3
Kenya,Tanzania,3,1,FIFA World Cup qualification,2
Colombia,Poland,1,4,Friendly,3
Nigeria,Tunisia,2,0,FIFA World Cup qualification,2
Russia,Denmark,2,0,Friendly,2
DR Congo,Mozambique,5,2,FIFA World Cup qualification,3
Norway,Iceland,3,1,Friendly,2
Tanzania,Kenya,5,0,FIFA World Cup qualification,5
Panama,Honduras,0,2,CONCACAF Championship qualification,2
Haiti,Trinidad and Tobago,2,0,CONCACAF Championship qualification,2
Basque Country,Hungary,1,5,Friendly,4
United Arab Emirates,Iran,0,2,Friendly,2
United Arab Emirates,Iran,0,3,Friendly,3
Mozambique,Lesotho,6,1,African Cup of Nations qualification,5
Cuba,Suriname,3,0,CONCACAF Championship qualification,3
Hungary,Sweden,2,0,Friendly,2
New Zealand,Mexico,4,0,Friendly,4
Norway,Finland,6,1,Nordic Championship,5
South Korea,Malaysia,2,0,Korea Cup,2
Panama,El Salvador,1,3,CONCACAF Championship qualification,2
South Korea,Indonesia,3,0,Korea Cup,3
Hungary,Russia,1,4,Friendly,3
South Korea,Thailand,4,0,Korea Cup,4
Romania,Yugoslavia,4,1,Balkan Cup,3
Bolivia,Paraguay,1,3,Friendly,2
South Korea,Bahrain,5,0,Korea Cup,5
Malaysia,Thailand,1,4,Korea Cup,3
Fiji,Mexico,0,2,Friendly,2
South Korea,Indonesia,2,0,Korea Cup,2
Albania,Finland,2,0,FIFA World Cup qualification,2
Singapore,South Korea,0,2,Friendly,2
England,Norway,4,0,FIFA World Cup qualification,4
Luxembourg,Yugoslavia,0,5,FIFA World Cup qualification,5
Canada,New Zealand,4,0,Friendly,4
Canada,New Zealand,3,0,Friendly,3
Kuwait,Malaysia,3,1,AFC Asian Cup,2
Qatar,South Korea,0,2,AFC Asian Cup,2
United Arab Emirates,Malaysia,0,2,AFC Asian Cup,2
Kuwait,South Korea,0,3,AFC Asian Cup,3
Bangladesh,Iran,0,7,AFC Asian Cup,7
Finland,Austria,0,2,FIFA World Cup qualification,2
Italy,Portugal,3,1,Friendly,2
South Korea,United Arab Emirates,4,1,AFC Asian Cup,3
Turkey,Iceland,1,3,FIFA World Cup qualification,2
China PR,Bangladesh,6,0,AFC Asian Cup,6
Kuwait,Qatar,4,0,AFC Asian Cup,4
Mali,Mauritania,2,0,African Cup of Nations qualification,2
Turkey,Northern Cyprus,5,0,Friendly,5
Iran,North Korea,3,0,AFC Asian Cup,3
Kuwait,South Korea,3,0,AFC Asian Cup,3
Northern Cyprus,Saudi Arabia,0,2,Friendly,2
Turkey,Saudi Arabia,3,0,Friendly,3
Libya,Saudi Arabia,2,0,Friendly,2
Luxembourg,United States,0,2,Friendly,2
El Salvador,Panama,4,1,CONCACAF Championship qualification,3
Austria,Hungary,3,1,Friendly,2
Argentina,Bulgaria,2,0,Friendly,2
Cyprus,France,0,7,FIFA World Cup qualification,7
Luxembourg,Italy,0,2,FIFA World Cup qualification,2
Cameroon,Zimbabwe,2,0,FIFA World Cup qualification,2
Suriname,Guyana,4,0,CONCACAF Championship qualification,4
Northern Ireland,Sweden,3,0,FIFA World Cup qualification,3
Russia,Iceland,5,0,FIFA World Cup qualification,5
Wales,Turkey,4,0,FIFA World Cup qualification,4
South Korea,Kuwait,3,0,Merdeka Tournament,3
Kuwait,New Zealand,1,5,Merdeka Tournament,4
Kuwait,Myanmar,3,1,Merdeka Tournament,2
Trinidad and Tobago,Guyana,2,0,Friendly,2
Morocco,New Zealand,3,0,Merdeka Tournament,3
Kuwait,Morocco,0,3,Merdeka Tournament,3
France,Republic of Ireland,2,0,FIFA World Cup qualification,2
Indonesia,Morocco,0,2,Merdeka Tournament,2
Malaysia,New Zealand,2,0,Merdeka Tournament,2
Brazil,Paraguay,6,0,Friendly,6
Italy,Denmark,2,0,FIFA World Cup qualification,2
Costa Rica,Panama,2,0,CONCACAF Championship qualification,2
Bolivia,Uruguay,1,3,Friendly,2
Honduras,Canada,2,0,Friendly,2
Mexico,United States,5,1,CONCACAF Championship qualification,4
Senegal,Mauritania,3,0,Friendly,3
Austria,Albania,5,0,FIFA World Cup qualification,5
Italy,Yugoslavia,2,0,FIFA World Cup qualification,2
Brunei,Western Australia,0,2,King's Cup,2
Guatemala,Panama,5,0,CONCACAF Championship qualification,5
Morocco,Zambia,2,0,FIFA World Cup qualification,2
Senegal,Sierra Leone,2,0,African Cup of Nations qualification,2
Denmark,Luxembourg,4,0,FIFA World Cup qualification,4
German DR,Hungary,2,0,Friendly,2
Germany,France,4,1,Friendly,3
Republic of Ireland,Cyprus,6,0,FIFA World Cup qualification,6
Poland,Algeria,5,1,Friendly,4
Brunei,Singapore,0,3,King's Cup,3
Sudan,Somalia,2,0,CECAFA Cup,2
Costa Rica,Guatemala,0,3,CONCACAF Championship qualification,3
Bolivia,Finland,3,0,Friendly,3
Guyana,Cuba,0,3,CONCACAF Championship qualification,3
Honduras,El Salvador,2,0,CONCACAF Championship qualification,2
Zambia,Morocco,2,0,FIFA World Cup qualification,2
Bulgaria,Germany,1,3,FIFA World Cup qualification,2
Czechoslovakia,Turkey,2,0,FIFA World Cup qualification,2
Greece,Italy,0,2,FIFA World Cup qualification,2
Malta,Poland,0,2,FIFA World Cup qualification,2
Uruguay,Finland,6,0,Friendly,6
Mali,Togo,4,0,Friendly,4
Kenya,Zambia,2,0,Friendly,2
Uruguay,Bolivia,5,0,Friendly,5
Algeria,Sudan,2,0,FIFA World Cup qualification,2
Saudi Arabia,Indonesia,8,0,Friendly,8
Honduras,Panama,5,0,CONCACAF Championship qualification,5
Saudi Arabia,Indonesia,3,0,Friendly,3
Argentina,Switzerland,5,0,Friendly,5
Portugal,Israel,3,0,FIFA World Cup qualification,3
Uruguay,Switzerland,4,0,Friendly,4
Tanzania,Nigeria,0,2,FIFA World Cup qualification,2
Brazil,Switzerland,2,0,Friendly,2
Cyprus,Belgium,0,2,FIFA World Cup qualification,2
North Korea,Macau,3,0,FIFA World Cup qualification,3
China PR,Macau,3,0,FIFA World Cup qualification,3
Japan,Macau,3,0,FIFA World Cup qualification,3
Uruguay,Netherlands,2,0,Mundialito,2
Uruguay,Italy,2,0,Mundialito,2
North Korea,China PR,2,4,FIFA World Cup qualification,2
Brazil,Germany,4,1,Mundialito,3
Curaçao,Venezuela,3,1,Friendly,2
Tunisia,Qatar,4,0,Friendly,4
Japan,Poland,0,2,Friendly,2
Ecuador,Bulgaria,1,3,Friendly,2
Japan,Poland,2,4,Friendly,2
Greece,Luxembourg,2,0,FIFA World Cup qualification,2
Japan,Poland,1,4,Friendly,3
Bolivia,Bulgaria,1,3,Friendly,2
Japan,Poland,0,3,Friendly,3
Mali,Mauritania,2,0,Amílcar Cabral Cup,2
Jordan,Iraq,0,2,Friendly,2
Mali,Gambia,4,1,Amílcar Cabral Cup,3
Cape Verde,Guinea-Bissau,3,0,Amílcar Cabral Cup,3
Jordan,Iraq,0,2,Friendly,2
Mali,Cape Verde,2,0,Amílcar Cabral Cup,2
Mexico,South Korea,4,0,Friendly,4
Cape Verde,Senegal,1,5,Amílcar Cabral Cup,4
Ecuador,Brazil,0,6,Friendly,6
Bolivia,Venezuela,3,0,FIFA World Cup qualification,3
Morocco,Syria,3,0,Friendly,3
Oman,Jordan,0,2,Friendly,2
Netherlands,Cyprus,3,0,FIFA World Cup qualification,3
Indonesia,Japan,2,0,Friendly,2
Republic of Ireland,Wales,1,3,Friendly,2
Norway,Sweden,2,4,Friendly,2
Bahrain,Tunisia,0,3,Friendly,3
Liberia,Togo,2,0,Friendly,2
Luxembourg,Greece,0,2,FIFA World Cup qualification,2
Paraguay,Colombia,0,2,Friendly,2
Brazil,Bolivia,3,1,FIFA World Cup qualification,2
Morocco,Liberia,3,1,African Cup of Nations qualification,2
Qatar,Bahrain,3,0,FIFA World Cup qualification,3
Saudi Arabia,Syria,2,0,FIFA World Cup qualification,2
Iraq,Bahrain,2,0,FIFA World Cup qualification,2
Romania,Poland,2,0,Friendly,2
Brazil,Venezuela,5,0,FIFA World Cup qualification,5
Albania,Germany,0,2,FIFA World Cup qualification,2
Cameroon,Niger,2,0,Friendly,2
Algeria,Senegal,2,0,Friendly,2
Kenya,Egypt,3,5,African Cup of Nations qualification,2
Liberia,Morocco,0,5,African Cup of Nations qualification,5
Cameroon,Togo,4,0,African Cup of Nations qualification,4
Algeria,Mali,5,1,African Cup of Nations qualification,4
Spain,Hungary,0,3,Friendly,3
Turkey,Czechoslovakia,0,3,FIFA World Cup qualification,3
Botswana,Malawi,2,5,Friendly,3
Egypt,Kenya,2,0,African Cup of Nations qualification,2
Lesotho,Mozambique,0,2,Friendly,2
Eswatini,Zambia,1,6,Friendly,5
Chile,Peru,3,0,Friendly,3
Mali,Algeria,3,0,African Cup of Nations qualification,3
Zimbabwe,Malawi,4,0,Friendly,4
Ethiopia,Sudan,2,0,Friendly,2
Kuwait,Thailand,6,0,FIFA World Cup qualification,6
South Korea,Thailand,5,1,FIFA World Cup qualification,4
Kuwait,Malaysia,4,0,FIFA World Cup qualification,4
Zambia,Zimbabwe,2,0,African Cup of Nations qualification,2
Cameroon,DR Congo,6,1,FIFA World Cup qualification,5
Scotland,Israel,3,1,FIFA World Cup qualification,2
Germany,Austria,2,0,FIFA World Cup qualification,2
Republic of Ireland,Czechoslovakia,3,1,Friendly,2
Kuwait,South Korea,2,0,FIFA World Cup qualification,2
Yugoslavia,Greece,5,1,FIFA World Cup qualification,4
Algeria,Niger,4,0,FIFA World Cup qualification,4
Fiji,New Zealand,0,4,FIFA World Cup qualification,4
Indonesia,New Zealand,0,2,FIFA World Cup qualification,2
Bulgaria,Finland,4,0,FIFA World Cup qualification,4
France,Brazil,1,3,Friendly,2
Australia,New Zealand,0,2,FIFA World Cup qualification,2
Wales,Scotland,2,0,British Home Championship,2
German DR,Cuba,5,0,Friendly,5
Scotland,Northern Ireland,2,0,British Home Championship,2
Australia,Indonesia,2,0,FIFA World Cup qualification,2
New Zealand,Indonesia,5,0,FIFA World Cup qualification,5
Poland,Republic of Ireland,3,0,Friendly,3
Finland,Germany,0,4,FIFA World Cup qualification,4
Czechoslovakia,Iceland,6,1,FIFA World Cup qualification,5
Austria,Bulgaria,2,0,FIFA World Cup qualification,2
New Zealand,Taiwan,2,0,FIFA World Cup qualification,2
Paraguay,Ecuador,3,1,FIFA World Cup qualification,2
Denmark,Italy,3,1,FIFA World Cup qualification,2
Hungary,England,1,3,FIFA World Cup qualification,2
Suriname,French Guiana,3,1,CFU Caribbean Cup qualification,2
Chile,Ecuador,2,0,FIFA World Cup qualification,2
Liechtenstein,Thailand,0,2,Korea Cup,2
Austria,Finland,5,1,FIFA World Cup qualification,4
South Korea,Malaysia,2,0,Korea Cup,2
Japan,Malaysia,2,0,Korea Cup,2
Malawi,Tanzania,4,1,Friendly,3
Indonesia,Thailand,1,3,Korea Cup,2
Portugal,Spain,2,0,Friendly,2
Chile,Paraguay,3,0,FIFA World Cup qualification,3
French Guiana,Suriname,3,1,CFU Caribbean Cup qualification,2
Guadeloupe,Dominica,5,0,CFU Caribbean Cup qualification,5
South Korea,Japan,2,0,Korea Cup,2
Malawi,Tanzania,3,1,Friendly,2
Malta,Thailand,2,0,Korea Cup,2
Hong Kong,Macau,3,1,Friendly,2
Sweden,Portugal,3,0,FIFA World Cup qualification,3
Zambia,DR Congo,3,1,Friendly,2
Venezuela,Spain,0,2,Friendly,2
Taiwan,Indonesia,2,0,FIFA World Cup qualification,2
Finland,Norway,3,1,Nordic Championship,2
Malawi,Mozambique,3,1,Friendly,2
Mozambique,Zimbabwe,2,4,Friendly,2
Malawi,Zimbabwe,2,0,Friendly,2
Réunion,Madagascar,0,3,Friendly,3
Réunion,Kenya,1,3,Friendly,2
El Salvador,Haiti,4,0,Friendly,4
Fiji,Australia,1,4,FIFA World Cup qualification,3
Zimbabwe,Nigeria,2,0,Friendly,2
Guadeloupe,Saint Vincent and the Grenadines,3,0,CFU Caribbean Cup qualification,3
Kenya,Nigeria,1,3,Friendly,2
Australia,Fiji,10,0,FIFA World Cup qualification,10
Indonesia,Philippines,3,0,Indonesia Tournament,3
Cameroon,Madagascar,5,1,African Cup of Nations qualification,4
New Zealand,Fiji,13,0,FIFA World Cup qualification,13
Peru,Colombia,2,0,FIFA World Cup qualification,2
Saint Vincent and the Grenadines,Guadeloupe,3,1,CFU Caribbean Cup qualification,2
Iceland,Nigeria,3,0,Friendly,3
Iraq,Ghana,4,0,Friendly,4
Denmark,Iceland,3,0,Friendly,3
Algeria,Burkina Faso,7,0,African Cup of Nations qualification,7
Malaysia,Japan,0,2,Merdeka Tournament,2
Zambia,Morocco,2,0,African Cup of Nations qualification,2
Singapore,Thailand,1,3,Merdeka Tournament,2
Indonesia,United Arab Emirates,5,2,Merdeka Tournament,3
Poland,Germany,0,2,Friendly,2
South Korea,Singapore,2,0,Merdeka Tournament,2
India,United Arab Emirates,2,0,Merdeka Tournament,2
Lesotho,Malawi,1,4,Friendly,3
Eswatini,Zimbabwe,0,2,Friendly,2
Lesotho,Zimbabwe,2,5,Friendly,3
Belgium,France,2,0,FIFA World Cup qualification,2
Czechoslovakia,Wales,2,0,FIFA World Cup qualification,2
Iceland,Turkey,2,0,FIFA World Cup qualification,2
Malaysia,Indonesia,2,0,Merdeka Tournament,2
Scotland,Sweden,2,0,FIFA World Cup qualification,2
Iraq,Thailand,7,1,Merdeka Tournament,6
Indonesia,Japan,0,2,Merdeka Tournament,2
Iraq,Singapore,4,0,Merdeka Tournament,4
Iraq,Japan,2,0,Merdeka Tournament,2
Germany,Finland,7,1,FIFA World Cup qualification,6
Portugal,Poland,2,0,Friendly,2
Russia,Turkey,4,0,FIFA World Cup qualification,4
Trinidad and Tobago,Grenada,3,1,Friendly,2
Trinidad and Tobago,Grenada,5,1,Friendly,4
Nigeria,Liberia,3,0,Friendly,3
Turkey,Russia,0,3,FIFA World Cup qualification,3
Nigeria,Algeria,0,2,FIFA World Cup qualification,2
Trinidad and Tobago,Canada,2,4,Friendly,2
Albania,Bulgaria,0,2,FIFA World Cup qualification,2
Austria,Germany,1,3,FIFA World Cup qualification,2
Hungary,Switzerland,3,0,FIFA World Cup qualification,3
Netherlands,Belgium,3,0,FIFA World Cup qualification,3
Spain,Luxembourg,3,0,Friendly,3
Saudi Arabia,South Korea,2,0,Friendly,2
China PR,Kuwait,3,0,FIFA World Cup qualification,3
Saint Vincent and the Grenadines,Trinidad and Tobago,0,2,CFU Caribbean Cup,2
Guadeloupe,Trinidad and Tobago,0,2,CFU Caribbean Cup,2
Puerto Rico,Saint Vincent and the Grenadines,0,2,CFU Caribbean Cup,2
Guadeloupe,Saint Vincent and the Grenadines,1,3,CFU Caribbean Cup,2
United Arab Emirates,India,2,0,Friendly,2
Brazil,Bulgaria,3,0,Friendly,3
Israel,Portugal,4,1,FIFA World Cup qualification,3
Russia,Czechoslovakia,2,0,FIFA World Cup qualification,2
United Arab Emirates,India,3,1,Friendly,2
Hungary,Norway,4,1,FIFA World Cup qualification,3
Mexico,Cuba,4,0,CONCACAF Championship,4
Senegal,Morocco,2,0,Friendly,2
Honduras,Haiti,4,0,CONCACAF Championship,4
Honduras,Cuba,2,0,CONCACAF Championship,2
German DR,Malta,5,1,FIFA World Cup qualification,4
Saudi Arabia,China PR,2,4,FIFA World Cup qualification,2
Haiti,Cuba,0,2,CONCACAF Championship,2
Morocco,Cameroon,0,2,FIFA World Cup qualification,2
Poland,Malta,6,0,FIFA World Cup qualification,6
Tanzania,Zanzibar,3,1,CECAFA Cup,2
Thailand,Malaysia,2,0,King's Cup,2
Uganda,Zambia,3,1,CECAFA Cup,2
France,Netherlands,2,0,FIFA World Cup qualification,2
Germany,Albania,8,0,FIFA World Cup qualification,8
Russia,Wales,3,0,FIFA World Cup qualification,3
China PR,Saudi Arabia,2,0,FIFA World Cup qualification,2
Malawi,Zanzibar,4,1,CECAFA Cup,3
Sudan,Zambia,0,2,CECAFA Cup,2
Yugoslavia,Luxembourg,5,0,FIFA World Cup qualification,5
Germany,Bulgaria,4,0,FIFA World Cup qualification,4
Kenya,Uganda,3,1,CECAFA Cup,2
France,Cyprus,4,0,FIFA World Cup qualification,4
Kuwait,Saudi Arabia,2,0,FIFA World Cup qualification,2
Bulgaria,Portugal,5,2,Friendly,3
Spain,Belgium,2,0,Friendly,2
Saudi Arabia,New Zealand,0,5,FIFA World Cup qualification,5
United Arab Emirates,Tunisia,1,4,Friendly,3
Ethiopia,Tanzania,0,2,Friendly,2
Singapore,Bahrain,2,0,Friendly,2
Brazil,German DR,3,1,Friendly,2
Libya,Guinea,3,0,Friendly,3
Cape Verde,Gambia,2,0,Amílcar Cabral Cup,2
Mali,Mauritania,4,0,Amílcar Cabral Cup,4
Benin,Ghana,0,4,West African Cup,4
Gambia,Mauritania,3,1,Amílcar Cabral Cup,2
Benin,Niger,2,0,West African Cup,2
Senegal,Sierra Leone,2,0,Amílcar Cabral Cup,2
Germany,Portugal,3,1,Friendly,2
Zambia,Botswana,2,0,Friendly,2
Bangladesh,Oman,1,3,Friendly,2
Guinea,Senegal,3,0,Amílcar Cabral Cup,3
England,Northern Ireland,4,0,British Home Championship,4
France,Italy,2,0,Friendly,2
Spain,Scotland,3,0,Friendly,3
India,Uruguay,1,3,Nehru Cup,2
China PR,Uruguay,0,2,Nehru Cup,2
Iran,North Korea,2,0,Friendly,2
Ethiopia,Nigeria,0,3,African Cup of Nations,3
Iraq,South Korea,3,0,Friendly,3
Libya,Tunisia,2,0,African Cup of Nations,2
Greece,Russia,0,2,Friendly,2
United Arab Emirates,Singapore,3,0,Friendly,3
United Arab Emirates,Singapore,5,3,Friendly,2
Nigeria,Zambia,0,3,African Cup of Nations,3
Algeria,Zambia,0,2,African Cup of Nations,2
Bahrain,Kuwait,0,2,Gulf Cup,2
South Korea,Japan,3,0,Friendly,3
Oman,Qatar,0,3,Gulf Cup,3
Belgium,Romania,4,1,Friendly,3
France,Northern Ireland,4,0,Friendly,4
United Arab Emirates,Kuwait,0,2,Gulf Cup,2
Bahrain,Oman,4,1,Gulf Cup,3
Kuwait,Oman,2,0,Gulf Cup,2
Saudi Arabia,Oman,3,0,Gulf Cup,3
Nepal,Bhutan,3,1,Friendly,2
United Arab Emirates,Oman,3,1,Gulf Cup,2
Algeria,Republic of Ireland,2,0,Friendly,2
Spain,Switzerland,2,0,Friendly,2
Romania,Cyprus,3,1,UEFA Euro qualification,2
Brazil,Portugal,3,1,Friendly,2
South Korea,Malaysia,5,0,King's Cup,5
Nepal,Singapore,0,2,King's Cup,2
Thailand,South Korea,0,3,King's Cup,3
Norway,Germany,2,4,Friendly,2
Trinidad and Tobago,Bermuda,4,2,Friendly,2
England,Netherlands,2,0,Friendly,2
Brazil,Republic of Ireland,7,0,Friendly,7
Wales,Northern Ireland,3,0,British Home Championship,3
Japan,Singapore,2,0,Kirin Cup,2
Finland,England,1,4,Friendly,3
Liechtenstein,China PR,2,0,Friendly,2
South Korea,Bahrain,3,0,Korea Cup,3
Hungary,El Salvador,10,1,FIFA World Cup,9
Scotland,New Zealand,5,2,FIFA World Cup,3
England,France,3,1,FIFA World Cup,2
Argentina,Hungary,4,1,FIFA World Cup,3
Brazil,Scotland,4,1,FIFA World Cup,3
Russia,New Zealand,3,0,FIFA World Cup,3
England,Czechoslovakia,2,0,FIFA World Cup,2
Germany,Chile,4,1,FIFA World Cup,3
Algeria,Austria,0,2,FIFA World Cup,2
France,Kuwait,4,1,FIFA World Cup,3
Poland,Peru,5,1,FIFA World Cup,4
Argentina,El Salvador,2,0,FIFA World Cup,2
Brazil,New Zealand,4,0,FIFA World Cup,4
Poland,Belgium,3,0,FIFA World Cup,3
Argentina,Brazil,1,3,FIFA World Cup,2
France,Northern Ireland,4,1,FIFA World Cup,3
Malawi,Tanzania,2,0,Friendly,2
Poland,Italy,0,2,FIFA World Cup,2
Italy,Germany,3,1,FIFA World Cup,2
China PR,Hong Kong,2,0,Beijing International Friendship Tournament,2
Faroe Islands,Iceland,1,4,Friendly,3
Faroe Islands,Iceland,0,4,Friendly,4
Malaysia,Indonesia,0,2,Merdeka Tournament,2
South Korea,Senegal,0,2,Merdeka Tournament,2
Singapore,Ghana,0,3,Merdeka Tournament,3
South Korea,Indonesia,4,0,Merdeka Tournament,4
Malaysia,Pakistan,4,1,Friendly,3
Senegal,United Arab Emirates,3,1,Merdeka Tournament,2
Thailand,Ghana,1,4,Merdeka Tournament,3
Singapore,India,3,0,Merdeka Tournament,3
Singapore,Thailand,2,0,Merdeka Tournament,2
Mauritius,Zimbabwe,2,0,Friendly,2
France,Poland,0,4,Friendly,4
Romania,Sweden,2,0,UEFA Euro qualification,2
Malawi,Zimbabwe,2,0,African Cup of Nations qualification,2
Austria,Albania,5,0,UEFA Euro qualification,5
Finland,Portugal,0,2,UEFA Euro qualification,2
Hungary,Turkey,5,0,Friendly,5
Egypt,Zambia,3,5,Friendly,2
Zimbabwe,Malawi,0,2,African Cup of Nations qualification,2
Belgium,Switzerland,3,0,UEFA Euro qualification,3
Singapore,Brunei,7,0,Merlion Cup,7
Luxembourg,Greece,0,2,UEFA Euro qualification,2
Brunei,Malaysia,0,4,Merlion Cup,4
Australia,Indonesia,2,0,Merlion Cup,2
Austria,Northern Ireland,2,0,UEFA Euro qualification,2
Republic of Ireland,Iceland,2,0,UEFA Euro qualification,2
Norway,Yugoslavia,3,1,UEFA Euro qualification,2
Russia,Finland,2,0,UEFA Euro qualification,2
Scotland,German DR,2,0,UEFA Euro qualification,2
Australia,Malaysia,5,0,Merlion Cup,5
Bulgaria,Malta,7,0,Friendly,7
Denmark,Czechoslovakia,1,3,Friendly,2
Singapore,Malaysia,3,1,Friendly,2
Kenya,Sudan,2,0,CECAFA Cup,2
Angola,Gabon,4,0,African Cup of Nations qualification,4
Mali,Gambia,3,1,African Cup of Nations qualification,2
Tanzania,Zimbabwe,0,3,CECAFA Cup,3
Togo,Sierra Leone,3,0,African Cup of Nations qualification,3
Austria,Turkey,4,0,UEFA Euro qualification,4
German DR,Romania,4,1,Friendly,3
Greece,England,0,3,UEFA Euro qualification,3
Switzerland,Scotland,2,0,UEFA Euro qualification,2
Malawi,Tanzania,2,0,CECAFA Cup,2
Uganda,Zanzibar,3,0,CECAFA Cup,3
Zanzibar,Zimbabwe,0,3,CECAFA Cup,3
Greece,Switzerland,1,3,Friendly,2
Tunisia,Angola,3,1,Friendly,2
England,Luxembourg,9,0,UEFA Euro qualification,9
Malta,Netherlands,0,6,UEFA Euro qualification,6
Malta,Bulgaria,1,7,Friendly,6
Egypt,Hungary,0,2,Friendly,2
Niger,Senegal,2,0,Friendly,2
Greece,Romania,1,3,Friendly,2
Mauritania,Benin,2,0,Friendly,2
Senegal,Niger,2,0,Friendly,2
Tunisia,German DR,0,2,Friendly,2
Portugal,France,0,3,Friendly,3
Saint Vincent and the Grenadines,Martinique,1,3,CFU Caribbean Cup qualification,2
Cameroon,Egypt,2,0,Friendly,2
Australia,New Zealand,0,2,Friendly,2
Romania,Turkey,3,1,Friendly,2
German DR,Finland,3,1,Friendly,2
Benin,Congo,0,2,Friendly,2
Poland,Bulgaria,3,1,Friendly,2
Togo,Congo,0,2,Friendly,2
Ethiopia,Djibouti,8,1,Friendly,7
Luxembourg,Hungary,2,6,UEFA Euro qualification,4
Ethiopia,Djibouti,4,2,Friendly,2
Benin,Togo,0,2,Friendly,2
Romania,Yugoslavia,0,2,Friendly,2
Mozambique,Cameroon,3,0,African Cup of Nations qualification,3
Guatemala,Mexico,0,2,Friendly,2
Algeria,Benin,6,2,African Cup of Nations qualification,4
Haiti,United States,0,2,Friendly,2
Nigeria,Angola,2,0,African Cup of Nations qualification,2
Congo,Egypt,2,0,African Cup of Nations qualification,2
Morocco,Mali,4,0,African Cup of Nations qualification,4
Tunisia,Rwanda,5,0,African Cup of Nations qualification,5
German DR,Bulgaria,3,0,Friendly,3
Czechoslovakia,Cyprus,6,0,UEFA Euro qualification,6
Guinea-Bissau,Togo,2,0,Friendly,2
Hungary,Luxembourg,6,2,UEFA Euro qualification,4
Egypt,Congo,2,0,African Cup of Nations qualification,2
France,Yugoslavia,4,0,Friendly,4
Turkey,Germany,0,3,UEFA Euro qualification,3
Cameroon,Mozambique,4,0,African Cup of Nations qualification,4
Mali,Morocco,2,0,African Cup of Nations qualification,2
Togo,Guinea,2,0,African Cup of Nations qualification,2
Benin,Algeria,6,2,African Cup of Nations qualification,4
England,Hungary,2,0,UEFA Euro qualification,2
Netherlands,Sweden,0,3,Friendly,3
Russia,Portugal,5,0,UEFA Euro qualification,5
Spain,Republic of Ireland,2,0,UEFA Euro qualification,2
Guinea,Guinea-Bissau,3,0,Friendly,3
Guatemala,Honduras,0,2,Friendly,2
Indonesia,Taiwan,0,2,Friendly,2
Guyana,Barbados,2,0,CFU Caribbean Cup qualification,2
Togo,Guinea-Bissau,3,0,Friendly,3
Sweden,Cyprus,5,0,UEFA Euro qualification,5
Martinique,Saint Kitts and Nevis,7,0,CFU Caribbean Cup qualification,7
Wales,Scotland,0,2,British Home Championship,2
Egypt,Cameroon,4,0,Friendly,4
Sweden,Italy,2,0,UEFA Euro qualification,2
Denmark,Hungary,3,1,UEFA Euro qualification,2
England,Scotland,2,0,British Home Championship,2
Antigua and Barbuda,Guyana,4,0,CFU Caribbean Cup qualification,4
Saint Kitts and Nevis,Martinique,0,5,CFU Caribbean Cup qualification,5
South Korea,Thailand,4,0,Korea Cup,4
Germany,Yugoslavia,4,2,Friendly,2
Ghana,New Zealand,0,2,Korea Cup,2
Indonesia,Thailand,0,3,Korea Cup,3
Portugal,Brazil,0,4,Friendly,4
Uruguay,Paraguay,3,0,Copa Artigas,3
Canada,Scotland,0,2,Friendly,2
South Korea,Indonesia,3,0,Korea Cup,3
Ghana,Sudan,3,1,Korea Cup,2
Canada,Scotland,0,3,Friendly,3
Malawi,Mozambique,2,0,Friendly,2
Qatar,Sudan,3,1,Friendly,2
Qatar,Sudan,2,0,Friendly,2
Réunion,Madagascar,0,3,Friendly,3
Mauritania,Cape Verde,2,0,Amílcar Cabral Cup,2
Gambia,Guinea,4,1,Amílcar Cabral Cup,3
Antigua and Barbuda,Martinique,0,2,CFU Caribbean Cup,2
Mauritania,Mali,0,2,Amílcar Cabral Cup,2
Martinique,Trinidad and Tobago,3,1,CFU Caribbean Cup,2
German DR,Russia,1,3,Friendly,2
Mauritania,Mali,0,2,Amílcar Cabral Cup,2
Guinea-Bissau,Senegal,0,3,Amílcar Cabral Cup,3
Costa Rica,Cuba,3,0,Friendly,3
Chile,Peru,2,0,Copa del Pacífico,2
Costa Rica,Cuba,2,0,Friendly,2
Bolivia,Paraguay,1,3,Friendly,2
Vanuatu,Tahiti,1,5,Friendly,4
Iceland,Faroe Islands,6,0,Friendly,6
Vanuatu,Tahiti,1,6,Friendly,5
Mauritania,Togo,0,4,Friendly,4
Cameroon,Sudan,5,0,African Cup of Nations qualification,5
Fiji,New Zealand,2,0,Friendly,2
Iceland,Sweden,0,4,Friendly,4
Niue,Tahiti,0,14,South Pacific Games,14
Tonga,Wallis Islands and Futuna,0,3,South Pacific Games,3
Samoa,American Samoa,3,1,South Pacific Games,2
American Samoa,Wallis Islands and Futuna,3,0,South Pacific Games,3
Niue,Papua New Guinea,0,19,South Pacific Games,19
Fiji,Solomon Islands,10,0,South Pacific Games,10
Chile,Bolivia,4,2,Friendly,2
Algeria,Ivory Coast,3,0,Friendly,3
Fiji,Vanuatu,6,0,South Pacific Games,6
Algeria,Senegal,2,0,African Cup of Nations qualification,2
Sudan,Cameroon,2,0,African Cup of Nations qualification,2
Togo,Ethiopia,3,0,African Cup of Nations qualification,3
Libya,Zimbabwe,3,1,Friendly,2
Brazil,Ecuador,5,0,Copa América,5
Uruguay,Venezuela,3,0,Copa América,3
Denmark,France,3,1,Friendly,2
Finland,Sweden,0,3,Nordic Championship,3
Netherlands,Iceland,3,0,UEFA Euro qualification,3
Chile,Venezuela,5,0,Copa América,5
Chile,Uruguay,2,0,Copa América,2
New Caledonia,Vanuatu,6,2,South Pacific Games,4
Fiji,New Caledonia,5,1,South Pacific Games,4
Fiji,Papua New Guinea,2,0,South Pacific Games,2
New Caledonia,Wallis Islands and Futuna,4,0,South Pacific Games,4
Papua New Guinea,Tahiti,1,6,South Pacific Games,5
Samoa,Tahiti,0,2,South Pacific Games,2
Malaysia,Nepal,7,0,Merdeka Tournament,7
Iceland,Republic of Ireland,0,3,UEFA Euro qualification,3
Northern Ireland,Austria,3,1,UEFA Euro qualification,2
Portugal,Finland,5,0,UEFA Euro qualification,5
Scotland,Uruguay,2,0,Friendly,2
Ivory Coast,Togo,3,0,West African Cup,3
Ivory Coast,Ghana,0,2,West African Cup,2
Liberia,Togo,0,4,West African Cup,4
Ghana,Togo,3,1,West African Cup,2
Germany,Austria,3,0,UEFA Euro qualification,3
Italy,Greece,3,0,Friendly,3
Peru,Paraguay,0,2,Friendly,2
Paraguay,Peru,4,1,Friendly,3
Libya,Malta,4,0,Friendly,4
Russia,Poland,2,0,UEFA Euro qualification,2
Denmark,Luxembourg,6,0,UEFA Euro qualification,6
German DR,Switzerland,3,0,UEFA Euro qualification,3
Hungary,England,0,3,UEFA Euro qualification,3
Wales,Romania,5,0,Friendly,5
Italy,Sweden,0,3,UEFA Euro qualification,3
El Salvador,Mexico,0,5,Friendly,5
Germany,Turkey,5,1,UEFA Euro qualification,4
Switzerland,Yugoslavia,2,0,Friendly,2
Uruguay,Brazil,2,0,Copa América,2
Switzerland,Belgium,3,1,UEFA Euro qualification,2
Kenya,Ethiopia,2,0,CECAFA Cup,2
Czechoslovakia,Italy,2,0,UEFA Euro qualification,2
Greece,Denmark,0,2,UEFA Euro qualification,2
Republic of Ireland,Malta,8,0,UEFA Euro qualification,8
Luxembourg,England,0,4,UEFA Euro qualification,4
Trinidad and Tobago,Sweden,0,5,Friendly,5
Turkey,Austria,3,1,UEFA Euro qualification,2
Barbados,Sweden,0,4,Friendly,4
Ethiopia,Sudan,0,2,CECAFA Cup,2
Malawi,Zanzibar,3,1,CECAFA Cup,2
Sri Lanka,Singapore,0,4,Friendly,4
Mexico,Sweden,2,0,Friendly,2
Kenya,Malawi,2,0,CECAFA Cup,2
Mexico,Canada,5,0,Friendly,5
Belize,Canada,0,2,Friendly,2
Honduras,Canada,3,1,Friendly,2
Singapore,Brunei,4,0,Merlion Cup,4
Northern Ireland,Scotland,2,0,British Home Championship,2
Nigeria,Togo,2,5,Friendly,3
Netherlands,Malta,5,0,UEFA Euro qualification,5
Singapore,Australia,2,4,Merlion Cup,2
Spain,Malta,12,1,UEFA Euro qualification,11
Italy,Cyprus,3,1,UEFA Euro qualification,2
Mauritania,Senegal,0,2,Friendly,2
Ivory Coast,Guinea,3,0,Friendly,3
India,China PR,0,3,Nehru Cup,3
Ivory Coast,Mali,4,1,Friendly,3
Ivory Coast,Liberia,4,1,Friendly,3
Italy,Mexico,5,0,Friendly,5
Sierra Leone,Cape Verde,2,0,Amílcar Cabral Cup,2
Cape Verde,Gambia,0,2,Amílcar Cabral Cup,2
Mauritania,Senegal,0,6,Amílcar Cabral Cup,6
Greece,German DR,1,3,Friendly,2
Gambia,Mali,0,2,Amílcar Cabral Cup,2
Saudi Arabia,Algeria,4,2,Friendly,2
Peru,Honduras,1,3,Friendly,2
France,England,2,0,Friendly,2
Ivory Coast,Togo,3,0,African Cup of Nations,3
Algeria,Malawi,3,0,African Cup of Nations,3
Brunei,Japan,1,7,Friendly,6
Cameroon,Togo,4,1,African Cup of Nations,3
Romania,Greece,2,0,Friendly,2
Algeria,Ghana,2,0,African Cup of Nations,2
Ivory Coast,Cameroon,0,2,African Cup of Nations,2
Kuwait,United Arab Emirates,0,2,Gulf Cup,2
Luxembourg,Turkey,1,3,Friendly,2
Netherlands,Denmark,6,0,Friendly,6
Oman,Saudi Arabia,1,3,Gulf Cup,2
Algeria,Egypt,3,1,African Cup of Nations,2
Iraq,Saudi Arabia,4,0,Gulf Cup,4
Cameroon,Nigeria,3,1,African Cup of Nations,2
Oman,Qatar,0,2,Gulf Cup,2
Iraq,Kuwait,3,1,Gulf Cup,2
Djibouti,Ethiopia,0,2,Friendly,2
Saudi Arabia,United Arab Emirates,2,0,Gulf Cup,2
Bahrain,Saudi Arabia,0,2,Gulf Cup,2
New Zealand,Malaysia,2,0,Friendly,2
New Zealand,Malaysia,6,1,Friendly,5
Israel,Republic of Ireland,3,0,Friendly,3
Turkey,Hungary,0,6,Friendly,6
Panama,Nicaragua,2,0,Friendly,2
Luxembourg,Norway,0,2,Friendly,2
Finland,Russia,1,3,Friendly,2
Sweden,Malta,4,0,FIFA World Cup qualification,4
Canada,Italy,0,2,Friendly,2
Switzerland,Spain,0,4,Friendly,4
France,Scotland,2,0,Friendly,2
England,Russia,0,2,Friendly,2
Ethiopia,Djibouti,2,0,Friendly,2
South Korea,Guatemala,2,0,Korea Cup,2
Djibouti,Zimbabwe,1,3,Friendly,2
Liechtenstein,Austria,0,6,Friendly,6
Brazil,England,0,2,Friendly,2
Ethiopia,Zimbabwe,2,0,Friendly,2
Trinidad and Tobago,India,3,0,Friendly,3
Belgium,Yugoslavia,2,0,UEFA Euro,2
Uruguay,England,2,0,Friendly,2
Panama,Honduras,0,3,CONCACAF Championship qualification,3
Suriname,India,6,2,Friendly,4
Denmark,Yugoslavia,5,0,UEFA Euro,5
France,Belgium,5,0,UEFA Euro,5
Macau,Hong Kong,0,3,Friendly,3
Suriname,India,4,1,Friendly,3
Guyana,India,3,0,Friendly,3
China PR,India,2,0,Great Wall Cup,2
Trinidad and Tobago,India,3,0,Friendly,3
El Salvador,Guatemala,3,1,Friendly,2
France,Spain,2,0,UEFA Euro,2
Kenya,Cameroon,1,3,Friendly,2
Eswatini,Lesotho,3,1,Friendly,2
Morocco,Sierra Leone,4,0,FIFA World Cup qualification,4
Guyana,Trinidad and Tobago,0,2,Friendly,2
Benin,Congo,2,0,Friendly,2
Malawi,Mauritius,4,0,FIFA World Cup qualification,4
Trinidad and Tobago,Guyana,3,1,Friendly,2
El Salvador,Puerto Rico,5,0,CONCACAF Championship qualification,5
Romania,China PR,4,2,Friendly,2
Zambia,Uganda,3,0,FIFA World Cup qualification,3
Mauritania,Guinea,0,2,Friendly,2
Burkina Faso,Benin,3,1,Friendly,2
Burkina Faso,Ghana,0,2,Friendly,2
Haiti,Antigua and Barbuda,4,0,CONCACAF Championship qualification,4
Puerto Rico,El Salvador,0,3,CONCACAF Championship qualification,3
Faroe Islands,Greenland,4,2,Friendly,2
Iran,Bangladesh,5,0,AFC Asian Cup qualification,5
Syria,Philippines,2,0,AFC Asian Cup qualification,2
Iran,Syria,3,1,AFC Asian Cup qualification,2
Thailand,Philippines,3,0,AFC Asian Cup qualification,3
Iran,Thailand,5,0,AFC Asian Cup qualification,5
Iran,Philippines,7,1,AFC Asian Cup qualification,6
Finland,Mexico,0,3,Friendly,3
Uganda,Tanzania,1,3,African Cup of Nations qualification,2
Russia,Mexico,3,0,Friendly,3
Hungary,Switzerland,3,0,Friendly,3
Hungary,Mexico,0,2,Friendly,2
Malaysia,Liberia,3,1,Merdeka Tournament,2
Cyprus,Greece,0,2,Friendly,2
Switzerland,Argentina,0,2,Friendly,2
Malaysia,Papua New Guinea,5,1,Merdeka Tournament,4
Belgium,Argentina,0,2,Friendly,2
Qatar,Afghanistan,8,0,AFC Asian Cup qualification,8
China PR,Afghanistan,6,0,AFC Asian Cup qualification,6
Denmark,Austria,3,1,Friendly,2
Finland,Poland,0,2,Friendly,2
Germany,Argentina,1,3,Friendly,2
Scotland,Yugoslavia,6,1,Friendly,5
China PR,Jordan,6,0,AFC Asian Cup qualification,6
China PR,Hong Kong,2,0,AFC Asian Cup qualification,2
Qatar,Jordan,2,0,AFC Asian Cup qualification,2
Uruguay,Peru,2,0,Friendly,2
Jordan,Afghanistan,6,1,AFC Asian Cup qualification,5
Ghana,Gambia,3,1,Friendly,2
Niger,Ivory Coast,1,3,Friendly,2
Hungary,Austria,3,1,FIFA World Cup qualification,2
Poland,Turkey,2,0,Friendly,2
Tunisia,Nigeria,5,0,Friendly,5
Botswana,Angola,1,3,Friendly,2
Mozambique,Mauritius,3,0,African Cup of Nations qualification,3
Peru,Uruguay,1,3,Friendly,2
South Korea,Cameroon,5,0,Friendly,5
United States,Curaçao,4,0,CONCACAF Championship qualification,4
United States,El Salvador,3,1,Friendly,2
German DR,Algeria,5,2,Friendly,3
South Korea,Yemen,6,0,AFC Asian Cup qualification,6
Saudi Arabia,Thailand,1,3,Friendly,2
Ivory Coast,Liberia,3,0,Friendly,3
Malaysia,Pakistan,5,0,AFC Asian Cup qualification,5
India,Yemen,4,0,AFC Asian Cup qualification,4
South Korea,Pakistan,6,0,AFC Asian Cup qualification,6
Luxembourg,France,0,4,FIFA World Cup qualification,4
Guatemala,United States,4,0,Friendly,4
Zimbabwe,Eswatini,3,0,African Cup of Nations qualification,3
Congo,Benin,0,2,Friendly,2
Pakistan,Yemen,4,1,AFC Asian Cup qualification,3
Northern Ireland,Israel,3,0,Friendly,3
Belgium,Albania,3,1,FIFA World Cup qualification,2
England,Finland,5,0,FIFA World Cup qualification,5
Germany,Sweden,2,0,FIFA World Cup qualification,2
India,Pakistan,2,0,AFC Asian Cup qualification,2
Poland,Greece,3,1,FIFA World Cup qualification,2
Scotland,Iceland,3,0,FIFA World Cup qualification,3
Spain,Wales,3,0,FIFA World Cup qualification,3
Malaysia,Yemen,4,1,AFC Asian Cup qualification,3
Saudi Arabia,Nepal,7,0,AFC Asian Cup qualification,7
Nigeria,Liberia,3,0,FIFA World Cup qualification,3
Ivory Coast,Gambia,4,0,FIFA World Cup qualification,4
Tunisia,Canada,2,0,Friendly,2
Sri Lanka,Nepal,4,0,AFC Asian Cup qualification,4
Saudi Arabia,Sri Lanka,5,0,AFC Asian Cup qualification,5
United Arab Emirates,Oman,8,0,AFC Asian Cup qualification,8
Saudi Arabia,Oman,6,0,AFC Asian Cup qualification,6
United Arab Emirates,Nepal,11,0,AFC Asian Cup qualification,11
Benin,Tunisia,0,2,FIFA World Cup qualification,2
Oman,Nepal,8,0,AFC Asian Cup qualification,8
United Arab Emirates,Sri Lanka,5,1,AFC Asian Cup qualification,4
Czechoslovakia,Malta,4,0,FIFA World Cup qualification,4
Eswatini,Zimbabwe,1,5,African Cup of Nations qualification,4
DR Congo,Gabon,2,0,African Cup of Nations qualification,2
Liberia,Mauritania,3,1,African Cup of Nations qualification,2
Trinidad and Tobago,Mexico,0,2,Friendly,2
Tunisia,Benin,4,0,FIFA World Cup qualification,4
Denmark,Republic of Ireland,3,0,FIFA World Cup qualification,3
Portugal,Sweden,1,3,FIFA World Cup qualification,2
Scotland,Spain,3,1,FIFA World Cup qualification,2
Turkey,England,0,8,FIFA World Cup qualification,8
Luxembourg,German DR,0,5,FIFA World Cup qualification,5
Malawi,Zimbabwe,3,0,Friendly,3
Ghana,Ivory Coast,2,0,West African Cup,2
Mauritania,Liberia,3,0,African Cup of Nations qualification,3
Benin,Togo,0,2,West African Cup,2
Benin,Ghana,1,3,West African Cup,2
Burkina Faso,Ivory Coast,0,2,West African Cup,2
Iran,United Arab Emirates,3,0,AFC Asian Cup,3
Dominica,Grenada,0,4,Windward Islands Tournament,4
Sierra Leone,Gambia,2,0,African Cup of Nations qualification,2
Singapore,India,2,0,AFC Asian Cup,2
Saint Lucia,Saint Vincent and the Grenadines,2,0,Windward Islands Tournament,2
Zambia,Zimbabwe,2,0,CECAFA Cup,2
China PR,Iran,0,2,AFC Asian Cup,2
Uganda,Zimbabwe,4,1,CECAFA Cup,3
United Arab Emirates,India,2,0,AFC Asian Cup,2
Bulgaria,Luxembourg,4,0,FIFA World Cup qualification,4
Singapore,China PR,0,2,AFC Asian Cup,2
France,German DR,2,0,FIFA World Cup qualification,2
Italy,Poland,2,0,Friendly,2
Congo,Equatorial Guinea,5,0,UDEAC Cup,5
India,China PR,0,3,AFC Asian Cup,3
Kuwait,Syria,3,1,AFC Asian Cup,2
Chad,Cameroon,0,2,UDEAC Cup,2
China PR,United Arab Emirates,5,0,AFC Asian Cup,5
Kenya,Zambia,0,2,CECAFA Cup,2
Uganda,Malawi,0,2,CECAFA Cup,2
Uganda,Kenya,3,1,CECAFA Cup,2
Saudi Arabia,China PR,2,0,AFC Asian Cup,2
Central African Republic,Cameroon,1,7,UDEAC Cup,6
Congo,Gabon,3,0,UDEAC Cup,3
Israel,Luxembourg,2,0,Friendly,2
Albania,Belgium,2,0,FIFA World Cup qualification,2
Guatemala,El Salvador,2,0,Friendly,2
Ivory Coast,Tunisia,3,1,Friendly,2
Algeria,Tunisia,3,1,Friendly,2
Ivory Coast,Ghana,2,0,Friendly,2
Ghana,Tunisia,0,2,Friendly,2
Israel,Greece,0,2,Friendly,2
Barbados,Saint Lucia,4,1,Friendly,3
Iran,Yugoslavia,1,3,Nehru Cup,2
Spain,Finland,3,1,Friendly,2
Iran,Russia,0,2,Nehru Cup,2
Uruguay,German DR,3,0,Friendly,3
Mexico,Poland,5,0,Friendly,5
Chile,Finland,2,0,Friendly,2
Malta,Portugal,1,3,FIFA World Cup qualification,2
Paraguay,Uruguay,1,3,Copa Artigas,2
Guinea,Senegal,0,2,Amílcar Cabral Cup,2
Mali,Mauritania,3,0,Amílcar Cabral Cup,3
Guinea,Mali,1,3,Amílcar Cabral Cup,2
Mauritania,Senegal,0,2,Amílcar Cabral Cup,2
Cape Verde,Guinea-Bissau,2,0,Amílcar Cabral Cup,2
Ecuador,Finland,3,1,Friendly,2
Macau,Brunei,2,0,FIFA World Cup qualification,2
Peru,Bolivia,3,0,Friendly,3
Macau,China PR,0,4,FIFA World Cup qualification,4
Ecuador,Bolivia,3,0,Friendly,3
Hong Kong,Brunei,8,0,FIFA World Cup qualification,8
Singapore,Japan,1,3,FIFA World Cup qualification,2
El Salvador,Suriname,3,0,CONCACAF Championship,3
Tunisia,Guinea,2,0,FIFA World Cup qualification,2
Uruguay,Colombia,3,0,Friendly,3
China PR,Brunei,8,0,FIFA World Cup qualification,8
El Salvador,Suriname,3,0,CONCACAF Championship,3
Greece,Albania,2,0,FIFA World Cup qualification,2
Netherlands,Cyprus,7,1,FIFA World Cup qualification,6
Paraguay,Colombia,0,3,Friendly,3
Brunei,China PR,0,4,FIFA World Cup qualification,4
Nepal,South Korea,0,2,FIFA World Cup qualification,2
Grenada,Trinidad and Tobago,1,5,CFU Caribbean Cup qualification,4
Costa Rica,Guatemala,2,0,Friendly,2
Algeria,Mauritania,4,0,African Cup of Nations qualification,4
Libya,Sudan,4,0,FIFA World Cup qualification,4
Chile,Ecuador,6,2,FIFA World Cup qualification,4
Indonesia,Bangladesh,2,0,FIFA World Cup qualification,2
Zimbabwe,Madagascar,5,2,African Cup of Nations qualification,3
Thailand,Bangladesh,3,0,FIFA World Cup qualification,3
Brunei,Philippines,4,1,Friendly,3
Chile,Uruguay,2,0,FIFA World Cup qualification,2
Saint Vincent and the Grenadines,Grenada,3,0,CFU Caribbean Cup qualification,3
Belgium,Greece,2,0,FIFA World Cup qualification,2
Germany,Malta,6,0,FIFA World Cup qualification,6
Russia,Austria,2,0,Friendly,2
Switzerland,Czechoslovakia,2,0,Friendly,2
Egypt,Cameroon,2,0,Friendly,2
Libya,Tunisia,2,0,African Cup of Nations qualification,2
Yemen DPR,Bahrain,1,4,FIFA World Cup qualification,3
Congo,DR Congo,2,5,African Cup of Nations qualification,3
Ecuador,Uruguay,0,2,FIFA World Cup qualification,2
Ivory Coast,Mali,6,0,African Cup of Nations qualification,6
Malaysia,Nepal,5,0,FIFA World Cup qualification,5
Canada,United States,2,0,Friendly,2
Hungary,Cyprus,2,0,FIFA World Cup qualification,2
Italy,Portugal,2,0,Friendly,2
Malta,Jordan,3,1,Friendly,2
Romania,Turkey,3,0,FIFA World Cup qualification,3
Kuwait,Yemen,5,0,FIFA World Cup qualification,5
Qatar,Iraq,3,0,FIFA World Cup qualification,3
Brunei,Hong Kong,1,5,FIFA World Cup qualification,4
Kenya,Nigeria,0,3,FIFA World Cup qualification,3
South Korea,Nepal,4,0,FIFA World Cup qualification,4
Mali,Togo,4,0,Friendly,4
Morocco,Malawi,2,0,FIFA World Cup qualification,2
Syria,United Arab Emirates,0,4,Friendly,4
Zambia,Cameroon,4,1,FIFA World Cup qualification,3
Qatar,Jordan,2,0,FIFA World Cup qualification,2
Canada,Haiti,2,0,CONCACAF Championship,2
Guinea,Ghana,1,4,African Cup of Nations qualification,3
Austria,Hungary,0,3,FIFA World Cup qualification,3
Colombia,Paraguay,2,0,Friendly,2
Germany,Bulgaria,4,1,Friendly,3
Iraq,Jordan,2,0,FIFA World Cup qualification,2
Syria,Yemen,3,0,FIFA World Cup qualification,3
Nigeria,Kenya,3,1,FIFA World Cup qualification,2
Bolivia,Venezuela,4,0,Friendly,4
Ghana,Ivory Coast,2,0,FIFA World Cup qualification,2
Togo,Mali,3,0,Friendly,3
Costa Rica,Trinidad and Tobago,3,0,CONCACAF Championship,3
Yemen,Kuwait,1,3,FIFA World Cup qualification,2
Macau,Hong Kong,0,2,FIFA World Cup qualification,2
North Korea,Nepal,8,1,Friendly,7
Czechoslovakia,Germany,1,5,FIFA World Cup qualification,4
Wales,Spain,3,0,FIFA World Cup qualification,3
Belgium,Poland,2,0,FIFA World Cup qualification,2
Northern Ireland,Turkey,2,0,FIFA World Cup qualification,2
Brazil,Uruguay,2,0,Friendly,2
Bulgaria,France,2,0,FIFA World Cup qualification,2
Indonesia,North Korea,0,7,Friendly,7
Pakistan,Bangladesh,1,3,Friendly,2
Russia,Switzerland,4,0,FIFA World Cup qualification,4
Zimbabwe,Malawi,1,3,Friendly,2
Hong Kong,Macau,2,0,FIFA World Cup qualification,2
Pakistan,Indonesia,1,3,Friendly,2
Austria,Cyprus,4,0,FIFA World Cup qualification,4
Denmark,German DR,4,1,Friendly,3
Haiti,Canada,0,2,CONCACAF Championship,2
China PR,Macau,6,0,FIFA World Cup qualification,6
Argentina,Chile,2,0,Friendly,2
Guatemala,Haiti,4,0,CONCACAF Championship,4
German DR,Luxembourg,3,1,FIFA World Cup qualification,2
Japan,Singapore,5,0,FIFA World Cup qualification,5
Greece,Poland,1,4,FIFA World Cup qualification,3
South Korea,Malaysia,2,0,FIFA World Cup qualification,2
North Korea,Singapore,2,0,FIFA World Cup qualification,2
Japan,Uruguay,1,4,Kirin Cup,3
Hong Kong,Macau,2,0,Friendly,2
Bolivia,Brazil,0,2,FIFA World Cup qualification,2
Colombia,Argentina,1,3,FIFA World Cup qualification,2
Republic of Ireland,Switzerland,3,0,FIFA World Cup qualification,3
Bahrain,Malaysia,3,1,Korea Cup,2
New Zealand,Fiji,5,0,Friendly,5
Denmark,Russia,4,2,FIFA World Cup qualification,2
New Zealand,Fiji,3,0,Friendly,3
Norway,Wales,4,2,Friendly,2
Sweden,Czechoslovakia,2,0,FIFA World Cup qualification,2
New Zealand,Fiji,2,0,Friendly,2
Brazil,Chile,3,1,Friendly,2
South Korea,Bahrain,3,0,Korea Cup,3
Argentina,Venezuela,3,0,FIFA World Cup qualification,3
Canada,Iraq,1,6,Korea Cup,5
Paraguay,Bolivia,3,0,FIFA World Cup qualification,3
England,Germany,3,0,Friendly,3
South Korea,Iraq,2,0,Korea Cup,2
Mexico,Germany,2,0,Friendly,2
Paraguay,Brazil,0,2,FIFA World Cup qualification,2
Peru,Venezuela,4,1,FIFA World Cup qualification,3
United States,England,0,5,Friendly,5
Nigeria,Ivory Coast,2,0,Friendly,2
Martinique,Suriname,2,0,CFU Caribbean Cup,2
Colombia,Venezuela,2,0,FIFA World Cup qualification,2
Saudi Arabia,Jordan,4,0,Arab Cup,4
Jordan,Qatar,0,2,Arab Cup,2
Bahrain,Mauritania,2,0,Arab Cup,2
Réunion,Malawi,2,8,Friendly,6
Iraq,Mauritania,2,0,Arab Cup,2
Malawi,Tanzania,2,0,Friendly,2
Angola,Guinea-Bissau,3,1,Friendly,2
Iceland,Faroe Islands,9,0,Friendly,9
Algeria,Zambia,2,0,FIFA World Cup qualification,2
Costa Rica,Trinidad and Tobago,3,1,Friendly,2
Tunisia,Nigeria,2,0,FIFA World Cup qualification,2
South Korea,Indonesia,2,0,FIFA World Cup qualification,2
Libya,Ghana,2,0,FIFA World Cup qualification,2
Morocco,Egypt,2,0,FIFA World Cup qualification,2
Indonesia,South Korea,1,4,FIFA World Cup qualification,3
Russia,Romania,2,0,Friendly,2
Japan,Hong Kong,3,0,FIFA World Cup qualification,3
Algeria,Kenya,3,0,African Cup of Nations qualification,3
Ivory Coast,Ghana,2,0,African Cup of Nations qualification,2
France,Uruguay,2,0,CONMEBOL–UEFA Cup of Champions,2
Romania,Finland,2,0,FIFA World Cup qualification,2
Senegal,Zimbabwe,3,0,African Cup of Nations qualification,3
Israel,Taiwan,6,0,FIFA World Cup qualification,6
Czechoslovakia,Poland,3,1,Friendly,2
Honduras,Costa Rica,3,1,CONCACAF Championship,2
Israel,Taiwan,5,0,FIFA World Cup qualification,5
Norway,Egypt,3,0,Friendly,3
Denmark,Sweden,0,3,Friendly,3
German DR,France,2,0,FIFA World Cup qualification,2
Cameroon,Saudi Arabia,4,1,Friendly,3
Papua New Guinea,China PR,1,4,Friendly,3
Luxembourg,Bulgaria,1,3,FIFA World Cup qualification,2
Australia,China PR,3,0,Friendly,3
New Zealand,Taiwan,5,1,FIFA World Cup qualification,4
Morocco,Libya,3,0,FIFA World Cup qualification,3
Tunisia,Algeria,1,4,FIFA World Cup qualification,3
Uganda,Zambia,3,0,CECAFA Cup,3
Libya,Mexico,3,1,Friendly,2
New Zealand,Taiwan,5,0,FIFA World Cup qualification,5
Malawi,Uganda,3,1,CECAFA Cup,2
Brunei,Malaysia,0,4,Merlion Cup,4
Zimbabwe,Kenya,2,0,CECAFA Cup,2
Yemen,Mexico,0,2,Friendly,2
Austria,Yugoslavia,0,3,Friendly,3
England,Turkey,5,0,FIFA World Cup qualification,5
Greece,Bulgaria,0,2,Friendly,2
Norway,Denmark,1,5,FIFA World Cup qualification,4
Russia,Republic of Ireland,2,0,FIFA World Cup qualification,2
Wales,Hungary,0,3,Friendly,3
Algeria,Tunisia,3,0,FIFA World Cup qualification,3
Singapore,Malaysia,2,0,Merlion Cup,2
Australia,Taiwan,7,0,FIFA World Cup qualification,7
Singapore,Malaysia,4,0,Merlion Cup,4
New Zealand,Israel,3,1,FIFA World Cup qualification,2
Australia,Taiwan,8,0,FIFA World Cup qualification,8
Chile,Peru,4,2,FIFA World Cup qualification,2
Paraguay,Colombia,3,0,FIFA World Cup qualification,3
France,Luxembourg,6,0,FIFA World Cup qualification,6
Australia,New Zealand,2,0,FIFA World Cup qualification,2
France,Yugoslavia,2,0,FIFA World Cup qualification,2
Israel,New Zealand,3,0,FIFA World Cup qualification,3
Paraguay,Chile,3,0,FIFA World Cup qualification,3
Republic of Ireland,Denmark,1,4,FIFA World Cup qualification,3
Turkey,Romania,1,3,FIFA World Cup qualification,2
Scotland,Australia,2,0,FIFA World Cup qualification,2
Iraq,Syria,3,1,FIFA World Cup qualification,2
Mexico,Algeria,2,0,Friendly,2
Cameroon,Equatorial Guinea,2,0,UDEAC Cup,2
Central African Republic,Congo,1,4,UDEAC Cup,3
Algeria,Hungary,1,3,Friendly,2
Gabon,Central African Republic,4,0,UDEAC Cup,4
Algeria,South Korea,0,2,Friendly,2
Gabon,Chad,3,0,UDEAC Cup,3
Mexico,Hungary,2,0,Friendly,2
Spain,Bulgaria,2,0,Friendly,2
Gabon,Congo,3,0,UDEAC Cup,3
Senegal,Guinea,3,1,Friendly,2
Senegal,Ivory Coast,2,0,Friendly,2
Spain,Russia,2,0,Friendly,2
China PR,Peru,3,1,Nehru Cup,2
Egypt,England,0,4,Friendly,4
Canada,Uruguay,1,3,Friendly,2
Gambia,Guinea-Bissau,3,0,Amílcar Cabral Cup,3
Qatar,Hungary,0,3,Friendly,3
Jamaica,Paraguay,1,4,Friendly,3
Portugal,Luxembourg,2,0,Friendly,2
Gambia,Mauritania,3,1,Amílcar Cabral Cup,2
Senegal,Sierra Leone,3,1,Amílcar Cabral Cup,2
South Korea,Paraguay,1,3,Lunar New Year Cup,2
Zambia,Botswana,6,0,Friendly,6
Iran,Pakistan,2,0,Friendly,2
Zambia,Botswana,3,0,Friendly,3
Portugal,German DR,1,3,Friendly,2
Spain,Belgium,3,0,Friendly,3
Iran,Ghana,2,0,Friendly,2
Bahrain,Finland,0,4,Friendly,4
Ghana,Niger,2,0,West African Cup,2
Algeria,Mozambique,4,1,Friendly,3
Liberia,Niger,3,0,West African Cup,3
Ghana,Liberia,3,0,West African Cup,3
Ghana,Burkina Faso,2,0,West African Cup,2
Niger,Togo,3,1,West African Cup,2
Ghana,Burkina Faso,2,0,West African Cup,2
Qatar,Paraguay,0,3,Friendly,3
Saint Lucia,Norway,0,6,Friendly,6
Togo,Niger,3,1,West African Cup,2
Ivory Coast,Mozambique,3,0,African Cup of Nations,3
Egypt,Ivory Coast,2,0,African Cup of Nations,2
Mozambique,Senegal,0,2,African Cup of Nations,2
Germany,Brazil,2,0,Friendly,2
Egypt,Mozambique,2,0,African Cup of Nations,2
Djibouti,Ethiopia,1,5,Friendly,4
Bahrain,Iceland,0,2,Friendly,2
Hungary,Brazil,3,0,Friendly,3
Saudi Arabia,Kuwait,1,3,Gulf Cup,2
Kuwait,Oman,2,0,Gulf Cup,2
France,Argentina,2,0,Friendly,2
Greece,German DR,2,0,Friendly,2
Scotland,Romania,3,0,Friendly,3
Spain,Poland,3,0,Friendly,3
Saudi Arabia,Oman,3,1,Gulf Cup,2
Brazil,Peru,4,0,Friendly,4
Saudi Arabia,United Arab Emirates,0,2,Gulf Cup,2
Bahrain,United Arab Emirates,1,3,Gulf Cup,2
Qatar,Saudi Arabia,0,2,Gulf Cup,2
Brazil,German DR,3,0,Friendly,3
Bulgaria,Denmark,3,0,Friendly,3
Brazil,Finland,3,0,Friendly,3
Belgium,Bulgaria,2,0,Friendly,2
Czechoslovakia,German DR,2,0,Friendly,2
China PR,Nepal,5,0,Friendly,5
Mexico,Canada,3,0,Friendly,3
Pakistan,China PR,0,3,Friendly,3
South Korea,Nepal,5,0,Friendly,5
Brazil,Yugoslavia,4,2,Friendly,2
Bulgaria,North Korea,3,0,Friendly,3
South Korea,Sri Lanka,4,0,Friendly,4
China PR,Sri Lanka,3,0,Friendly,3
Pakistan,Nepal,5,0,Friendly,5
Switzerland,Algeria,2,0,Friendly,2
Canada,Wales,2,0,Friendly,2
Italy,China PR,2,0,Friendly,2
Germany,Netherlands,3,1,Friendly,2
Mexico,England,0,3,Friendly,3
Belgium,Yugoslavia,1,3,Friendly,2
Canada,Wales,0,3,Friendly,3
Argentina,South Korea,3,1,FIFA World Cup,2
Russia,Hungary,6,0,FIFA World Cup,6
Djibouti,Ethiopia,0,2,Friendly,2
Nepal,Hong Kong,4,2,Friendly,2
Romania,Norway,3,1,Friendly,2
Hungary,Canada,2,0,FIFA World Cup,2
Nepal,Bhutan,4,0,Friendly,4
Denmark,Uruguay,6,1,FIFA World Cup,5
Hungary,France,0,3,FIFA World Cup,3
Russia,Canada,2,0,FIFA World Cup,2
Argentina,Bulgaria,2,0,FIFA World Cup,2
England,Poland,3,0,FIFA World Cup,3
Portugal,Morocco,1,3,FIFA World Cup,2
Algeria,Spain,0,3,FIFA World Cup,3
Northern Ireland,Brazil,0,3,FIFA World Cup,3
Denmark,Germany,2,0,FIFA World Cup,2
Mexico,Bulgaria,2,0,FIFA World Cup,2
Brazil,Poland,4,0,FIFA World Cup,4
Italy,France,0,2,FIFA World Cup,2
Denmark,Spain,1,5,FIFA World Cup,4
England,Paraguay,3,0,FIFA World Cup,3
Malawi,Zambia,0,2,Friendly,2
Argentina,Belgium,2,0,FIFA World Cup,2
France,Germany,0,2,FIFA World Cup,2
France,Belgium,4,2,FIFA World Cup,2
Myanmar,India,3,1,Friendly,2
Malaysia,India,3,0,Merdeka Tournament,3
Malaysia,Thailand,2,0,Merdeka Tournament,2
Guinea,Ivory Coast,0,2,Friendly,2
Ghana,Nigeria,2,0,Friendly,2
India,Thailand,3,1,Merdeka Tournament,2
Liberia,Ivory Coast,0,2,Friendly,2
Finland,Sweden,1,3,Friendly,2
Australia,Czechoslovakia,0,3,Friendly,3
Bahrain,Oman,2,0,Friendly,2
Switzerland,France,2,0,Friendly,2
Singapore,North Korea,0,2,Merlion Cup,2
Singapore,China PR,0,3,Merlion Cup,3
Canada,North Korea,0,2,Merlion Cup,2
Singapore,Saudi Arabia,0,4,Friendly,4
Romania,Austria,4,0,UEFA Euro qualification,4
Fiji,New Zealand,2,4,Friendly,2
Iran,Thailand,4,0,Friendly,4
Denmark,Germany,0,2,Friendly,2
Spain,Greece,3,1,Friendly,2
Sweden,Switzerland,2,0,UEFA Euro qualification,2
Botswana,Malawi,2,0,Friendly,2
Uganda,Somalia,5,0,African Cup of Nations qualification,5
Ethiopia,Tanzania,4,2,African Cup of Nations qualification,2
Israel,Romania,2,4,Friendly,2
Italy,Greece,2,0,Friendly,2
France,Russia,0,2,UEFA Euro qualification,2
Uganda,Kenya,3,1,Friendly,2
Luxembourg,Belgium,0,6,UEFA Euro qualification,6
Austria,Albania,3,0,UEFA Euro qualification,3
Czechoslovakia,Finland,3,0,UEFA Euro qualification,3
England,Northern Ireland,3,0,UEFA Euro qualification,3
Congo,Central African Republic,5,1,African Cup of Nations qualification,4
Austria,Germany,4,1,Friendly,3
German DR,Iceland,2,0,UEFA Euro qualification,2
Russia,Norway,4,0,UEFA Euro qualification,4
Yugoslavia,Turkey,4,0,UEFA Euro qualification,4
England,Yugoslavia,2,0,UEFA Euro qualification,2
Scotland,Luxembourg,3,0,UEFA Euro qualification,3
Malta,Sweden,0,5,UEFA Euro qualification,5
China PR,Australia,0,2,Friendly,2
Cyprus,Greece,2,4,UEFA Euro qualification,2
Malta,Italy,0,2,UEFA Euro qualification,2
Equatorial Guinea,Cameroon,0,2,UDEAC Cup,2
Chad,Cameroon,1,3,UDEAC Cup,2
Saint Lucia,Saint Vincent and the Grenadines,5,1,Windward Islands Tournament,4
Central African Republic,Congo,1,3,UDEAC Cup,2
Chad,Cameroon,1,4,UDEAC Cup,3
Cyprus,Netherlands,0,2,UEFA Euro qualification,2
Barbados,Saint Vincent and the Grenadines,3,0,Friendly,3
El Salvador,Mexico,1,3,Friendly,2
Greece,Cyprus,3,1,UEFA Euro qualification,2
Mali,Burkina Faso,2,0,Friendly,2
Italy,Malta,5,0,UEFA Euro qualification,5
Saint Lucia,Guyana,1,3,Friendly,2
Ivory Coast,Ghana,0,2,West African Cup,2
Liberia,Burkina Faso,2,0,West African Cup,2
Niger,Ghana,0,4,West African Cup,4
Cayman Islands,Jamaica,1,3,Friendly,2
Tunisia,Austria,1,3,Friendly,2
Kuwait,Algeria,2,0,Friendly,2
Spain,England,2,4,Friendly,2
Thailand,Oman,2,0,King's Cup,2
Kuwait,Iraq,2,0,Friendly,2
Panama,Cuba,1,3,Friendly,2
Cape Verde,Senegal,0,2,Amílcar Cabral Cup,2
Dominican Republic,Panama,0,2,Friendly,2
Cape Verde,Sierra Leone,0,2,Amílcar Cabral Cup,2
Turkey,Romania,1,3,Friendly,2
Palau,Vanuatu,2,6,Friendly,4
Poland,Finland,3,1,Friendly,2
Guatemala,El Salvador,2,0,Friendly,2
Ivory Coast,DR Congo,1,3,Friendly,2
Poland,Norway,4,1,Friendly,3
Israel,Germany,0,2,Friendly,2
Romania,Albania,5,1,UEFA Euro qualification,4
Turkey,German DR,3,1,Friendly,2
Yugoslavia,Austria,4,0,Friendly,4
Kenya,Madagascar,2,0,African Cup of Nations qualification,2
Nigeria,Togo,2,0,African Cup of Nations qualification,2
Cameroon,Uganda,5,1,African Cup of Nations qualification,4
DR Congo,Angola,3,0,African Cup of Nations qualification,3
Ivory Coast,Congo,2,0,African Cup of Nations qualification,2
Senegal,Guinea,4,0,African Cup of Nations qualification,4
Belgium,Scotland,4,1,UEFA Euro qualification,3
Northern Ireland,England,0,2,UEFA Euro qualification,2
Wales,Finland,4,0,UEFA Euro qualification,4
Bahrain,Iraq,1,3,Friendly,2
Uganda,Cameroon,3,1,African Cup of Nations qualification,2
Switzerland,Malta,4,1,UEFA Euro qualification,3
Russia,Sweden,1,3,Friendly,2
France,Iceland,2,0,UEFA Euro qualification,2
Jamaica,Cuba,2,0,Friendly,2
Netherlands,Hungary,2,0,UEFA Euro qualification,2
Romania,Spain,3,1,UEFA Euro qualification,2
Russia,German DR,2,0,UEFA Euro qualification,2
Luxembourg,Bulgaria,1,4,UEFA Euro qualification,3
German DR,Czechoslovakia,2,0,Friendly,2
Hungary,Poland,5,3,UEFA Euro qualification,2
Bulgaria,Luxembourg,3,0,UEFA Euro qualification,3
Scotland,Brazil,0,2,Rous Cup,2
Guadeloupe,French Guiana,4,1,Friendly,3
Luxembourg,Republic of Ireland,0,2,UEFA Euro qualification,2
Guadeloupe,Réunion,3,0,Friendly,3
Hong Kong,Macau,5,0,Friendly,5
Israel,Brazil,0,4,Friendly,4
Iceland,German DR,0,6,UEFA Euro qualification,6
Egypt,United States,3,1,Korea Cup,2
Argentina,Italy,1,3,Friendly,2
Malawi,Zimbabwe,1,4,Friendly,3
Bolivia,Paraguay,0,2,Friendly,2
Ecuador,Colombia,3,0,Friendly,3
South Korea,Thailand,4,2,Korea Cup,2
Norway,France,2,0,UEFA Euro qualification,2
Madagascar,Seychelles,2,0,Friendly,2
Peru,Chile,1,3,Friendly,2
Brazil,Ecuador,4,1,Friendly,3
Peru,Chile,2,0,Friendly,2
Brazil,Venezuela,5,0,Copa América,5
Zambia,Ivory Coast,2,0,Friendly,2
Venezuela,Chile,1,3,Copa América,2
Bolivia,Colombia,0,2,Copa América,2
Argentina,Ecuador,3,0,Copa América,3
Chile,Brazil,4,0,Copa América,4
Nigeria,Sierra Leone,3,0,African Cup of Nations qualification,3
Cameroon,Sudan,2,0,African Cup of Nations qualification,2
Colombia,Paraguay,3,0,Copa América,3
Malawi,Burundi,2,4,Friendly,2
Sierra Leone,Nigeria,2,0,African Cup of Nations qualification,2
Ivory Coast,Malawi,2,0,African Cup of Nations qualification,2
São Tomé and Príncipe,Guinea-Bissau,0,2,Friendly,2
Algeria,South Korea,2,0,Indonesia Tournament,2
Poland,German DR,2,0,Friendly,2
Poland,Romania,3,1,Friendly,2
Guyana,Grenada,3,0,Friendly,3
Finland,Czechoslovakia,3,0,UEFA Euro qualification,3
Germany,England,3,1,Friendly,2
Scotland,Hungary,2,0,Friendly,2
Bulgaria,Belgium,2,0,UEFA Euro qualification,2
German DR,Tunisia,2,0,Friendly,2
Russia,Greece,3,0,Friendly,3
Spain,Luxembourg,2,0,Friendly,2
Mexico,Canada,4,0,Friendly,4
England,Turkey,8,0,UEFA Euro qualification,8
Hungary,Greece,3,0,UEFA Euro qualification,3
Republic of Ireland,Bulgaria,2,0,UEFA Euro qualification,2
Poland,Netherlands,0,2,UEFA Euro qualification,2
Scotland,Belgium,2,0,UEFA Euro qualification,2
Spain,Austria,2,0,UEFA Euro qualification,2
Yugoslavia,Northern Ireland,3,0,UEFA Euro qualification,3
Zambia,Angola,2,0,Friendly,2
Czechoslovakia,Poland,3,1,Friendly,2
German DR,Norway,3,1,UEFA Euro qualification,2
Netherlands,Cyprus,8,0,UEFA Euro qualification,8
Russia,Iceland,2,0,UEFA Euro qualification,2
Liberia,Ghana,0,2,Friendly,2
Kuwait,Egypt,0,2,Friendly,2
Mali,Central African Republic,3,1,Friendly,2
Republic of Ireland,Israel,5,0,Friendly,5
Belgium,Luxembourg,3,0,UEFA Euro qualification,3
Czechoslovakia,Wales,2,0,UEFA Euro qualification,2
Yugoslavia,England,1,4,UEFA Euro qualification,3
Spain,Albania,5,0,UEFA Euro qualification,5
Ivory Coast,Togo,3,0,Friendly,3
Barbados,Trinidad and Tobago,0,4,CFU Caribbean Cup qualification,4
Italy,Portugal,3,0,UEFA Euro qualification,3
Trinidad and Tobago,Barbados,5,1,CFU Caribbean Cup qualification,4
Netherlands,Cyprus,4,0,UEFA Euro qualification,4
New Caledonia,American Samoa,10,0,South Pacific Games,10
Vanuatu,Wallis Islands and Futuna,6,1,South Pacific Games,5
American Samoa,Vanuatu,0,7,South Pacific Games,7
New Caledonia,Papua New Guinea,2,0,South Pacific Games,2
Tahiti,Wallis Islands and Futuna,4,0,South Pacific Games,4
American Samoa,Wallis Islands and Futuna,1,5,South Pacific Games,4
Uganda,Zambia,4,0,CECAFA Cup,4
Algeria,Mauritania,3,0,Arab Cup qualification,3
American Samoa,Papua New Guinea,0,20,South Pacific Games,20
Chad,Equatorial Guinea,4,0,UDEAC Cup,4
New Caledonia,Wallis Islands and Futuna,5,1,South Pacific Games,4
Greece,Netherlands,0,3,UEFA Euro qualification,3
Israel,Switzerland,0,2,Friendly,2
New Caledonia,Vanuatu,6,0,South Pacific Games,6
Papua New Guinea,Wallis Islands and Futuna,2,0,South Pacific Games,2
Papua New Guinea,Vanuatu,3,1,South Pacific Games,2
Tanzania,Zanzibar,0,2,CECAFA Cup,2
Malawi,Uganda,0,2,CECAFA Cup,2
Ethiopia,Uganda,3,0,CECAFA Cup,3
Uganda,Zanzibar,2,0,CECAFA Cup,2
Gambia,Ghana,0,2,Friendly,2
Algeria,Congo,4,1,Friendly,3
Czechoslovakia,Finland,0,2,Friendly,2
German DR,Sweden,1,4,Friendly,3
Indonesia,Oman,3,0,King's Cup,3
Jordan,United Arab Emirates,2,0,Friendly,2
Thailand,Oman,3,1,King's Cup,2
United Arab Emirates,Bulgaria,0,3,Friendly,3
United Arab Emirates,Japan,2,0,Friendly,2
Austria,Morocco,1,3,Tournoi de France,2
Israel,Romania,0,2,Friendly,2
United Arab Emirates,Thailand,3,0,AFC Asian Cup qualification,3
Malta,Finland,2,0,Malta International Tournament,2
China PR,Bangladesh,4,0,AFC Asian Cup qualification,4
Israel,Poland,1,3,Friendly,2
Finland,Tunisia,3,0,Malta International Tournament,3
United Arab Emirates,India,3,0,AFC Asian Cup qualification,3
China PR,Thailand,5,0,AFC Asian Cup qualification,5
United Arab Emirates,Bangladesh,4,0,AFC Asian Cup qualification,4
Italy,Russia,4,1,Friendly,3
Djibouti,Yemen DPR,4,1,Friendly,3
Iraq,Tunisia,2,0,Friendly,2
Saudi Arabia,Oman,2,0,Gulf Cup,2
United Arab Emirates,Bahrain,2,0,Gulf Cup,2
Oman,Bahrain,0,2,Gulf Cup,2
Guadeloupe,Suriname,0,2,CFU Caribbean Cup qualification,2
Qatar,Iraq,0,3,Gulf Cup,3
Kenya,Nigeria,0,3,African Cup of Nations,3
Oman,Kuwait,0,2,Gulf Cup,2
Saudi Arabia,Iraq,0,2,Gulf Cup,2
Egypt,Kenya,3,0,African Cup of Nations,3
Bulgaria,Czechoslovakia,2,0,Friendly,2
Greece,Russia,0,4,Friendly,4
Republic of Ireland,Romania,2,0,Friendly,2
Belgium,Hungary,3,0,Friendly,3
Peru,Canada,1,3,Friendly,2
Mexico,El Salvador,8,0,Friendly,8
Colombia,Canada,3,0,Friendly,3
Argentina,Russia,2,4,Friendly,2
Sweden,Russia,2,0,Friendly,2
Jamaica,Canada,0,4,Friendly,4
Malaysia,Pakistan,4,0,AFC Asian Cup qualification,4
Kuwait,Pakistan,3,0,AFC Asian Cup qualification,3
Guyana,Trinidad and Tobago,0,4,CONCACAF Championship qualification,4
Japan,Pakistan,4,1,AFC Asian Cup qualification,3
Malaysia,Kuwait,0,5,AFC Asian Cup qualification,5
Mexico,Honduras,4,1,Friendly,3
Republic of Ireland,Yugoslavia,2,0,Friendly,2
Luxembourg,Italy,0,3,Friendly,3
Sweden,Wales,4,1,Friendly,3
Gambia,Senegal,0,4,Amílcar Cabral Cup,4
Cape Verde,Mali,1,3,Amílcar Cabral Cup,2
Gambia,Sierra Leone,1,3,Amílcar Cabral Cup,2
Guinea-Bissau,Gambia,3,1,Amílcar Cabral Cup,2
Hungary,Iceland,3,0,Friendly,3
Guinea,Sierra Leone,3,0,Amílcar Cabral Cup,3
Macau,Hong Kong,0,2,Friendly,2
Hungary,Austria,0,4,Friendly,4
Finland,Colombia,1,3,Friendly,2
Canada,Greece,0,3,Matthews Cup,3
Northern Ireland,Malta,3,0,FIFA World Cup qualification,3
Republic of Ireland,Poland,3,1,Friendly,2
Burkina Faso,Ghana,3,0,Friendly,3
Iran,Hong Kong,2,0,AFC Asian Cup qualification,2
Nepal,Syria,0,3,AFC Asian Cup qualification,3
Netherlands,Romania,2,0,Friendly,2
Spain,Sweden,1,3,Friendly,2
Japan,China PR,0,3,Kirin Cup,3
Libya,Burkina Faso,3,0,FIFA World Cup qualification,3
Syria,Hong Kong,2,0,AFC Asian Cup qualification,2
United States,Chile,1,3,Friendly,2
Nepal,Iran,0,3,AFC Asian Cup qualification,3
Denmark,Belgium,3,1,Friendly,2
United States,Chile,0,3,Friendly,3
United States,Ecuador,0,2,Friendly,2
Germany,Denmark,2,0,UEFA Euro,2
England,Netherlands,1,3,UEFA Euro,2
Bahrain,South Korea,2,0,AFC Asian Cup qualification,2
Germany,Spain,2,0,UEFA Euro,2
Italy,Denmark,2,0,UEFA Euro,2
England,Russia,1,3,UEFA Euro,2
South Korea,Zambia,4,0,Korea Cup,4
Saudi Arabia,New Zealand,0,2,Friendly,2
Bahrain,Yemen DPR,2,0,AFC Asian Cup qualification,2
Indonesia,South Korea,0,4,AFC Asian Cup qualification,4
Russia,Italy,2,0,UEFA Euro,2
Russia,Netherlands,0,2,UEFA Euro,2
Hong Kong,Saudi Arabia,0,3,Friendly,3
Burkina Faso,Libya,2,0,FIFA World Cup qualification,2
Guadeloupe,Trinidad and Tobago,0,3,CFU Caribbean Cup,3
Australia,Saudi Arabia,3,0,Friendly,3
Martinique,Trinidad and Tobago,0,3,CFU Caribbean Cup,3
Brazil,Saudi Arabia,4,1,Friendly,3
Australia,Argentina,4,1,Friendly,3
Egypt,Lebanon,3,0,Arab Cup,3
Argentina,Saudi Arabia,2,0,Friendly,2
Jordan,Syria,2,0,Arab Cup,2
Australia,Brazil,0,2,Friendly,2
Jordan,Iraq,0,3,Arab Cup,3
Jordan,Egypt,0,2,Arab Cup,2
Burkina Faso,Ghana,3,1,Tournament Burkina Faso,2
Curaçao,Antigua and Barbuda,3,1,CONCACAF Championship qualification,2
Ghana,Niger,0,3,Tournament Burkina Faso,3
Malawi,Uganda,3,1,FIFA World Cup qualification,2
Panama,Costa Rica,0,2,CONCACAF Championship qualification,2
Angola,Gabon,4,1,Friendly,3
Benin,Niger,0,5,Tournament Burkina Faso,5
Austria,Brazil,0,2,Friendly,2
Zambia,Malawi,4,1,Friendly,3
Zambia,Malawi,7,1,Friendly,6
Tunisia,Guinea,5,0,FIFA World Cup qualification,5
United States,Jamaica,5,1,CONCACAF Championship qualification,4
Guinea,Tunisia,3,0,FIFA World Cup qualification,3
Liberia,Ghana,2,0,FIFA World Cup qualification,2
Switzerland,Yugoslavia,0,2,Friendly,2
Finland,Germany,0,4,FIFA World Cup qualification,4
Ecuador,Paraguay,1,5,Friendly,4
Chile,Ecuador,3,1,Friendly,2
Honduras,Paraguay,0,2,Friendly,2
Czechoslovakia,Austria,4,2,Friendly,2
Romania,Albania,3,0,Friendly,3
Iceland,Hungary,0,3,Friendly,3
Luxembourg,Switzerland,1,4,FIFA World Cup qualification,3
Turkey,Greece,3,1,Friendly,2
Paraguay,Chile,2,0,Friendly,2
Paraguay,Uruguay,3,1,Friendly,2
Mauritius,Seychelles,3,0,African Cup of Nations qualification,3
Indonesia,Qatar,1,4,Friendly,3
Gabon,Burkina Faso,3,0,African Cup of Nations qualification,3
Uruguay,Paraguay,2,0,Friendly,2
Australia,New Zealand,2,0,Friendly,2
El Salvador,Curaçao,5,0,CONCACAF Championship qualification,5
Mali,Liberia,3,0,African Cup of Nations qualification,3
Israel,Malta,2,0,Friendly,2
Luxembourg,Czechoslovakia,0,2,FIFA World Cup qualification,2
Bulgaria,Romania,1,3,FIFA World Cup qualification,2
German DR,Iceland,2,0,FIFA World Cup qualification,2
Republic of Ireland,Tunisia,4,0,Friendly,4
Russia,Austria,2,0,FIFA World Cup qualification,2
New Caledonia,Vanuatu,6,1,Friendly,5
Fiji,Vanuatu,8,0,Friendly,8
Chile,Peru,2,0,Copa del Pacífico,2
Fiji,New Caledonia,2,0,Friendly,2
Solomon Islands,Vanuatu,5,0,Friendly,5
Solomon Islands,Fiji,1,3,Friendly,2
Cyprus,Norway,0,3,FIFA World Cup qualification,3
Romania,Greece,3,0,FIFA World Cup qualification,3
Kenya,Zanzibar,2,0,CECAFA Cup,2
Tunisia,Angola,5,0,Friendly,5
Uruguay,Chile,3,1,Copa Juan Pinto Durán,2
Kenya,Tanzania,2,0,CECAFA Cup,2
Malawi,Kenya,3,0,CECAFA Cup,3
Algeria,Mali,7,0,Friendly,7
Uganda,Zambia,0,3,CECAFA Cup,3
Greece,Hungary,3,0,Friendly,3
Spain,Republic of Ireland,2,0,FIFA World Cup qualification,2
Fiji,New Zealand,2,0,Friendly,2
Malawi,Zambia,3,1,CECAFA Cup,2
Syria,Russia,0,2,Friendly,2
Romania,Israel,3,0,Friendly,3
Kuwait,Russia,0,2,Friendly,2
Turkey,German DR,3,1,FIFA World Cup qualification,2
Qatar,Iran,0,2,AFC Asian Cup,2
Syria,Saudi Arabia,0,2,AFC Asian Cup,2
Australia,Fiji,5,1,FIFA World Cup qualification,4
China PR,Syria,3,0,AFC Asian Cup,3
Equatorial Guinea,Gabon,0,3,UDEAC Cup,3
Cameroon,Congo,2,0,UDEAC Cup,2
South Korea,Japan,2,0,AFC Asian Cup,2
Central African Republic,Congo,0,3,UDEAC Cup,3
Oman,Singapore,1,3,Merdeka Tournament,2
South Korea,Iran,3,0,AFC Asian Cup,3
Yugoslavia,Cyprus,4,0,FIFA World Cup qualification,4
New Zealand,Taiwan,4,0,FIFA World Cup qualification,4
Qatar,Japan,3,0,AFC Asian Cup,3
Egypt,Switzerland,1,3,Friendly,2
Uruguay,Peru,3,0,Friendly,3
Morocco,Gabon,5,2,Friendly,3
New Zealand,Taiwan,4,1,FIFA World Cup qualification,3
Spain,Northern Ireland,4,0,FIFA World Cup qualification,4
Italy,Scotland,2,0,Friendly,2
Israel,Netherlands,0,2,Friendly,2
Algeria,Zimbabwe,3,0,FIFA World Cup qualification,3
Egypt,Liberia,2,0,FIFA World Cup qualification,2
DR Congo,Tunisia,3,1,FIFA World Cup qualification,2
Jordan,Oman,2,0,FIFA World Cup qualification,2
United Arab Emirates,Pakistan,5,0,FIFA World Cup qualification,5
Gabon,Cameroon,1,3,FIFA World Cup qualification,2
Malta,Spain,0,2,FIFA World Cup qualification,2
Zambia,DR Congo,4,2,FIFA World Cup qualification,2
Iraq,Oman,3,1,FIFA World Cup qualification,2
Kuwait,Pakistan,2,0,FIFA World Cup qualification,2
Thailand,Indonesia,3,0,King's Cup,3
Indonesia,Malaysia,1,3,King's Cup,2
Iraq,Jordan,4,0,FIFA World Cup qualification,4
Qatar,Oman,3,0,FIFA World Cup qualification,3
China PR,North Korea,3,1,King's Cup,2
Algeria,Finland,2,0,Malta International Tournament,2
Malta,Denmark,0,2,Malta International Tournament,2
Northern Ireland,Spain,0,2,FIFA World Cup qualification,2
Thailand,China PR,2,0,King's Cup,2
Oman,Jordan,0,2,FIFA World Cup qualification,2
Pakistan,United Arab Emirates,1,4,FIFA World Cup qualification,3
Egypt,German DR,0,4,Friendly,4
Mexico,Poland,3,1,Friendly,2
Greece,Norway,4,2,Friendly,2
China PR,Bangladesh,2,0,FIFA World Cup qualification,2
El Salvador,Mexico,0,2,Friendly,2
Thailand,Iran,0,3,FIFA World Cup qualification,3
Thailand,China PR,0,3,FIFA World Cup qualification,3
Guatemala,El Salvador,3,0,Friendly,3
Bangladesh,China PR,0,2,FIFA World Cup qualification,2
Albania,England,0,2,FIFA World Cup qualification,2
Bangladesh,Thailand,3,1,FIFA World Cup qualification,2
Scotland,France,2,0,FIFA World Cup qualification,2
Australia,New Zealand,4,1,FIFA World Cup qualification,3
Jamaica,Paraguay,0,3,Friendly,3
Martinique,Paraguay,0,2,Friendly,2
Guadeloupe,Paraguay,0,2,Friendly,2
Netherlands,Russia,2,0,Friendly,2
Spain,Malta,4,0,FIFA World Cup qualification,4
Syria,Yemen,2,0,FIFA World Cup qualification,2
Portugal,Angola,6,0,Friendly,6
Aruba,Trinidad and Tobago,0,7,Friendly,7
New Zealand,Australia,2,0,FIFA World Cup qualification,2
Algeria,Tunisia,2,0,Friendly,2
Hungary,Switzerland,3,0,Friendly,3
Greece,Yugoslavia,1,4,Friendly,3
Angola,Ivory Coast,0,2,African Cup of Nations qualification,2
Mauritius,Zimbabwe,1,4,African Cup of Nations qualification,3
Eswatini,Malawi,0,2,African Cup of Nations qualification,2
Brazil,Paraguay,2,0,Friendly,2
Denmark,Canada,2,0,Friendly,2
German DR,Turkey,0,2,FIFA World Cup qualification,2
Egypt,Ethiopia,6,1,African Cup of Nations qualification,5
Nigeria,Guinea,3,0,African Cup of Nations qualification,3
Ivory Coast,Angola,4,1,African Cup of Nations qualification,3
Trinidad and Tobago,Aruba,11,0,CFU Caribbean Cup qualification,11
Bulgaria,Denmark,0,2,FIFA World Cup qualification,2
Curaçao,Martinique,3,1,CFU Caribbean Cup qualification,2
England,Albania,5,0,FIFA World Cup qualification,5
Italy,Hungary,4,0,Friendly,4
Malta,Northern Ireland,0,2,FIFA World Cup qualification,2
Portugal,Switzerland,3,1,FIFA World Cup qualification,2
Russia,German DR,3,0,FIFA World Cup qualification,3
Wales,Sweden,0,2,Friendly,2
Zambia,Mozambique,3,0,African Cup of Nations qualification,3
Norway,Poland,0,3,Friendly,3
Uruguay,Ecuador,3,1,Friendly,2
Jamaica,Guadeloupe,1,3,CFU Caribbean Cup qualification,2
Czechoslovakia,Luxembourg,4,0,FIFA World Cup qualification,4
Brazil,Peru,4,1,Friendly,3
French Guiana,Trinidad and Tobago,1,3,CFU Caribbean Cup qualification,2
Japan,China PR,2,0,Friendly,2
Denmark,Greece,7,1,FIFA World Cup qualification,6
Norway,Cyprus,3,1,FIFA World Cup qualification,2
Saint Kitts and Nevis,Trinidad and Tobago,0,2,CFU Caribbean Cup qualification,2
South Korea,Singapore,3,0,FIFA World Cup qualification,3
Malaysia,Nepal,2,0,FIFA World Cup qualification,2
South Korea,Nepal,9,0,FIFA World Cup qualification,9
South Korea,Malaysia,3,0,FIFA World Cup qualification,3
Scotland,England,0,2,Rous Cup,2
Singapore,Nepal,3,0,FIFA World Cup qualification,3
Republic of Ireland,Malta,2,0,FIFA World Cup qualification,2
Guinea,Mauritania,3,1,Amílcar Cabral Cup,2
Iran,Thailand,3,0,FIFA World Cup qualification,3
Scotland,Chile,2,0,Rous Cup,2
Norway,Austria,4,1,Friendly,3
Sweden,Algeria,2,0,Friendly,2
Luxembourg,Belgium,0,5,FIFA World Cup qualification,5
Paraguay,Bolivia,2,0,Friendly,2
Curaçao,British Virgin Islands,4,0,CFU Caribbean Cup qualification,4
Egypt,Chile,2,0,Friendly,2
England,Poland,3,0,FIFA World Cup qualification,3
Nepal,South Korea,0,4,FIFA World Cup qualification,4
Republic of Ireland,Hungary,2,0,FIFA World Cup qualification,2
Mali,Guinea,3,0,Amílcar Cabral Cup,3
United States,Peru,3,0,Friendly,3
Malaysia,South Korea,0,3,FIFA World Cup qualification,3
Singapore,Nepal,7,0,FIFA World Cup qualification,7
Malaysia,Nepal,3,0,FIFA World Cup qualification,3
Martinique,Sint Maarten,10,0,CFU Caribbean Cup qualification,10
Singapore,South Korea,0,3,FIFA World Cup qualification,3
Brazil,Portugal,4,0,Friendly,4
Canada,Belgium,0,2,Friendly,2
French Guiana,Aruba,4,0,CFU Caribbean Cup qualification,4
Nigeria,Cameroon,2,0,FIFA World Cup qualification,2
Angola,Gabon,2,0,FIFA World Cup qualification,2
Japan,Indonesia,5,0,FIFA World Cup qualification,5
Denmark,Sweden,6,0,Friendly,6
Aruba,Saint Kitts and Nevis,1,4,CFU Caribbean Cup qualification,3
Denmark,Brazil,4,0,Friendly,4
El Salvador,Costa Rica,2,4,CONCACAF Championship,2
North Korea,Japan,2,0,FIFA World Cup qualification,2
Venezuela,Peru,3,1,Friendly,2
Haiti,Colombia,0,4,Friendly,4
Brazil,Venezuela,3,1,Copa América,2
Paraguay,Peru,5,2,Copa América,3
Grenada,Saint Vincent and the Grenadines,2,0,CFU Caribbean Cup,2
North Korea,Hong Kong,4,1,FIFA World Cup qualification,3
Venezuela,Colombia,2,4,Copa América,2
Uruguay,Bolivia,3,0,Copa América,3
Barbados,Trinidad and Tobago,0,3,CFU Caribbean Cup,3
Chile,Uruguay,0,3,Copa América,3
Malawi,Gabon,2,0,Friendly,2
Faroe Islands,Ynys Môn,6,0,Island Games,6
Greenland,Shetland,4,1,Island Games,3
Guadeloupe,Trinidad and Tobago,2,0,CFU Caribbean Cup,2
Paraguay,Venezuela,3,0,Copa América,3
Bolivia,Chile,0,5,Copa América,5
Faroe Islands,Shetland,4,0,Island Games,4
Brazil,Paraguay,2,0,Copa América,2
Faroe Islands,Greenland,3,0,Island Games,3
Åland Islands,Shetland,2,0,Island Games,2
Malawi,Mozambique,0,2,Friendly,2
Åland Islands,Greenland,3,0,Island Games,3
Ynys Môn,Shetland,3,0,Island Games,3
Brazil,Argentina,2,0,Copa América,2
Paraguay,Uruguay,0,3,Copa América,3
Faroe Islands,Åland Islands,7,1,Island Games,6
Argentina,Uruguay,0,2,Copa América,2
Brazil,Paraguay,3,0,Copa América,3
China PR,Iran,2,0,FIFA World Cup qualification,2
Egypt,DR Congo,2,0,African Cup of Nations qualification,2
Nigeria,Zimbabwe,3,0,African Cup of Nations qualification,3
Zambia,Gabon,3,0,African Cup of Nations qualification,3
Senegal,Tunisia,3,0,African Cup of Nations qualification,3
China PR,Thailand,2,0,FIFA World Cup qualification,2
Ivory Coast,Mali,3,1,African Cup of Nations qualification,2
Trinidad and Tobago,El Salvador,2,0,CONCACAF Championship,2
Venezuela,Brazil,0,4,FIFA World Cup qualification,4
Tunisia,Malawi,3,0,Friendly,3
Venezuela,Chile,1,3,FIFA World Cup qualification,2
Mexico,South Korea,4,2,Friendly,2
Ivory Coast,Zimbabwe,5,0,FIFA World Cup qualification,5
Sweden,France,2,4,Friendly,2
Brazil,Venezuela,6,0,FIFA World Cup qualification,6
Colombia,Ecuador,2,0,FIFA World Cup qualification,2
Belgium,Denmark,3,0,Friendly,3
Egypt,Kenya,2,0,FIFA World Cup qualification,2
Chile,Venezuela,5,0,FIFA World Cup qualification,5
Peru,Uruguay,0,2,FIFA World Cup qualification,2
Trinidad and Tobago,Panama,2,0,Friendly,2
Czechoslovakia,Romania,2,0,Friendly,2
Poland,Greece,3,0,Friendly,3
Belgium,Portugal,3,0,FIFA World Cup qualification,3
Iceland,German DR,0,3,FIFA World Cup qualification,3
Yugoslavia,Scotland,3,1,FIFA World Cup qualification,2
Uruguay,Bolivia,2,0,FIFA World Cup qualification,2
Italy,Bulgaria,4,0,Friendly,4
Kuwait,China PR,2,0,Friendly,2
Yugoslavia,Greece,3,0,Friendly,3
Ecuador,Paraguay,3,1,FIFA World Cup qualification,2
Uruguay,Peru,2,0,FIFA World Cup qualification,2
Germany,Finland,6,1,FIFA World Cup qualification,5
Cameroon,Tunisia,2,0,FIFA World Cup qualification,2
Sweden,Albania,3,1,FIFA World Cup qualification,2
Bulgaria,Greece,4,0,FIFA World Cup qualification,4
Denmark,Romania,3,0,FIFA World Cup qualification,3
France,Scotland,3,0,FIFA World Cup qualification,3
Republic of Ireland,Northern Ireland,3,0,FIFA World Cup qualification,3
Luxembourg,Portugal,0,3,FIFA World Cup qualification,3
North Korea,Qatar,2,0,FIFA World Cup qualification,2
Liberia,Guinea,2,0,Friendly,2
Czechoslovakia,Switzerland,3,0,FIFA World Cup qualification,3
Malta,German DR,0,4,Friendly,4
Poland,Sweden,0,2,FIFA World Cup qualification,2
Saudi Arabia,South Korea,0,2,FIFA World Cup qualification,2
Trinidad and Tobago,Finland,2,0,Friendly,2
Turkey,Austria,3,0,FIFA World Cup qualification,3
Saudi Arabia,North Korea,2,0,FIFA World Cup qualification,2
Solomon Islands,Vanuatu,2,0,Friendly,2
Kuwait,Lebanon,5,0,Friendly,5
New Caledonia,Solomon Islands,2,0,Friendly,2
Fiji,New Caledonia,3,0,Friendly,3
Papua New Guinea,Vanuatu,3,0,Friendly,3
Iran,Yemen DPR,2,0,Friendly,2
Lebanon,Uganda,0,2,Friendly,2
Iraq,Yemen DPR,6,2,Friendly,4
New Caledonia,Vanuatu,5,1,Friendly,4
Qatar,Egypt,0,2,Friendly,2
Austria,German DR,3,0,FIFA World Cup qualification,3
Malta,Republic of Ireland,0,2,FIFA World Cup qualification,2
Netherlands,Finland,3,0,FIFA World Cup qualification,3
Romania,Denmark,3,1,FIFA World Cup qualification,2
Russia,Turkey,2,0,FIFA World Cup qualification,2
Spain,Hungary,4,0,FIFA World Cup qualification,4
France,Cyprus,2,0,FIFA World Cup qualification,2
Senegal,Central African Republic,3,0,Friendly,3
Liberia,Guinea,2,0,Friendly,2
Tanzania,Zimbabwe,0,3,CECAFA Cup,3
Congo,Gabon,0,2,UDEAC Cup,2
Tanzania,Uganda,1,5,CECAFA Cup,4
Chad,Gabon,0,2,UDEAC Cup,2
Uganda,Zambia,3,1,CECAFA Cup,2
Algeria,Mali,5,0,Friendly,5
Algeria,Cameroon,3,1,Friendly,2
Greece,Belgium,2,0,Friendly,2
Mexico,Argentina,2,0,Friendly,2
Eswatini,Botswana,3,1,Friendly,2
France,German DR,3,0,Friendly,3
Nigeria,Ivory Coast,2,0,Friendly,2
Colombia,Uruguay,0,2,Friendly,2
Iran,Poland,0,2,Friendly,2
United States,Costa Rica,0,2,Friendly,2
Costa Rica,Uruguay,0,2,Friendly,2
Uganda,Mauritius,4,1,Friendly,3
United Arab Emirates,Sweden,0,2,Friendly,2
United States,Russia,1,3,Friendly,2
Algeria,Nigeria,5,1,African Cup of Nations,4
Ivory Coast,Egypt,3,1,African Cup of Nations,2
Oman,Qatar,2,4,Gulf Cup,2
Algeria,Ivory Coast,3,0,African Cup of Nations,3
Cameroon,Senegal,0,2,African Cup of Nations,2
Kuwait,Qatar,2,0,Gulf Cup,2
Lesotho,Zimbabwe,1,4,Friendly,3
Algeria,Egypt,2,0,African Cup of Nations,2
Angola,Zimbabwe,0,2,Friendly,2
Cameroon,Kenya,2,0,African Cup of Nations,2
Kuwait,United Arab Emirates,6,1,Gulf Cup,5
Angola,Lesotho,3,1,Friendly,2
Mozambique,Zimbabwe,3,1,Friendly,2
Mozambique,Lesotho,3,0,Friendly,3
Nigeria,Zambia,2,0,African Cup of Nations,2
Hungary,United States,2,0,Friendly,2
Saint Kitts and Nevis,Antigua and Barbuda,3,1,Friendly,2
Saint Martin,British Virgin Islands,3,0,CFU Caribbean Cup qualification,3
Egypt,Romania,1,3,Friendly,2
Hungary,France,1,3,Friendly,2
Zambia,Tanzania,2,0,Friendly,2
Bermuda,Iceland,0,4,Friendly,4
United States,Iceland,4,1,Friendly,3
Austria,Hungary,3,0,Friendly,3
German DR,Egypt,2,0,Friendly,2
Bermuda,Antigua and Barbuda,3,0,Friendly,3
Mexico,Colombia,2,0,Friendly,2
Martinique,French Guiana,4,0,CFU Caribbean Cup qualification,4
England,Czechoslovakia,4,2,Friendly,2
Israel,Romania,1,4,Friendly,3
Sweden,Wales,4,2,Friendly,2
Gabon,Martinique,0,2,Friendly,2
Jamaica,Saint Kitts and Nevis,3,0,CFU Caribbean Cup qualification,3
Suriname,Guyana,5,0,CFU Caribbean Cup qualification,5
Costa Rica,Poland,0,2,Friendly,2
United States,Poland,3,1,Friendly,2
Saint Lucia,Bermuda,0,2,CFU Caribbean Cup qualification,2
Grenada,Suriname,3,1,CFU Caribbean Cup qualification,2
Scotland,Egypt,1,3,Friendly,2
Barbados,Suriname,5,0,Friendly,5
Mauritania,Gambia,2,0,African Cup of Nations qualification,2
Saint Kitts and Nevis,Guadeloupe,2,0,CFU Caribbean Cup qualification,2
Poland,United Arab Emirates,4,0,Friendly,4
Antigua and Barbuda,Saint Lucia,0,2,CFU Caribbean Cup qualification,2
Sweden,Finland,6,0,Friendly,6
Hungary,United Arab Emirates,3,0,Friendly,3
Bermuda,Barbados,3,0,Friendly,3
Iceland,Albania,2,0,UEFA Euro qualification,2
Liechtenstein,United States,1,4,Friendly,3
Jordan,Iraq,0,2,Friendly,2
Belgium,Mexico,3,0,Friendly,3
Hungary,Colombia,3,1,Friendly,2
Malta,Republic of Ireland,0,3,Friendly,3
Yugoslavia,Netherlands,0,2,Friendly,2
Russia,Romania,0,2,FIFA World Cup,2
United Arab Emirates,Colombia,0,2,FIFA World Cup,2
Germany,Yugoslavia,4,1,FIFA World Cup,3
United States,Czechoslovakia,1,5,FIFA World Cup,4
Belgium,South Korea,2,0,FIFA World Cup,2
Argentina,Russia,2,0,FIFA World Cup,2
Germany,United Arab Emirates,5,1,FIFA World Cup,4
Belgium,Uruguay,3,1,FIFA World Cup,2
South Korea,Spain,1,3,FIFA World Cup,2
Cameroon,Russia,0,4,FIFA World Cup,4
Italy,Czechoslovakia,2,0,FIFA World Cup,2
Yugoslavia,United Arab Emirates,4,1,FIFA World Cup,3
Czechoslovakia,Costa Rica,4,1,FIFA World Cup,3
Italy,Uruguay,2,0,FIFA World Cup,2
Malawi,Tanzania,2,0,Friendly,2
Barbados,Grenada,4,0,Friendly,4
China PR,North Korea,2,0,Dynasty Cup,2
Japan,South Korea,0,2,Dynasty Cup,2
Egypt,Ethiopia,2,0,African Cup of Nations qualification,2
Indonesia,Singapore,6,0,Friendly,6
DR Congo,Tanzania,2,0,African Cup of Nations qualification,2
Ivory Coast,Mauritania,2,0,African Cup of Nations qualification,2
Morocco,Niger,2,0,African Cup of Nations qualification,2
Zambia,Eswatini,5,0,African Cup of Nations qualification,5
Burkina Faso,Benin,2,0,African Cup of Nations qualification,2
Nigeria,Togo,3,0,African Cup of Nations qualification,3
Austria,Switzerland,1,3,Friendly,2
Indonesia,Australia,0,3,Friendly,3
Zambia,Zimbabwe,3,1,Friendly,2
Botswana,Zimbabwe,0,7,Friendly,7
Mozambique,Angola,0,2,Friendly,2
Congo,Zimbabwe,2,0,African Cup of Nations qualification,2
Burkina Faso,Togo,2,0,African Cup of Nations qualification,2
Morocco,Mauritania,4,0,African Cup of Nations qualification,4
Hungary,Turkey,4,1,Friendly,3
Belgium,German DR,0,2,Friendly,2
Northern Ireland,Yugoslavia,0,2,UEFA Euro qualification,2
Russia,Norway,2,0,UEFA Euro qualification,2
Spain,Brazil,3,0,Friendly,3
Switzerland,Bulgaria,2,0,UEFA Euro qualification,2
Singapore,Malaysia,3,0,Friendly,3
United States,Trinidad and Tobago,3,0,Friendly,3
Sweden,Bulgaria,2,0,Friendly,2
Aruba,Curaçao,1,3,Friendly,2
Denmark,Faroe Islands,4,1,UEFA Euro qualification,3
Greece,Egypt,6,1,Friendly,5
Sweden,Germany,1,3,Friendly,2
Niger,Mauritania,7,1,African Cup of Nations qualification,6
Ghana,Burkina Faso,2,0,African Cup of Nations qualification,2
England,Poland,2,0,UEFA Euro qualification,2
Republic of Ireland,Turkey,5,0,UEFA Euro qualification,5
Romania,Bulgaria,0,3,UEFA Euro qualification,3
Wales,Belgium,3,1,UEFA Euro qualification,2
Greece,Malta,4,0,UEFA Euro qualification,4
Hungary,Cyprus,4,2,UEFA Euro qualification,2
Norway,Cameroon,6,1,Friendly,5
Yugoslavia,Austria,4,1,UEFA Euro qualification,3
Tunisia,Norway,1,3,Friendly,2
New Caledonia,Solomon Islands,3,1,Friendly,2
Angola,Mozambique,4,2,Friendly,2
Cyprus,Norway,0,3,UEFA Euro qualification,3
Denmark,Yugoslavia,0,2,UEFA Euro qualification,2
San Marino,Switzerland,0,4,UEFA Euro qualification,4
Ethiopia,Tunisia,0,2,African Cup of Nations qualification,2
Netherlands,Greece,2,0,UEFA Euro qualification,2
Trinidad and Tobago,Russia,0,2,Friendly,2
Guatemala,Russia,0,3,Friendly,3
Romania,San Marino,6,0,UEFA Euro qualification,6
Congo,Chad,3,0,UDEAC Cup,3
Central African Republic,Cameroon,0,3,UDEAC Cup,3
Congo,Equatorial Guinea,6,0,UDEAC Cup,6
Tanzania,Zimbabwe,2,0,CECAFA Cup,2
Germany,Switzerland,4,0,Friendly,4
Malta,Netherlands,0,8,UEFA Euro qualification,8
Spain,Albania,9,0,UEFA Euro qualification,9
Sudan,Uganda,0,2,CECAFA Cup,2
Croatia,Romania,2,0,Friendly,2
Cyprus,Italy,0,4,UEFA Euro qualification,4
Burkina Faso,Mali,2,0,Friendly,2
Russia,Zambia,4,0,Nehru Cup,4
Ghana,Benin,4,0,African Cup of Nations qualification,4
Morocco,Ivory Coast,3,1,African Cup of Nations qualification,2
Hungary,Zambia,4,1,Nehru Cup,3
India,Russia,1,3,Nehru Cup,2
Northern Ireland,Poland,3,1,Friendly,2
Australia,Czechoslovakia,0,2,Friendly,2
England,Cameroon,2,0,Friendly,2
Wales,Republic of Ireland,0,3,Friendly,3
Guinea-Bissau,Mauritania,2,0,Friendly,2
Senegal,Algeria,1,3,Friendly,2
Argentina,Hungary,2,0,Friendly,2
France,Spain,3,1,UEFA Euro qualification,2
Portugal,Malta,5,0,UEFA Euro qualification,5
Belgium,Luxembourg,3,0,UEFA Euro qualification,3
Suriname,French Guiana,3,0,Friendly,3
Liechtenstein,Switzerland,0,6,Friendly,6
Canada,Mexico,0,3,NAFU Championship,3
United States,Canada,2,0,NAFU Championship,2
Czechoslovakia,Poland,4,0,Friendly,4
San Marino,Romania,1,3,UEFA Euro qualification,2
Spain,Hungary,2,4,Friendly,2
Yugoslavia,Northern Ireland,4,1,UEFA Euro qualification,3
France,Albania,5,0,UEFA Euro qualification,5
Cyprus,Hungary,0,2,UEFA Euro qualification,2
Mali,Burkina Faso,5,1,Friendly,4
Mauritania,Morocco,0,2,African Cup of Nations qualification,2
Zimbabwe,Malawi,4,0,African Cup of Nations qualification,4
Netherlands,Finland,2,0,UEFA Euro qualification,2
Poland,Turkey,3,0,UEFA Euro qualification,3
Spain,Romania,0,2,Friendly,2
Nigeria,Benin,3,0,African Cup of Nations qualification,3
Mali,Cameroon,0,2,African Cup of Nations qualification,2
Ghana,Togo,2,0,African Cup of Nations qualification,2
Albania,Czechoslovakia,0,2,UEFA Euro qualification,2
Italy,Hungary,3,1,UEFA Euro qualification,2
Norway,Cyprus,3,0,UEFA Euro qualification,3
San Marino,Scotland,0,2,UEFA Euro qualification,2
Sweden,Austria,6,0,Friendly,6
Jamaica,Haiti,2,0,Friendly,2
Malta,Iceland,1,4,Friendly,3
Mexico,Uruguay,0,2,Friendly,2
Guyana,Aruba,4,1,CFU Caribbean Cup qualification,3
Saint Lucia,Montserrat,3,0,CFU Caribbean Cup qualification,3
Panama,Honduras,2,0,UNCAF Cup,2
Hong Kong,Malaysia,2,0,Friendly,2
Puerto Rico,Dominican Republic,1,3,CFU Caribbean Cup qualification,2
Finland,Malta,2,0,UEFA Euro qualification,2
Saint Lucia,Anguilla,6,0,CFU Caribbean Cup qualification,6
Yugoslavia,Faroe Islands,7,0,UEFA Euro qualification,7
Honduras,Panama,3,0,UNCAF Cup,3
Martinique,Guadeloupe,3,1,CFU Caribbean Cup qualification,2
England,Russia,3,1,Friendly,2
Austria,Faroe Islands,3,0,UEFA Euro qualification,3
San Marino,Bulgaria,0,3,UEFA Euro qualification,3
Dominican Republic,Trinidad and Tobago,0,7,CFU Caribbean Cup,7
Jamaica,Guyana,6,0,CFU Caribbean Cup,6
Costa Rica,Honduras,2,0,UNCAF Cup,2
Dominican Republic,Martinique,1,4,CFU Caribbean Cup,3
Brazil,Bulgaria,3,0,Friendly,3
Costa Rica,El Salvador,7,1,UNCAF Cup,6
Russia,Cyprus,4,0,UEFA Euro qualification,4
Guyana,Trinidad and Tobago,1,3,CFU Caribbean Cup,2
Jamaica,Saint Lucia,2,0,CFU Caribbean Cup,2
Guyana,Saint Lucia,1,4,CFU Caribbean Cup,3
Jamaica,Trinidad and Tobago,2,0,CFU Caribbean Cup,2
Switzerland,San Marino,7,0,UEFA Euro qualification,7
Indonesia,Malta,0,3,Korea Cup,3
New Zealand,England,0,2,Friendly,2
Egypt,Malta,5,2,Korea Cup,3
Ivory Coast,Senegal,2,0,Friendly,2
South Korea,Indonesia,3,0,Korea Cup,3
Egypt,Indonesia,6,0,Korea Cup,6
Denmark,Italy,0,2,Friendly,2
Malaysia,England,2,4,Friendly,2
Sweden,Denmark,4,0,Friendly,4
South Korea,Egypt,2,0,Korea Cup,2
Mozambique,Botswana,2,0,Friendly,2
Faroe Islands,Shetland,3,0,Island Games,3
Jersey,Shetland,2,0,Island Games,2
Åland Islands,Guernsey,2,0,Island Games,2
Ynys Môn,Isle of Wight,5,1,Island Games,4
Faroe Islands,Jersey,5,3,Island Games,2
Shetland,Greenland,5,2,Island Games,3
Canada,Honduras,2,4,Gold Cup,2
Mexico,Jamaica,4,1,Gold Cup,3
Isle of Wight,Greenland,3,1,Island Games,2
Åland Islands,Jersey,0,2,Island Games,2
Costa Rica,Guatemala,2,0,Gold Cup,2
Faroe Islands,Ynys Môn,2,0,Island Games,2
Canada,Mexico,1,3,Gold Cup,2
Chile,Ecuador,3,1,Friendly,2
Jamaica,Honduras,0,5,Gold Cup,5
United States,Guatemala,3,0,Gold Cup,3
Moldova,Georgia,2,4,Friendly,2
Honduras,Costa Rica,2,0,Gold Cup,2
United States,Mexico,2,0,Gold Cup,2
Chile,Venezuela,2,0,Copa América,2
Malawi,Kenya,0,2,Friendly,2
Mexico,Costa Rica,2,0,Gold Cup,2
Argentina,Venezuela,3,0,Copa América,3
Chile,Peru,4,2,Copa América,2
Paraguay,Venezuela,5,0,Copa América,5
Argentina,Paraguay,4,1,Copa América,3
Egypt,Chad,5,1,African Cup of Nations qualification,4
Peru,Venezuela,5,1,Copa América,4
Bolivia,Ecuador,0,4,Copa América,4
Brazil,Colombia,0,2,Copa América,2
Chile,Paraguay,4,0,Copa América,4
Togo,Benin,2,0,African Cup of Nations qualification,2
Brazil,Ecuador,3,1,Copa América,2
Iceland,Turkey,5,1,Friendly,4
Brazil,Colombia,2,0,Copa América,2
Chile,Brazil,0,2,Copa América,2
Nigeria,Burkina Faso,7,1,African Cup of Nations qualification,6
Ivory Coast,Morocco,2,0,African Cup of Nations qualification,2
Sierra Leone,Mali,2,0,African Cup of Nations qualification,2
Benin,Ivory Coast,0,3,Friendly,3
Poland,France,1,5,Friendly,4
Malawi,Mozambique,2,0,Friendly,2
Poland,Sweden,2,0,Friendly,2
Romania,United States,0,2,Friendly,2
Greece,Albania,0,2,Friendly,2
Guam,Tahiti,0,15,South Pacific Games,15
Fiji,New Caledonia,3,1,South Pacific Games,2
Vanuatu,Wallis Islands and Futuna,4,0,South Pacific Games,4
Faroe Islands,Northern Ireland,0,5,UEFA Euro qualification,5
Luxembourg,Belgium,0,2,UEFA Euro qualification,2
Solomon Islands,Wallis Islands and Futuna,5,0,South Pacific Games,5
Fiji,Guam,14,1,South Pacific Games,13
Fiji,Tahiti,3,0,South Pacific Games,3
Solomon Islands,Vanuatu,3,0,South Pacific Games,3
Guam,New Caledonia,0,18,South Pacific Games,18
Papua New Guinea,Wallis Islands and Futuna,5,0,South Pacific Games,5
Fiji,Vanuatu,3,1,South Pacific Games,2
New Caledonia,Solomon Islands,1,4,South Pacific Games,3
Wallis Islands and Futuna,Tahiti,0,5,South Pacific Games,5
Wallis Islands and Futuna,Guam,5,0,South Pacific Games,5
New Caledonia,Vanuatu,3,1,South Pacific Games,2
Mauritius,Tunisia,0,3,Friendly,3
Nigeria,Uganda,8,1,Friendly,7
Mali,Mauritius,5,0,Friendly,5
Faroe Islands,Denmark,0,4,UEFA Euro qualification,4
Iceland,Spain,2,0,UEFA Euro qualification,2
Mauritius,Uganda,3,0,Friendly,3
Tunisia,Zimbabwe,3,1,Friendly,2
Nigeria,Zimbabwe,3,0,Friendly,3
Singapore,Indonesia,2,0,Friendly,2
Austria,Denmark,0,3,UEFA Euro qualification,3
Hungary,Belgium,0,2,Friendly,2
Switzerland,Sweden,3,1,Friendly,2
Bulgaria,San Marino,4,0,UEFA Euro qualification,4
Faroe Islands,Yugoslavia,0,2,UEFA Euro qualification,2
Germany,Wales,4,1,UEFA Euro qualification,3
Brazil,Yugoslavia,3,1,Friendly,2
Greece,Finland,2,0,UEFA Euro qualification,2
Ivory Coast,Nigeria,2,0,Friendly,2
Austria,Yugoslavia,0,2,UEFA Euro qualification,2
Cyprus,Russia,0,3,UEFA Euro qualification,3
Scotland,San Marino,4,0,UEFA Euro qualification,4
Turkey,Republic of Ireland,1,3,UEFA Euro qualification,2
Lithuania,Estonia,4,1,Baltic Cup,3
Estonia,Latvia,0,2,Baltic Cup,2
France,Iceland,3,1,UEFA Euro qualification,2
Ivory Coast,Niger,5,2,Friendly,3
Senegal,Guinea-Bissau,4,0,Amílcar Cabral Cup,4
Malta,Libya,2,0,Friendly,2
Tunisia,Ivory Coast,5,3,Friendly,2
Uganda,Sudan,2,0,CECAFA Cup,2
Guinea,Mali,0,2,Amílcar Cabral Cup,2
Senegal,Gambia,2,0,Amílcar Cabral Cup,2
Uganda,Tanzania,5,0,CECAFA Cup,5
Egypt,Poland,4,0,Friendly,4
Greece,Netherlands,0,2,UEFA Euro qualification,2
Mexico,Hungary,3,0,Friendly,3
Morocco,Mali,3,0,Friendly,3
Uganda,Kenya,1,3,CECAFA Cup,2
Kenya,Zambia,0,2,CECAFA Cup,2
Uganda,Sudan,3,1,CECAFA Cup,2
Kuwait,Poland,0,2,Friendly,2
Algeria,Senegal,3,1,Friendly,2
Germany,Luxembourg,4,0,UEFA Euro qualification,4
Egypt,Romania,3,1,Friendly,2
Italy,Cyprus,2,0,UEFA Euro qualification,2
Malawi,Zambia,0,2,Friendly,2
Egypt,Czechoslovakia,2,0,Friendly,2
DR Congo,Ivory Coast,2,0,Friendly,2
Guyana,Barbados,0,2,Friendly,2
Algeria,Ivory Coast,0,3,African Cup of Nations,3
Senegal,Kenya,3,0,African Cup of Nations,3
El Salvador,Russia,0,3,Friendly,3
Bermuda,Norway,1,3,Friendly,2
Portugal,Netherlands,2,0,Friendly,2
El Salvador,United States,2,0,Friendly,2
England,France,2,0,Friendly,2
Italy,San Marino,4,0,Friendly,4
Brazil,United States,3,0,Friendly,3
Costa Rica,El Salvador,2,0,Friendly,2
Mexico,Russia,4,0,Friendly,4
Spain,United States,2,0,Friendly,2
Morocco,United States,3,1,Friendly,2
Cyprus,Greece,1,3,Friendly,2
Netherlands,Yugoslavia,2,0,Friendly,2
Saint Vincent and the Grenadines,Saint Lucia,3,1,FIFA World Cup qualification,2
Cayman Islands,Martinique,0,7,CFU Caribbean Cup qualification,7
Canada,China PR,5,2,Friendly,3
Sint Maarten,Cayman Islands,4,2,CFU Caribbean Cup qualification,2
United States,China PR,5,0,Friendly,5
Romania,Latvia,2,0,Friendly,2
Austria,Lithuania,4,0,Friendly,4
Antigua and Barbuda,Montserrat,5,0,CFU Caribbean Cup qualification,5
Brazil,Finland,3,1,Friendly,2
Saint Kitts and Nevis,British Virgin Islands,4,0,CFU Caribbean Cup qualification,4
Antigua and Barbuda,British Virgin Islands,2,0,CFU Caribbean Cup qualification,2
Saint Kitts and Nevis,Montserrat,10,0,CFU Caribbean Cup qualification,10
China PR,Indonesia,2,0,AFC Asian Cup qualification,2
Spain,Albania,3,0,FIFA World Cup qualification,3
China PR,Malaysia,4,0,AFC Asian Cup qualification,4
Antigua and Barbuda,Curaçao,3,0,FIFA World Cup qualification,3
Switzerland,Bulgaria,0,2,Friendly,2
Republic of Ireland,United States,4,1,Friendly,3
Ukraine,Hungary,1,3,Friendly,2
Anguilla,Cuba,0,3,CFU Caribbean Cup qualification,3
Romania,Faroe Islands,7,0,FIFA World Cup qualification,7
Sweden,Poland,5,0,Friendly,5
Aruba,French Guiana,0,2,CFU Caribbean Cup qualification,2
Congo,Haiti,4,1,Friendly,3
Cuba,Anguilla,5,0,CFU Caribbean Cup qualification,5
Iran,Pakistan,7,0,AFC Asian Cup qualification,7
Norway,Faroe Islands,2,0,Friendly,2
Finland,Bulgaria,0,3,FIFA World Cup qualification,3
India,Iran,0,3,AFC Asian Cup qualification,3
United Arab Emirates,Syria,2,0,Friendly,2
Austria,Poland,2,4,Friendly,2
Canada,Scotland,1,3,Friendly,2
Romania,Wales,5,1,FIFA World Cup qualification,4
Ethiopia,Sudan,5,1,Friendly,4
Republic of Ireland,Albania,2,0,FIFA World Cup qualification,2
Qatar,Syria,4,2,AFC Asian Cup qualification,2
Netherlands,Wales,4,0,Friendly,4
United States,Republic of Ireland,3,1,USA Cup,2
Qatar,Oman,4,0,AFC Asian Cup qualification,4
Trinidad and Tobago,Barbados,3,0,FIFA World Cup qualification,3
Faroe Islands,Belgium,0,3,FIFA World Cup qualification,3
North Korea,Taiwan,6,0,AFC Asian Cup qualification,6
Republic of Ireland,Italy,0,2,USA Cup,2
North Korea,Macau,2,0,AFC Asian Cup qualification,2
Guatemala,Nicaragua,7,1,Friendly,6
Republic of Ireland,Portugal,2,0,USA Cup,2
Macau,Taiwan,2,0,AFC Asian Cup qualification,2
New Zealand,Fiji,3,0,FIFA World Cup qualification,3
Canada,Hong Kong,3,1,Friendly,2
Antigua and Barbuda,Bermuda,0,3,FIFA World Cup qualification,3
Guinea-Bissau,Cape Verde,3,1,African Cup of Nations qualification,2
Scotland,Germany,0,2,UEFA Euro,2
Faroe Islands,Cyprus,0,2,FIFA World Cup qualification,2
Argentina,Australia,2,0,Friendly,2
Netherlands,Germany,3,1,UEFA Euro,2
Scotland,Russia,3,0,UEFA Euro,3
South Korea,Bangladesh,6,0,AFC Asian Cup qualification,6
Mozambique,Eswatini,4,1,Friendly,3
Antigua and Barbuda,Martinique,1,4,CFU Caribbean Cup,3
Uruguay,Australia,2,0,Friendly,2
Denmark,Germany,2,0,UEFA Euro,2
Trinidad and Tobago,Jamaica,3,1,CFU Caribbean Cup,2
Vanuatu,New Zealand,1,4,FIFA World Cup qualification,3
Botswana,Lesotho,0,4,African Cup of Nations qualification,4
Honduras,Panama,4,0,Friendly,4
Honduras,Panama,4,0,Friendly,4
New Zealand,Vanuatu,8,0,FIFA World Cup qualification,8
Uruguay,Ecuador,3,1,Friendly,2
Australia,Croatia,3,1,Friendly,2
Nicaragua,El Salvador,0,5,FIFA World Cup qualification,5
El Salvador,Nicaragua,5,1,FIFA World Cup qualification,4
Honduras,Guatemala,2,0,FIFA World Cup qualification,2
Ivory Coast,Egypt,2,0,Friendly,2
Vanuatu,Solomon Islands,1,3,Friendly,2
Vanuatu,Fiji,0,2,Friendly,2
Brazil,Mexico,5,0,Friendly,5
Lesotho,Namibia,2,0,Friendly,2
Iceland,Israel,0,2,Friendly,2
El Salvador,Honduras,0,3,Friendly,3
Algeria,Guinea-Bissau,3,1,African Cup of Nations qualification,2
Indonesia,Australia,0,3,Friendly,3
Uganda,Ethiopia,3,1,African Cup of Nations qualification,2
Zambia,Mauritius,3,1,African Cup of Nations qualification,2
DR Congo,Mozambique,2,0,African Cup of Nations qualification,2
Estonia,Switzerland,0,6,FIFA World Cup qualification,6
Zimbabwe,South Africa,4,1,African Cup of Nations qualification,3
Ethiopia,Iraq,0,13,Jordan International Tournament,13
Jordan,Sudan,3,0,Jordan International Tournament,3
Moldova,Pakistan,5,0,Jordan International Tournament,5
Congo,Iraq,0,3,Jordan International Tournament,3
Jordan,Pakistan,2,0,Jordan International Tournament,2
Congo,Ethiopia,3,0,Jordan International Tournament,3
Pakistan,Sudan,0,4,Jordan International Tournament,4
Costa Rica,Panama,5,1,FIFA World Cup qualification,4
Uzbekistan,Kyrgyzstan,3,0,Friendly,3
China PR,Japan,0,2,Dynasty Cup,2
China PR,South Korea,0,2,Dynasty Cup,2
France,Brazil,0,2,Friendly,2
Japan,North Korea,4,1,Dynasty Cup,3
Romania,Mexico,2,0,Friendly,2
Congo,Moldova,1,3,Jordan International Tournament,2
Jordan,Iraq,2,0,Jordan International Tournament,2
Kenya,DR Congo,1,3,African Cup of Nations qualification,2
Nigeria,Uganda,2,0,African Cup of Nations qualification,2
Cameroon,Benin,2,0,African Cup of Nations qualification,2
Ethiopia,Sudan,3,0,African Cup of Nations qualification,3
Mozambique,Lesotho,3,0,African Cup of Nations qualification,3
Niger,Gabon,1,3,African Cup of Nations qualification,2
Senegal,Guinea-Bissau,3,0,African Cup of Nations qualification,3
Canada,United States,0,2,Friendly,2
Bulgaria,France,2,0,FIFA World Cup qualification,2
Republic of Ireland,Latvia,4,0,FIFA World Cup qualification,4
Luxembourg,Hungary,0,3,FIFA World Cup qualification,3
Northern Ireland,Albania,3,0,FIFA World Cup qualification,3
Norway,San Marino,10,0,FIFA World Cup qualification,10
Switzerland,Scotland,3,1,FIFA World Cup qualification,2
Wales,Faroe Islands,6,0,FIFA World Cup qualification,6
Kuwait,Jordan,4,1,Arab Cup,3
Tahiti,Australia,0,3,FIFA World Cup qualification,3
Fiji,Vanuatu,3,0,FIFA World Cup qualification,3
El Salvador,Honduras,3,1,Friendly,2
Saudi Arabia,Kuwait,2,0,Arab Cup,2
Georgia,Azerbaijan,6,3,Friendly,3
Australia,Tahiti,2,0,FIFA World Cup qualification,2
Honduras,Jamaica,5,1,Friendly,4
Brazil,Costa Rica,4,2,Friendly,2
Czechoslovakia,Faroe Islands,4,0,FIFA World Cup qualification,4
Honduras,Jamaica,7,0,Friendly,7
Australia,Solomon Islands,6,1,FIFA World Cup qualification,5
Vanuatu,Fiji,0,3,FIFA World Cup qualification,3
Botswana,Kenya,1,3,Friendly,2
Kyrgyzstan,Uzbekistan,2,6,Friendly,4
Guinea-Bissau,Sierra Leone,0,3,African Cup of Nations qualification,3
Cyprus,Malta,3,0,Friendly,3
El Salvador,Mexico,0,2,Friendly,2
San Marino,Norway,0,2,FIFA World Cup qualification,2
Sweden,Bulgaria,2,0,FIFA World Cup qualification,2
Algeria,Burundi,3,1,FIFA World Cup qualification,2
Tahiti,Solomon Islands,4,2,FIFA World Cup qualification,2
Nigeria,South Africa,4,0,FIFA World Cup qualification,4
Ivory Coast,Botswana,6,0,FIFA World Cup qualification,6
DR Congo,Liberia,4,2,FIFA World Cup qualification,2
Gabon,Mozambique,3,1,FIFA World Cup qualification,2
Madagascar,Namibia,3,0,FIFA World Cup qualification,3
Morocco,Ethiopia,5,0,FIFA World Cup qualification,5
Qatar,Hungary,1,4,Friendly,3
Tunisia,Benin,5,1,FIFA World Cup qualification,4
Zambia,Tanzania,2,0,FIFA World Cup qualification,2
France,Austria,2,0,FIFA World Cup qualification,2
Turkmenistan,Kyrgyzstan,4,0,Friendly,4
Saudi Arabia,United States,3,0,Confederations Cup,3
Argentina,Ivory Coast,4,0,Confederations Cup,4
Cameroon,Eswatini,5,0,FIFA World Cup qualification,5
Niger,Mali,0,2,Friendly,2
United States,Ivory Coast,5,2,Confederations Cup,3
Saudi Arabia,Argentina,1,3,Confederations Cup,2
Croatia,Mexico,3,0,Friendly,3
Kuwait,Oman,4,0,Friendly,4
Kazakhstan,Kyrgyzstan,2,0,Friendly,2
Namibia,Zambia,0,4,FIFA World Cup qualification,4
Togo,Egypt,1,4,FIFA World Cup qualification,3
Austria,Israel,5,2,FIFA World Cup qualification,3
Russia,Luxembourg,2,0,FIFA World Cup qualification,2
Turkey,San Marino,4,1,FIFA World Cup qualification,3
North Korea,Iran,0,2,AFC Asian Cup,2
El Salvador,Bermuda,4,1,FIFA World Cup qualification,3
Saudi Arabia,Thailand,4,0,AFC Asian Cup,4
Saudi Arabia,United Arab Emirates,2,0,AFC Asian Cup,2
Saint Vincent and the Grenadines,Mexico,0,4,FIFA World Cup qualification,4
Sierra Leone,Senegal,2,0,African Cup of Nations qualification,2
Zimbabwe,Malawi,4,1,Friendly,3
Israel,Sweden,1,3,FIFA World Cup qualification,2
Canada,Bermuda,4,2,FIFA World Cup qualification,2
Ethiopia,Zanzibar,3,0,CECAFA Cup,3
Mexico,Honduras,2,0,FIFA World Cup qualification,2
Belgium,Wales,2,0,FIFA World Cup qualification,2
England,Turkey,4,0,FIFA World Cup qualification,4
Switzerland,Malta,3,0,FIFA World Cup qualification,3
Seychelles,Uganda,2,5,CECAFA Cup,3
Zambia,Zanzibar,8,0,CECAFA Cup,8
Saint Vincent and the Grenadines,Honduras,0,4,FIFA World Cup qualification,4
Jamaica,El Salvador,0,2,FIFA World Cup qualification,2
Mexico,Costa Rica,4,0,FIFA World Cup qualification,4
Malawi,Zanzibar,3,1,CECAFA Cup,2
Argentina,Poland,2,0,Friendly,2
Qatar,Oman,2,0,Gulf Cup,2
Honduras,Saint Vincent and the Grenadines,4,0,FIFA World Cup qualification,4
Malawi,Zambia,0,4,CECAFA Cup,4
United Arab Emirates,Kuwait,0,2,Gulf Cup,2
Costa Rica,Mexico,2,0,FIFA World Cup qualification,2
Cyprus,Romania,1,4,FIFA World Cup qualification,3
Israel,Bulgaria,0,2,FIFA World Cup qualification,2
Qatar,Kuwait,4,0,Gulf Cup,4
Bahrain,United Arab Emirates,0,2,Gulf Cup,2
Oman,Saudi Arabia,0,2,Gulf Cup,2
Mexico,Saint Vincent and the Grenadines,11,0,FIFA World Cup qualification,11
Bahrain,Oman,3,0,Gulf Cup,3
Singapore,Malaysia,3,0,Merlion Cup,3
Costa Rica,Saint Vincent and the Grenadines,5,0,FIFA World Cup qualification,5
Brazil,Germany,3,1,Friendly,2
Spain,Latvia,5,0,FIFA World Cup qualification,5
Turkey,Netherlands,1,3,FIFA World Cup qualification,2
Tanzania,Namibia,2,0,FIFA World Cup qualification,2
Ethiopia,Benin,3,1,FIFA World Cup qualification,2
Ghana,Algeria,2,0,FIFA World Cup qualification,2
Guinea,Kenya,4,0,FIFA World Cup qualification,4
Madagascar,Zambia,2,0,FIFA World Cup qualification,2
Uruguay,Germany,1,4,Friendly,3
Burkina Faso,Mali,3,1,Friendly,2
Kuwait,Lebanon,2,0,Friendly,2
Uganda,Tanzania,3,1,Friendly,2
Botswana,South Africa,0,2,Friendly,2
Tunisia,Bulgaria,3,0,Friendly,3
Uganda,Tanzania,2,0,Friendly,2
Tanzania,Zambia,1,3,FIFA World Cup qualification,2
Benin,Tunisia,0,5,FIFA World Cup qualification,5
Italy,Mexico,2,0,Friendly,2
Zambia,Namibia,4,0,FIFA World Cup qualification,4
Ghana,Niger,4,0,Friendly,4
Guinea-Bissau,Algeria,1,4,African Cup of Nations qualification,3
India,Finland,0,2,Nehru Cup,2
Cameroon,Finland,2,0,Nehru Cup,2
Bolivia,Honduras,3,1,Friendly,2
Senegal,Mozambique,6,1,FIFA World Cup qualification,5
Ecuador,Romania,3,0,Friendly,3
Egypt,Togo,3,0,FIFA World Cup qualification,3
Morocco,Benin,5,0,FIFA World Cup qualification,5
Tunisia,Ethiopia,3,0,FIFA World Cup qualification,3
Peru,Romania,0,2,Friendly,2
Ghana,Indonesia,2,0,Merdeka Tournament,2
Mexico,Romania,0,2,Friendly,2
Cyprus,Belgium,0,3,FIFA World Cup qualification,3
Costa Rica,Nicaragua,6,0,UNCAF Cup,6
Thailand,China PR,0,4,King's Cup,4
England,San Marino,6,0,FIFA World Cup qualification,6
Greece,Luxembourg,2,0,FIFA World Cup qualification,2
Israel,France,0,4,FIFA World Cup qualification,4
Scotland,Malta,3,0,FIFA World Cup qualification,3
Costa Rica,Nicaragua,2,0,UNCAF Cup,2
United Arab Emirates,Bulgaria,1,3,Friendly,2
Estonia,Latvia,0,2,Friendly,2
Finland,Lithuania,3,0,Friendly,3
Netherlands,Turkey,3,1,FIFA World Cup qualification,2
Portugal,Italy,1,3,FIFA World Cup qualification,2
Spain,Lithuania,5,0,FIFA World Cup qualification,5
Kenya,Guinea,2,0,FIFA World Cup qualification,2
Nigeria,Congo,2,0,FIFA World Cup qualification,2
Zambia,Madagascar,3,1,FIFA World Cup qualification,2
Honduras,Panama,2,0,UNCAF Cup,2
Honduras,Costa Rica,2,0,UNCAF Cup,2
Canada,South Korea,0,2,Friendly,2
Costa Rica,Panama,2,0,UNCAF Cup,2
Honduras,El Salvador,3,0,UNCAF Cup,3
Canada,South Korea,2,0,Friendly,2
Cayman Islands,Barbados,1,6,CFU Caribbean Cup qualification,5
Guyana,Puerto Rico,0,2,CFU Caribbean Cup qualification,2
Guyana,Barbados,0,3,CFU Caribbean Cup qualification,3
Japan,United States,3,1,Kirin Cup,2
Puerto Rico,Cayman Islands,4,0,CFU Caribbean Cup qualification,4
Italy,Malta,6,1,FIFA World Cup qualification,5
Netherlands,San Marino,6,0,FIFA World Cup qualification,6
Honduras,United States,4,1,Friendly,3
Qatar,Norway,1,6,Friendly,5
Colombia,Costa Rica,4,1,Friendly,3
Republic of Ireland,Northern Ireland,3,0,FIFA World Cup qualification,3
Turkey,England,0,2,FIFA World Cup qualification,2
Wales,Belgium,2,0,FIFA World Cup qualification,2
Saint Kitts and Nevis,British Virgin Islands,5,1,CFU Caribbean Cup qualification,4
Anguilla,Antigua and Barbuda,0,4,CFU Caribbean Cup qualification,4
Dominican Republic,British Virgin Islands,3,1,CFU Caribbean Cup qualification,2
Kuwait,Egypt,1,3,Friendly,2
Antigua and Barbuda,Sint Maarten,0,2,CFU Caribbean Cup qualification,2
Slovenia,Estonia,2,0,Friendly,2
Sri Lanka,United Arab Emirates,0,4,FIFA World Cup qualification,4
North Korea,Vietnam,3,0,FIFA World Cup qualification,3
Qatar,Indonesia,3,1,FIFA World Cup qualification,2
Canada,El Salvador,2,0,FIFA World Cup qualification,2
Gabon,Benin,2,0,African Cup of Nations qualification,2
Guinea-Bissau,Senegal,0,3,African Cup of Nations qualification,3
Japan,Bangladesh,8,0,FIFA World Cup qualification,8
Mexico,Honduras,3,0,FIFA World Cup qualification,3
Qatar,Vietnam,4,0,FIFA World Cup qualification,4
North Korea,Indonesia,4,0,FIFA World Cup qualification,4
Austria,Bulgaria,3,1,FIFA World Cup qualification,2
Denmark,Latvia,2,0,FIFA World Cup qualification,2
Germany,Ghana,6,1,Friendly,5
Guadeloupe,Martinique,1,4,CFU Caribbean Cup qualification,3
Italy,Estonia,2,0,FIFA World Cup qualification,2
Lithuania,Albania,3,1,FIFA World Cup qualification,2
Luxembourg,Russia,0,4,FIFA World Cup qualification,4
Hungary,Sweden,0,2,Friendly,2
Japan,Sri Lanka,5,0,FIFA World Cup qualification,5
Qatar,Singapore,4,1,FIFA World Cup qualification,3
Malta,Switzerland,0,2,FIFA World Cup qualification,2
Cameroon,Guinea,3,1,FIFA World Cup qualification,2
Canada,Honduras,3,1,FIFA World Cup qualification,2
Indonesia,Singapore,0,2,FIFA World Cup qualification,2
Japan,United Arab Emirates,2,0,FIFA World Cup qualification,2
Mexico,El Salvador,3,1,FIFA World Cup qualification,2
Saudi Arabia,New Zealand,3,1,Friendly,2
Thailand,Bangladesh,4,1,FIFA World Cup qualification,3
Australia,Kuwait,1,3,Friendly,2
Singapore,Saudi Arabia,0,3,Friendly,3
Nigeria,Sudan,4,0,African Cup of Nations qualification,4
Egypt,Malawi,2,0,African Cup of Nations qualification,2
Indonesia,Qatar,1,4,FIFA World Cup qualification,3
Kenya,Lesotho,3,0,African Cup of Nations qualification,3
Sierra Leone,Guinea-Bissau,2,0,African Cup of Nations qualification,2
Cyprus,Faroe Islands,3,1,FIFA World Cup qualification,2
Honduras,El Salvador,2,0,FIFA World Cup qualification,2
Mauritius,Zambia,0,3,African Cup of Nations qualification,3
Mexico,Canada,4,0,FIFA World Cup qualification,4
Niger,Benin,4,1,African Cup of Nations qualification,3
Singapore,North Korea,1,3,FIFA World Cup qualification,2
Vietnam,Qatar,0,4,FIFA World Cup qualification,4
Dominica,Saint Lucia,2,4,CFU Caribbean Cup qualification,2
Bulgaria,Finland,2,0,FIFA World Cup qualification,2
Norway,Turkey,3,1,FIFA World Cup qualification,2
Portugal,Scotland,5,0,FIFA World Cup qualification,5
Russia,Hungary,3,0,FIFA World Cup qualification,3
Spain,Northern Ireland,3,1,FIFA World Cup qualification,2
United Arab Emirates,Sri Lanka,3,0,FIFA World Cup qualification,3
Dominica,Saint Vincent and the Grenadines,0,2,CFU Caribbean Cup qualification,2
Bangladesh,Japan,1,4,FIFA World Cup qualification,3
Macau,Saudi Arabia,0,6,FIFA World Cup qualification,6
Guinea,Zimbabwe,3,0,FIFA World Cup qualification,3
Honduras,Mexico,1,4,FIFA World Cup qualification,3
Macau,Kuwait,1,10,FIFA World Cup qualification,9
Sri Lanka,Thailand,0,3,FIFA World Cup qualification,3
United Arab Emirates,Bangladesh,7,0,FIFA World Cup qualification,7
Bangladesh,Thailand,1,4,FIFA World Cup qualification,3
Malaysia,Macau,9,0,FIFA World Cup qualification,9
Sri Lanka,Japan,0,6,FIFA World Cup qualification,6
Bangladesh,Sri Lanka,3,0,FIFA World Cup qualification,3
Finland,Austria,3,1,FIFA World Cup qualification,2
India,South Korea,0,3,FIFA World Cup qualification,3
Kuwait,Malaysia,2,0,FIFA World Cup qualification,2
Saudi Arabia,Macau,8,0,FIFA World Cup qualification,8
Hong Kong,South Korea,0,3,FIFA World Cup qualification,3
Kuwait,Macau,8,0,FIFA World Cup qualification,8
Saudi Arabia,Malaysia,3,0,FIFA World Cup qualification,3
Macau,Malaysia,0,5,FIFA World Cup qualification,5
Saudi Arabia,Kuwait,2,0,FIFA World Cup qualification,2
Estonia,Scotland,0,3,FIFA World Cup qualification,3
San Marino,Poland,0,3,FIFA World Cup qualification,3
Guadeloupe,Réunion,0,3,Friendly,3
Jamaica,Saint Kitts and Nevis,4,1,CFU Caribbean Cup,3
Martinique,Saint Lucia,2,0,CFU Caribbean Cup,2
Puerto Rico,Sint Maarten,3,0,CFU Caribbean Cup,3
Belgium,Faroe Islands,3,0,FIFA World Cup qualification,3
Burkina Faso,Guadeloupe,2,0,Friendly,2
New Zealand,Fiji,2,0,Friendly,2
Pakistan,China PR,0,5,FIFA World Cup qualification,5
Jamaica,Sint Maarten,2,0,CFU Caribbean Cup,2
New Zealand,Fiji,5,0,Friendly,5
Yemen,Pakistan,5,1,FIFA World Cup qualification,4
Zambia,Malawi,4,2,Friendly,2
Saint Vincent and the Grenadines,Saint Lucia,4,1,CFU Caribbean Cup,3
Jordan,China PR,0,3,FIFA World Cup qualification,3
Yemen,Iraq,1,6,FIFA World Cup qualification,5
Jamaica,Trinidad and Tobago,3,0,CFU Caribbean Cup,3
Pakistan,Iraq,0,8,FIFA World Cup qualification,8
Republic of Ireland,Hungary,2,4,Friendly,2
Jordan,Pakistan,3,1,FIFA World Cup qualification,2
Czech Republic,Romania,5,2,FIFA World Cup qualification,3
Denmark,Albania,4,0,FIFA World Cup qualification,4
Lithuania,Spain,0,2,FIFA World Cup qualification,2
Norway,England,2,0,FIFA World Cup qualification,2
Scotland,Estonia,3,1,FIFA World Cup qualification,2
Sweden,Israel,5,0,FIFA World Cup qualification,5
Turkmenistan,Tajikistan,6,0,Friendly,6
South Korea,Hong Kong,4,1,FIFA World Cup qualification,3
Australia,New Zealand,3,0,FIFA World Cup qualification,3
Azerbaijan,Tajikistan,2,0,Friendly,2
Faroe Islands,Wales,0,3,FIFA World Cup qualification,3
Iran,Pakistan,5,0,Friendly,5
United States,Brazil,0,2,USA Cup,2
India,Bahrain,0,3,FIFA World Cup qualification,3
South Korea,Lebanon,2,0,FIFA World Cup qualification,2
Pakistan,Turkmenistan,0,4,Friendly,4
South Korea,India,7,0,FIFA World Cup qualification,7
Latvia,Republic of Ireland,0,2,FIFA World Cup qualification,2
United States,England,2,0,USA Cup,2
Mexico,Paraguay,3,1,Friendly,2
Bahrain,Hong Kong,3,0,FIFA World Cup qualification,3
Peru,Venezuela,3,1,Friendly,2
China PR,Pakistan,3,0,FIFA World Cup qualification,3
Bolivia,Chile,1,3,Friendly,2
Hong Kong,India,1,3,FIFA World Cup qualification,2
South Korea,Bahrain,3,0,FIFA World Cup qualification,3
Iraq,Jordan,4,0,FIFA World Cup qualification,4
Pakistan,Yemen,0,3,FIFA World Cup qualification,3
Ecuador,Venezuela,6,1,Copa América,5
China PR,Jordan,4,1,FIFA World Cup qualification,3
Faroe Islands,Czech Republic,0,3,FIFA World Cup qualification,3
Iceland,Hungary,2,0,FIFA World Cup qualification,2
Iraq,Yemen,3,0,FIFA World Cup qualification,3
Iraq,Pakistan,4,0,FIFA World Cup qualification,4
Ecuador,United States,2,0,Copa América,2
Portugal,Malta,4,0,FIFA World Cup qualification,4
Mali,Senegal,0,2,Friendly,2
Pakistan,Jordan,0,5,FIFA World Cup qualification,5
Taiwan,Syria,0,2,FIFA World Cup qualification,2
Costa Rica,Panama,3,1,Friendly,2
Brazil,Paraguay,3,0,Copa América,3
Croatia,Ukraine,3,1,Friendly,2
Iran,Taiwan,6,0,FIFA World Cup qualification,6
Ecuador,Paraguay,3,0,Copa América,3
Peru,Mexico,2,4,Copa América,2
Costa Rica,Mexico,0,2,Friendly,2
Ecuador,Mexico,0,2,Copa América,2
Estonia,Latvia,0,2,Baltic Cup,2
Syria,Taiwan,8,1,FIFA World Cup qualification,7
Nigeria,Algeria,4,1,FIFA World Cup qualification,3
Taiwan,Iran,0,6,FIFA World Cup qualification,6
Gabon,Mali,0,2,Friendly,2
Åland Islands,Shetland,3,1,Island Games,2
Jersey,Greenland,4,2,Island Games,2
Isle of Man,Åland Islands,2,0,Island Games,2
Isle of Wight,Shetland,2,0,Island Games,2
Malawi,Eswatini,3,1,Friendly,2
Greenland,Gibraltar,5,0,Island Games,5
Shetland,Isle of Man,1,5,Island Games,4
Isle of Wight,Åland Islands,0,2,Island Games,2
Taiwan,Oman,1,7,FIFA World Cup qualification,6
Jersey,Isle of Man,5,1,Island Games,4
Honduras,Panama,5,1,Gold Cup,4
Benin,Cameroon,0,3,African Cup of Nations qualification,3
Gabon,Niger,3,0,African Cup of Nations qualification,3
Mexico,Martinique,9,0,Gold Cup,9
Zambia,South Africa,3,0,African Cup of Nations qualification,3
Zimbabwe,Mauritius,2,0,African Cup of Nations qualification,2
Brazil,Paraguay,2,0,Friendly,2
Honduras,Jamaica,1,3,Gold Cup,2
Senegal,Morocco,1,3,FIFA World Cup qualification,2
Uruguay,Peru,3,0,Friendly,3
Costa Rica,Martinique,3,1,Gold Cup,2
Mexico,Canada,8,0,Gold Cup,8
Venezuela,Bolivia,1,7,FIFA World Cup qualification,6
Mexico,Jamaica,6,1,Gold Cup,5
Nigeria,Ethiopia,6,0,African Cup of Nations qualification,6
Kenya,Mozambique,4,1,African Cup of Nations qualification,3
Algeria,Senegal,4,0,African Cup of Nations qualification,4
Bolivia,Brazil,2,0,FIFA World Cup qualification,2
Cameroon,Niger,2,0,African Cup of Nations qualification,2
DR Congo,Lesotho,7,0,African Cup of Nations qualification,7
Liberia,Ghana,0,2,African Cup of Nations qualification,2
Malawi,Morocco,0,2,African Cup of Nations qualification,2
Mauritius,South Africa,1,3,African Cup of Nations qualification,2
Mexico,United States,4,0,Gold Cup,4
France,Russia,3,1,Friendly,2
Malawi,Eswatini,3,0,Friendly,3
Venezuela,Brazil,1,5,FIFA World Cup qualification,4
Bolivia,Uruguay,3,1,FIFA World Cup qualification,2
Ecuador,Venezuela,5,0,FIFA World Cup qualification,5
Paraguay,Argentina,1,3,FIFA World Cup qualification,2
Zimbabwe,Eswatini,2,0,Friendly,2
Guinea,Sierra Leone,4,0,Friendly,4
Faroe Islands,Norway,0,7,Friendly,7
Bolivia,Venezuela,7,0,FIFA World Cup qualification,7
Brazil,Ecuador,2,0,FIFA World Cup qualification,2
Austria,Finland,3,0,FIFA World Cup qualification,3
Denmark,Lithuania,4,0,FIFA World Cup qualification,4
Brazil,Bolivia,6,0,FIFA World Cup qualification,6
Colombia,Peru,4,0,FIFA World Cup qualification,4
Uruguay,Venezuela,4,0,FIFA World Cup qualification,4
Argentina,Colombia,0,5,FIFA World Cup qualification,5
Brazil,Venezuela,4,0,FIFA World Cup qualification,4
Estonia,Portugal,0,2,FIFA World Cup qualification,2
England,Poland,3,0,FIFA World Cup qualification,3
Faroe Islands,Romania,0,4,FIFA World Cup qualification,4
Finland,France,0,2,FIFA World Cup qualification,2
Hungary,Russia,1,3,FIFA World Cup qualification,2
Republic of Ireland,Lithuania,2,0,FIFA World Cup qualification,2
Northern Ireland,Latvia,2,0,FIFA World Cup qualification,2
Spain,Chile,2,0,Friendly,2
Morocco,Mali,3,0,Friendly,3
Saudi Arabia,Thailand,4,0,Friendly,4
Brazil,Uruguay,2,0,FIFA World Cup qualification,2
Zimbabwe,Senegal,2,0,Friendly,2
Saudi Arabia,Thailand,3,0,Friendly,3
Albania,Spain,1,5,FIFA World Cup qualification,4
Estonia,Italy,0,3,FIFA World Cup qualification,3
San Marino,Netherlands,0,7,FIFA World Cup qualification,7
Nigeria,Ivory Coast,4,1,FIFA World Cup qualification,3
Zambia,Senegal,4,0,FIFA World Cup qualification,4
Mexico,South Africa,4,0,Friendly,4
Saudi Arabia,Russia,4,2,Friendly,2
Cameroon,Zimbabwe,3,1,FIFA World Cup qualification,2
Luxembourg,Greece,1,3,FIFA World Cup qualification,2
Bulgaria,Austria,4,1,FIFA World Cup qualification,3
Germany,Uruguay,5,0,Friendly,5
Republic of Ireland,Spain,1,3,FIFA World Cup qualification,2
Italy,Scotland,3,1,FIFA World Cup qualification,2
Netherlands,England,2,0,FIFA World Cup qualification,2
Poland,Norway,0,3,FIFA World Cup qualification,3
Slovenia,North Macedonia,1,4,Friendly,3
Wales,Cyprus,2,0,FIFA World Cup qualification,2
Iran,South Korea,0,3,FIFA World Cup qualification,3
Tunisia,Iceland,3,1,Friendly,2
North Korea,Japan,0,3,FIFA World Cup qualification,3
Liechtenstein,Estonia,0,2,Friendly,2
Czech Republic,Cyprus,3,0,FIFA World Cup qualification,3
South Korea,North Korea,3,0,FIFA World Cup qualification,3
United Arab Emirates,Jordan,0,2,Friendly,2
Mexico,China PR,3,0,Friendly,3
Egypt,Malta,3,0,Friendly,3
Tunisia,Gabon,4,0,Friendly,4
Israel,Finland,1,3,FIFA World Cup qualification,2
Portugal,Estonia,3,0,FIFA World Cup qualification,3
Antigua and Barbuda,Saint Kitts and Nevis,3,0,Friendly,3
United States,Cayman Islands,8,1,Friendly,7
Slovakia,Slovenia,2,0,Friendly,2
Malta,Scotland,0,2,FIFA World Cup qualification,2
Poland,Netherlands,1,3,FIFA World Cup qualification,2
San Marino,England,1,7,FIFA World Cup qualification,6
Switzerland,Estonia,4,0,FIFA World Cup qualification,4
Gambia,Mauritania,2,4,Friendly,2
Gambia,Ghana,3,0,Friendly,3
Mali,Guinea-Bissau,3,0,Amílcar Cabral Cup,3
Senegal,Mauritania,4,0,Amílcar Cabral Cup,4
Tahiti,Fiji,3,0,Friendly,3
Gambia,Senegal,0,2,Amílcar Cabral Cup,2
Sierra Leone,Mali,2,0,Amílcar Cabral Cup,2
Gambia,Mali,2,0,Amílcar Cabral Cup,2
Sierra Leone,Senegal,2,0,Amílcar Cabral Cup,2
United States,El Salvador,7,0,Friendly,7
Bangladesh,Myanmar,3,1,Friendly,2
United States,Germany,0,3,Friendly,3
Basque Country,Bolivia,3,1,Friendly,2
Mauritania,Mali,1,3,Friendly,2
Guinea,Ivory Coast,3,0,Friendly,3
Suriname,Guyana,2,0,CFU Caribbean Cup qualification,2
Mexico,Switzerland,1,5,Friendly,4
Ivory Coast,Niger,5,3,Friendly,2
Guinea,Niger,1,3,Friendly,2
Oman,Finland,0,2,Friendly,2
Mexico,Russia,1,4,Friendly,3
Oman,Kenya,2,0,Friendly,2
Georgia,Tunisia,2,0,Malta International Tournament,2
Malawi,Zambia,0,3,Friendly,3
Malawi,Zambia,0,2,Friendly,2
Bolivia,Colombia,0,2,Friendly,2
United States,Sweden,1,3,Friendly,2
Israel,Georgia,2,0,Friendly,2
Saint Kitts and Nevis,Montserrat,9,1,CFU Caribbean Cup qualification,8
Turkey,Czech Republic,1,4,Friendly,3
Antigua and Barbuda,Montserrat,8,0,CFU Caribbean Cup qualification,8
Cayman Islands,British Virgin Islands,5,0,CFU Caribbean Cup qualification,5
Cayman Islands,Sint Maarten,5,0,CFU Caribbean Cup qualification,5
Guadeloupe,Anguilla,9,0,CFU Caribbean Cup qualification,9
Jamaica,British Virgin Islands,12,0,CFU Caribbean Cup qualification,12
Sint Maarten,British Virgin Islands,3,0,CFU Caribbean Cup qualification,3
Saint Vincent and the Grenadines,Anguilla,2,0,CFU Caribbean Cup qualification,2
Cyprus,Estonia,2,0,Friendly,2
Wales,Norway,1,3,Friendly,2
Tunisia,Niger,4,2,Friendly,2
France,Chile,3,1,Friendly,2
Brazil,Argentina,2,0,Friendly,2
North Macedonia,Slovenia,2,0,Friendly,2
Northern Ireland,Romania,2,0,Friendly,2
Spain,Croatia,0,2,Friendly,2
Nigeria,Gabon,3,0,African Cup of Nations,3
Saudi Arabia,Chile,0,2,Friendly,2
Tunisia,Mali,0,2,African Cup of Nations,2
Ivory Coast,Sierra Leone,4,0,African Cup of Nations,4
Egypt,Gabon,4,0,African Cup of Nations,4
DR Congo,Nigeria,0,2,African Cup of Nations,2
Zambia,Mali,4,0,African Cup of Nations,4
Martinique,Suriname,2,0,CFU Caribbean Cup,2
Martinique,Haiti,3,0,CFU Caribbean Cup,3
Suriname,Cayman Islands,2,0,CFU Caribbean Cup,2
Ivory Coast,Mali,3,1,African Cup of Nations,2
Uzbekistan,Turkmenistan,4,0,Friendly,4
Kyrgyzstan,Turkmenistan,1,5,Friendly,4
Martinique,Guadeloupe,4,2,CFU Caribbean Cup,2
Guadeloupe,Suriname,2,0,CFU Caribbean Cup,2
Trinidad and Tobago,Martinique,7,2,CFU Caribbean Cup,5
Tunisia,Saudi Arabia,2,0,Friendly,2
Malta,Azerbaijan,5,0,Friendly,5
Tajikistan,Turkmenistan,0,2,Friendly,2
Uzbekistan,Kyrgyzstan,3,0,Friendly,3
Argentina,Morocco,3,1,Friendly,2
Denmark,Hungary,3,1,Friendly,2
Iceland,Saudi Arabia,0,2,Friendly,2
Northern Ireland,Liechtenstein,4,1,UEFA Euro qualification,3
Romania,Bolivia,3,0,Friendly,3
Slovakia,Croatia,4,1,Friendly,3
Switzerland,Czech Republic,3,0,Friendly,3
United States,Moldova,3,0,Friendly,3
Wales,Sweden,0,2,Friendly,2
Greece,Saudi Arabia,5,1,Friendly,4
Slovenia,Cyprus,3,0,Friendly,3
United Arab Emirates,Germany,0,2,Friendly,2
United States,Chile,0,2,Friendly,2
Jersey,Guernsey,3,1,Friendly,2
El Salvador,Honduras,3,1,Friendly,2
Brazil,Iceland,3,0,Friendly,3
Colombia,El Salvador,3,0,Friendly,3
Sweden,Nigeria,3,1,Friendly,2
United States,Estonia,4,0,Friendly,4
Greece,Cameroon,0,3,Friendly,3
North Macedonia,Albania,5,1,Friendly,4
England,Greece,5,0,Friendly,5
Czech Republic,Lithuania,5,3,Friendly,2
Fiji,Tahiti,2,0,Friendly,2
Ukraine,Belarus,3,1,Friendly,2
Italy,Finland,2,0,Friendly,2
Netherlands,Scotland,3,1,Friendly,2
Switzerland,Liechtenstein,2,0,Friendly,2
Germany,Republic of Ireland,0,2,Friendly,2
Japan,France,1,4,Kirin Cup,3
Israel,Argentina,0,3,Friendly,3
North Macedonia,Estonia,2,0,Friendly,2
Netherlands,Hungary,7,1,Friendly,6
Austria,Germany,1,5,Friendly,4
Latvia,Malta,2,0,Friendly,2
Colombia,Northern Ireland,2,0,Friendly,2
Colombia,Greece,2,0,Friendly,2
Republic of Ireland,Czech Republic,1,3,Friendly,2
Ivory Coast,Liberia,4,1,Friendly,3
Sweden,Norway,2,0,Friendly,2
Belgium,Hungary,3,1,Friendly,2
Canada,Germany,0,2,Friendly,2
Honduras,Brazil,2,8,Friendly,6
Canada,Spain,0,2,Friendly,2
Honduras,South Korea,0,3,Friendly,3
Mexico,Northern Ireland,3,0,Friendly,3
Nigeria,Georgia,5,1,Friendly,4
Canada,Netherlands,0,3,Friendly,3
El Salvador,Brazil,0,4,Friendly,4
Colombia,Romania,1,3,FIFA World Cup,2
Brazil,Russia,2,0,FIFA World Cup,2
Argentina,Greece,4,0,FIFA World Cup,4
Nigeria,Bulgaria,3,0,FIFA World Cup,3
Romania,Switzerland,1,4,FIFA World Cup,3
Brazil,Cameroon,3,0,FIFA World Cup,3
Sweden,Russia,3,1,FIFA World Cup,2
Bulgaria,Greece,4,0,FIFA World Cup,4
Latvia,Georgia,1,3,Friendly,2
Switzerland,Colombia,0,2,FIFA World Cup,2
Bolivia,Spain,1,3,FIFA World Cup,2
Russia,Cameroon,6,1,FIFA World Cup,5
Argentina,Bulgaria,0,2,FIFA World Cup,2
Greece,Nigeria,0,2,FIFA World Cup,2
Spain,Switzerland,3,0,FIFA World Cup,3
Saudi Arabia,Sweden,1,3,FIFA World Cup,2
Fiji,New Caledonia,3,1,Oceania Nations Cup qualification,2
Netherlands,Republic of Ireland,2,0,FIFA World Cup,2
Solomon Islands,Papua New Guinea,2,0,Oceania Nations Cup qualification,2
Solomon Islands,Vanuatu,4,0,Oceania Nations Cup qualification,4
Solomon Islands,New Caledonia,3,1,Oceania Nations Cup qualification,2
Vanuatu,Fiji,2,4,Oceania Nations Cup qualification,2
Sweden,Bulgaria,4,0,FIFA World Cup,4
Lithuania,Estonia,3,0,Baltic Cup,3
Estonia,Latvia,0,2,Baltic Cup,2
Iceland,Estonia,4,0,Friendly,4
Austria,Russia,0,3,Friendly,3
Israel,Croatia,0,4,Friendly,4
Peru,Ecuador,2,0,Friendly,2
Sweden,Lithuania,4,2,Friendly,2
Congo,DR Congo,2,0,Friendly,2
Egypt,Ghana,2,0,Friendly,2
DR Congo,Congo,2,0,Friendly,2
Egypt,Zambia,0,4,Friendly,4
North Macedonia,Turkey,0,2,Friendly,2
Tanzania,Uganda,4,0,African Cup of Nations qualification,4
Angola,Namibia,2,0,African Cup of Nations qualification,2
Estonia,Croatia,0,2,UEFA Euro qualification,2
Guinea-Bissau,Tunisia,1,3,African Cup of Nations qualification,2
Czech Republic,Malta,6,1,UEFA Euro qualification,5
Belgium,Armenia,2,0,UEFA Euro qualification,2
England,United States,2,0,Friendly,2
Faroe Islands,Greece,1,5,UEFA Euro qualification,4
Finland,Scotland,0,2,UEFA Euro qualification,2
Latvia,Republic of Ireland,0,3,UEFA Euro qualification,3
Liechtenstein,Austria,0,4,UEFA Euro qualification,4
Luxembourg,Netherlands,0,4,UEFA Euro qualification,4
Romania,Azerbaijan,3,0,UEFA Euro qualification,3
Ukraine,Lithuania,0,2,UEFA Euro qualification,2
Wales,Albania,2,0,UEFA Euro qualification,2
Qatar,Oman,0,2,Friendly,2
Bangladesh,India,2,4,Friendly,2
South Korea,Ukraine,2,0,Friendly,2
India,Oman,1,4,Friendly,3
Qatar,Yemen,2,0,Friendly,2
India,Yemen,0,2,Friendly,2
Malaysia,Kuwait,0,2,Friendly,2
Zambia,Ghana,3,0,Friendly,3
Estonia,Italy,0,2,UEFA Euro qualification,2
Croatia,Lithuania,2,0,UEFA Euro qualification,2
Latvia,Portugal,1,3,UEFA Euro qualification,2
Senegal,Niger,3,1,Friendly,2
Belarus,Luxembourg,2,0,UEFA Euro qualification,2
Bulgaria,Georgia,2,0,UEFA Euro qualification,2
Denmark,Belgium,3,1,UEFA Euro qualification,2
Greece,Finland,4,0,UEFA Euro qualification,4
Republic of Ireland,Liechtenstein,4,0,UEFA Euro qualification,4
North Macedonia,Spain,0,2,UEFA Euro qualification,2
Russia,San Marino,4,0,UEFA Euro qualification,4
Scotland,Faroe Islands,5,1,UEFA Euro qualification,4
Switzerland,Sweden,4,2,UEFA Euro qualification,2
Turkey,Iceland,5,0,UEFA Euro qualification,5
Egypt,Tanzania,5,1,African Cup of Nations qualification,4
Malawi,Zimbabwe,3,1,African Cup of Nations qualification,2
Uganda,Ethiopia,4,1,African Cup of Nations qualification,3
Guinea,Angola,3,1,African Cup of Nations qualification,2
Mozambique,Botswana,3,1,African Cup of Nations qualification,2
Niger,Ghana,1,5,African Cup of Nations qualification,4
Togo,Senegal,2,0,African Cup of Nations qualification,2
Estonia,Finland,0,7,Friendly,7
United Arab Emirates,Qatar,2,0,Gulf Cup,2
Tunisia,Ivory Coast,2,0,Friendly,2
Qatar,Oman,4,2,Gulf Cup,2
United Arab Emirates,Kuwait,2,0,Gulf Cup,2
Saudi Arabia,Bahrain,3,1,Gulf Cup,2
Egypt,Ethiopia,5,0,African Cup of Nations qualification,5
Tanzania,Sudan,2,0,African Cup of Nations qualification,2
Gabon,Mauritius,3,0,African Cup of Nations qualification,3
Guinea-Bissau,Senegal,1,4,African Cup of Nations qualification,3
Lesotho,Cameroon,2,0,African Cup of Nations qualification,2
Niger,Sierra Leone,4,2,African Cup of Nations qualification,2
Ukraine,Estonia,3,0,UEFA Euro qualification,3
Azerbaijan,Israel,0,2,UEFA Euro qualification,2
Belarus,Norway,0,4,UEFA Euro qualification,4
Bulgaria,Moldova,4,1,UEFA Euro qualification,3
Chile,Argentina,0,3,Friendly,3
Cyprus,Armenia,2,0,UEFA Euro qualification,2
Finland,Faroe Islands,5,0,UEFA Euro qualification,5
Georgia,Wales,5,0,UEFA Euro qualification,5
Greece,San Marino,2,0,UEFA Euro qualification,2
Kuwait,Saudi Arabia,0,2,Gulf Cup,2
Northern Ireland,Republic of Ireland,0,4,UEFA Euro qualification,4
Spain,Denmark,3,0,UEFA Euro qualification,3
Sweden,Hungary,2,0,UEFA Euro qualification,2
United Arab Emirates,Oman,2,0,Gulf Cup,2
Jamaica,United States,0,3,Friendly,3
Samoa,American Samoa,3,1,Oceania Nations Cup qualification,2
Kenya,Somalia,3,1,CECAFA Cup,2
Kenya,Djibouti,4,1,CECAFA Cup,3
Samoa,Tahiti,0,7,Oceania Nations Cup qualification,7
Tanzania,Somalia,4,0,CECAFA Cup,4
Spain,Finland,2,0,Friendly,2
Uganda,Seychelles,2,0,CECAFA Cup,2
Tanzania,Djibouti,3,0,CECAFA Cup,3
Togo,Burkina Faso,2,0,Friendly,2
Saudi Arabia,Poland,0,2,Friendly,2
Azerbaijan,France,0,2,UEFA Euro qualification,2
Finland,San Marino,4,1,UEFA Euro qualification,3
Mexico,Hungary,5,1,Friendly,4
Moldova,Germany,0,3,UEFA Euro qualification,3
Netherlands,Luxembourg,5,0,UEFA Euro qualification,5
Wales,Bulgaria,0,3,UEFA Euro qualification,3
Belgium,Spain,1,4,UEFA Euro qualification,3
North Macedonia,Cyprus,3,0,UEFA Euro qualification,3
Saudi Arabia,Costa Rica,1,3,Friendly,2
Portugal,Liechtenstein,8,0,UEFA Euro qualification,8
Italy,Turkey,3,1,Friendly,2
Brazil,Serbia,2,0,Friendly,2
Guinea,Sierra Leone,3,1,Friendly,2
Tunisia,Egypt,2,0,Friendly,2
Japan,Nigeria,0,3,Confederations Cup,3
Saudi Arabia,Mexico,0,2,Confederations Cup,2
Sierra Leone,Gambia,2,0,African Cup of Nations qualification,2
Congo,Niger,3,1,African Cup of Nations qualification,2
DR Congo,Lesotho,3,0,African Cup of Nations qualification,3
Guinea,Namibia,3,0,African Cup of Nations qualification,3
Japan,Argentina,1,5,Confederations Cup,4
Saudi Arabia,Denmark,0,2,Confederations Cup,2
Mauritius,Zambia,0,3,African Cup of Nations qualification,3
Denmark,Argentina,2,0,Confederations Cup,2
Ethiopia,Sudan,2,0,African Cup of Nations qualification,2
Ghana,Congo,3,1,African Cup of Nations qualification,2
Lesotho,Malawi,0,2,African Cup of Nations qualification,2
Mozambique,Namibia,4,2,African Cup of Nations qualification,2
Zimbabwe,Cameroon,4,1,African Cup of Nations qualification,3
Estonia,Norway,0,7,Friendly,7
Cyprus,Norway,0,2,Friendly,2
Argentina,Bulgaria,4,1,Friendly,3
Israel,Luxembourg,4,2,Friendly,2
Cyprus,Estonia,3,1,Friendly,2
Hong Kong,Japan,0,3,Dynasty Cup,3
New Zealand,Singapore,3,0,Friendly,3
Brazil,Slovakia,5,0,Friendly,5
Morocco,Senegal,2,0,Friendly,2
Czech Republic,Finland,4,1,Friendly,3
Hungary,Latvia,3,1,Friendly,2
Iraq,Uzbekistan,3,1,Nehru Cup,2
India,Thailand,0,5,Nehru Cup,5
Iraq,Thailand,3,1,Nehru Cup,2
Poland,Lithuania,4,1,Friendly,3
Sint Maarten,Saint Kitts and Nevis,0,2,CFU Caribbean Cup qualification,2
Grenada,Saint Lucia,2,0,CFU Caribbean Cup qualification,2
Morocco,Mali,3,0,Friendly,3
Croatia,Ukraine,4,0,UEFA Euro qualification,4
Italy,Estonia,4,1,UEFA Euro qualification,3
Nepal,Bangladesh,0,2,SAFF Cup,2
Barbados,Guyana,3,0,CFU Caribbean Cup qualification,3
Albania,Moldova,3,0,UEFA Euro qualification,3
Austria,Latvia,5,0,UEFA Euro qualification,5
Bulgaria,Wales,3,1,UEFA Euro qualification,2
Czech Republic,Belarus,4,2,UEFA Euro qualification,2
Georgia,Germany,0,2,UEFA Euro qualification,2
Luxembourg,Norway,0,2,UEFA Euro qualification,2
Nepal,Pakistan,2,0,SAFF Cup,2
Netherlands,Malta,4,0,UEFA Euro qualification,4
San Marino,Finland,0,2,UEFA Euro qualification,2
Slovakia,Azerbaijan,4,1,UEFA Euro qualification,3
Slovenia,Estonia,3,0,UEFA Euro qualification,3
Ukraine,Italy,0,2,UEFA Euro qualification,2
Tahiti,Fiji,3,0,Friendly,3
Gabon,Benin,7,0,Friendly,7
Guyana,Barbados,0,4,CFU Caribbean Cup qualification,4
Uganda,Tanzania,2,0,African Cup of Nations qualification,2
Guinea,Botswana,5,0,African Cup of Nations qualification,5
Lesotho,Zimbabwe,0,2,African Cup of Nations qualification,2
Saint Lucia,Grenada,4,0,CFU Caribbean Cup qualification,4
Peru,Chile,6,0,Friendly,6
Congo,Sierra Leone,0,2,African Cup of Nations qualification,2
Senegal,Togo,5,1,African Cup of Nations qualification,4
Angola,Guinea,3,0,African Cup of Nations qualification,3
Botswana,Mozambique,0,3,African Cup of Nations qualification,3
Mali,Namibia,2,0,African Cup of Nations qualification,2
Sudan,Algeria,2,0,African Cup of Nations qualification,2
Armenia,Spain,0,2,UEFA Euro qualification,2
Austria,Liechtenstein,7,0,UEFA Euro qualification,7
Azerbaijan,Romania,1,4,UEFA Euro qualification,3
Belgium,Cyprus,2,0,UEFA Euro qualification,2
Croatia,Slovenia,2,0,UEFA Euro qualification,2
Czech Republic,Netherlands,3,1,UEFA Euro qualification,2
Faroe Islands,Finland,0,4,UEFA Euro qualification,4
France,Slovakia,4,0,UEFA Euro qualification,4
Georgia,Albania,2,0,UEFA Euro qualification,2
Greece,Russia,0,3,UEFA Euro qualification,3
Ivory Coast,Sierra Leone,4,0,Friendly,4
Moldova,Bulgaria,0,3,UEFA Euro qualification,3
Norway,Luxembourg,5,0,UEFA Euro qualification,5
San Marino,Scotland,0,2,UEFA Euro qualification,2
Russia,Faroe Islands,3,0,UEFA Euro qualification,3
French Guiana,Martinique,1,3,CFU Caribbean Cup qualification,2
French Guiana,Suriname,4,0,CFU Caribbean Cup qualification,4
Togo,Benin,3,0,Friendly,3
Latvia,Estonia,2,0,Baltic Cup,2
Estonia,Lithuania,0,7,Baltic Cup,7
Latvia,Lithuania,2,0,Baltic Cup,2
Canada,Northern Ireland,2,0,Friendly,2
Cuba,Curaçao,3,0,CFU Caribbean Cup qualification,3
Dominican Republic,Puerto Rico,3,1,CFU Caribbean Cup qualification,2
Dominican Republic,Cuba,0,3,CFU Caribbean Cup qualification,3
Faroe Islands,San Marino,3,0,UEFA Euro qualification,3
Cuba,Puerto Rico,9,0,CFU Caribbean Cup qualification,9
Japan,Ecuador,3,0,Kirin Cup,3
Sierra Leone,Niger,5,1,African Cup of Nations qualification,4
Cameroon,Lesotho,4,1,African Cup of Nations qualification,3
Canada,Turkey,1,3,Friendly,2
DR Congo,Zimbabwe,5,0,African Cup of Nations qualification,5
Ecuador,Zambia,4,1,Korea Cup,3
Ethiopia,Egypt,0,2,African Cup of Nations qualification,2
Ivory Coast,Morocco,2,0,African Cup of Nations qualification,2
Liberia,Mauritania,2,0,African Cup of Nations qualification,2
Mauritius,Gabon,0,3,African Cup of Nations qualification,3
Brazil,Japan,3,0,Friendly,3
Canada,Turkey,0,3,Friendly,3
Denmark,Cyprus,4,0,UEFA Euro qualification,4
Faroe Islands,Scotland,0,2,UEFA Euro qualification,2
North Macedonia,Belgium,0,5,UEFA Euro qualification,5
Norway,Malta,2,0,UEFA Euro qualification,2
Poland,Slovakia,5,0,UEFA Euro qualification,5
San Marino,Russia,0,7,UEFA Euro qualification,7
England,Brazil,1,3,Friendly,2
Estonia,Slovenia,1,3,UEFA Euro qualification,2
Republic of Ireland,Austria,1,3,UEFA Euro qualification,2
United States,Mexico,4,0,USA Cup,4
Venezuela,Bolivia,1,3,Friendly,2
Germany,Italy,2,0,Friendly,2
Mozambique,Zimbabwe,3,1,Friendly,2
Uruguay,New Zealand,7,0,Friendly,7
Argentina,Australia,2,0,Friendly,2
Ivory Coast,Ghana,2,0,Friendly,2
Peru,Bolivia,4,1,Friendly,3
Iceland,Faroe Islands,2,0,Friendly,2
Uruguay,Venezuela,4,1,Copa América,3
Mexico,Venezuela,3,1,Copa América,2
Brazil,Peru,2,0,Copa América,2
Argentina,Chile,4,0,Copa América,4
Brazil,Colombia,3,0,Copa América,3
Argentina,United States,0,3,Copa América,3
Tanzania,Ethiopia,2,0,African Cup of Nations qualification,2
Tunisia,Senegal,4,0,African Cup of Nations qualification,4
Uganda,Sudan,2,0,African Cup of Nations qualification,2
Zambia,Mauritius,2,0,African Cup of Nations qualification,2
Malawi,Cameroon,1,3,African Cup of Nations qualification,2
Mali,Botswana,4,0,African Cup of Nations qualification,4
Isle of Man,Ynys Môn,0,2,Island Games,2
Jersey,Isle of Wight,2,0,Island Games,2
Åland Islands,Isle of Wight,0,5,Island Games,5
Gibraltar,Ynys Môn,2,0,Island Games,2
Greenland,Isle of Man,4,0,Island Games,4
Jersey,Åland Islands,3,1,Island Games,2
Trinidad and Tobago,Cuba,2,0,CFU Caribbean Cup,2
Uruguay,Colombia,2,0,Copa América,2
Cayman Islands,Antigua and Barbuda,2,0,CFU Caribbean Cup,2
French Guiana,Saint Vincent and the Grenadines,1,3,CFU Caribbean Cup,2
Saint Lucia,Trinidad and Tobago,0,5,CFU Caribbean Cup,5
Åland Islands,Isle of Man,4,1,Island Games,3
Guernsey,Ynys Môn,4,2,Island Games,2
Colombia,United States,4,1,Copa América,3
Cuba,Saint Lucia,2,0,CFU Caribbean Cup,2
Saint Vincent and the Grenadines,Antigua and Barbuda,5,1,CFU Caribbean Cup,4
Cayman Islands,Trinidad and Tobago,2,9,CFU Caribbean Cup,7
Angola,Botswana,4,0,African Cup of Nations qualification,4
Cayman Islands,Cuba,0,3,CFU Caribbean Cup,3
Congo,Ghana,0,2,African Cup of Nations qualification,2
Egypt,Uganda,6,0,African Cup of Nations qualification,6
Guinea,Mali,4,1,African Cup of Nations qualification,3
Senegal,Liberia,3,0,African Cup of Nations qualification,3
Sudan,Ethiopia,3,0,African Cup of Nations qualification,3
Canada,Jamaica,3,1,Friendly,2
Canada,Trinidad and Tobago,3,1,Friendly,2
Japan,Costa Rica,3,0,Friendly,3
Japan,Brazil,1,5,Friendly,4
Liechtenstein,Portugal,0,7,UEFA Euro qualification,7
Armenia,Denmark,0,2,UEFA Euro qualification,2
Cook Islands,New Caledonia,0,9,South Pacific Games,9
Finland,Russia,0,6,UEFA Euro qualification,6
Guam,Vanuatu,0,6,South Pacific Games,6
Hungary,Israel,0,2,Friendly,2
Iceland,Switzerland,0,2,UEFA Euro qualification,2
Solomon Islands,Wallis Islands and Futuna,12,1,South Pacific Games,11
Tahiti,Wallis Islands and Futuna,13,0,South Pacific Games,13
Tahiti,Solomon Islands,4,2,South Pacific Games,2
Fiji,Guam,8,0,South Pacific Games,8
Jamaica,Zambia,3,1,Friendly,2
New Caledonia,Wallis Islands and Futuna,10,0,South Pacific Games,10
Papua New Guinea,Vanuatu,0,3,South Pacific Games,3
Cook Islands,Solomon Islands,0,16,South Pacific Games,16
Tahiti,New Caledonia,2,0,South Pacific Games,2
Fiji,Vanuatu,3,1,South Pacific Games,2
Guam,Papua New Guinea,0,9,South Pacific Games,9
Tahiti,Cook Islands,11,0,South Pacific Games,11
Tahiti,Vanuatu,3,0,South Pacific Games,3
Fiji,Vanuatu,3,0,South Pacific Games,3
Tahiti,Solomon Islands,2,0,South Pacific Games,2
Croatia,Estonia,7,1,UEFA Euro qualification,6
Austria,Republic of Ireland,3,1,UEFA Euro qualification,2
Belgium,Denmark,1,3,UEFA Euro qualification,2
Czech Republic,Norway,2,0,UEFA Euro qualification,2
Faroe Islands,Russia,2,5,UEFA Euro qualification,3
France,Azerbaijan,10,0,UEFA Euro qualification,10
Germany,Georgia,4,1,UEFA Euro qualification,3
Lithuania,Ukraine,1,3,UEFA Euro qualification,2
San Marino,Greece,0,4,UEFA Euro qualification,4
Spain,Cyprus,6,0,UEFA Euro qualification,6
Turkey,Hungary,2,0,UEFA Euro qualification,2
Greece,Serbia,0,2,Friendly,2
Israel,Uruguay,3,1,Friendly,2
Jamaica,Costa Rica,2,0,Friendly,2
Armenia,Belgium,0,2,UEFA Euro qualification,2
Belarus,Czech Republic,0,2,UEFA Euro qualification,2
Bulgaria,Albania,3,0,UEFA Euro qualification,3
Germany,Moldova,6,1,UEFA Euro qualification,5
Brazil,Uruguay,2,0,Friendly,2
Chile,Canada,2,0,Friendly,2
Israel,Azerbaijan,2,0,UEFA Euro qualification,2
Liechtenstein,Northern Ireland,0,4,UEFA Euro qualification,4
Lithuania,Estonia,5,0,UEFA Euro qualification,5
Malta,Netherlands,0,4,UEFA Euro qualification,4
Romania,France,1,3,UEFA Euro qualification,2
San Marino,Faroe Islands,1,3,UEFA Euro qualification,2
Slovakia,Poland,4,1,UEFA Euro qualification,3
Sweden,Scotland,2,0,Friendly,2
Switzerland,Hungary,3,0,UEFA Euro qualification,3
Mali,Algeria,0,2,Friendly,2
Cayman Islands,Jamaica,1,5,Friendly,4
Panama,Nicaragua,2,0,UNCAF Cup,2
Cayman Islands,Trinidad and Tobago,0,7,Friendly,7
Myanmar,Bangladesh,4,0,Friendly,4
Myanmar,Sri Lanka,2,0,Friendly,2
Nicaragua,Panama,0,5,UNCAF Cup,5
Algeria,Mauritania,4,0,Friendly,4
Tunisia,Algeria,2,0,Friendly,2
Zambia,Jamaica,4,2,Friendly,2
Italy,Ukraine,3,1,UEFA Euro qualification,2
El Salvador,Serbia,1,4,Friendly,3
Malta,Belarus,0,2,UEFA Euro qualification,2
Australia,New Zealand,3,0,Oceania Nations Cup,3
Czech Republic,Luxembourg,3,0,UEFA Euro qualification,3
Denmark,Armenia,3,1,UEFA Euro qualification,2
England,Switzerland,3,1,Friendly,2
France,Israel,2,0,UEFA Euro qualification,2
Germany,Bulgaria,3,1,UEFA Euro qualification,2
Greece,Faroe Islands,5,0,UEFA Euro qualification,5
Italy,Lithuania,4,0,UEFA Euro qualification,4
Morocco,Mali,2,0,Friendly,2
Netherlands,Norway,3,0,UEFA Euro qualification,3
Northern Ireland,Austria,5,3,UEFA Euro qualification,2
Portugal,Republic of Ireland,3,0,UEFA Euro qualification,3
Russia,Finland,3,1,UEFA Euro qualification,2
Scotland,San Marino,5,0,UEFA Euro qualification,5
Slovakia,Romania,0,2,UEFA Euro qualification,2
Spain,North Macedonia,3,0,UEFA Euro qualification,3
Mexico,Serbia,1,4,Friendly,3
Sierra Leone,Guinea,2,0,Amílcar Cabral Cup,2
Saint Vincent and the Grenadines,Barbados,2,0,Windward Islands Tournament,2
Senegal,Guinea,3,0,Amílcar Cabral Cup,3
Sierra Leone,Guinea-Bissau,2,0,Amílcar Cabral Cup,2
South Africa,Egypt,2,0,Simba Tournament,2
Sierra Leone,Cape Verde,2,0,Amílcar Cabral Cup,2
Egypt,Zambia,3,1,Simba Tournament,2
South Africa,Zimbabwe,2,0,Simba Tournament,2
Kenya,Zanzibar,2,0,CECAFA Cup,2
Algeria,Cameroon,4,0,Friendly,4
Gabon,Ivory Coast,0,2,Friendly,2
El Salvador,Belize,3,0,UNCAF Cup,3
Honduras,Panama,2,0,UNCAF Cup,2
Tunisia,Burkina Faso,3,0,Friendly,3
Albania,Bosnia and Herzegovina,2,0,Friendly,2
Tanzania,Somalia,7,0,CECAFA Cup,7
Ethiopia,Somalia,5,0,CECAFA Cup,5
Honduras,Guatemala,2,0,UNCAF Cup,2
Saint Kitts and Nevis,Jamaica,0,3,Friendly,3
Honduras,Guatemala,3,0,UNCAF Cup,3
Republic of Ireland,Netherlands,0,2,UEFA Euro qualification,2
Brazil,Colombia,3,1,Friendly,2
Argentina,Venezuela,6,0,Friendly,6
Burkina Faso,Gabon,2,5,Friendly,3
Zambia,Tunisia,2,0,Friendly,2
Saudi Arabia,Kazakhstan,3,0,Friendly,3
Morocco,Tunisia,3,1,Friendly,2
Canada,Honduras,3,1,Gold Cup,2
Mexico,Saint Vincent and the Grenadines,5,0,Gold Cup,5
Brazil,Canada,4,1,Gold Cup,3
South Africa,Cameroon,3,0,African Cup of Nations,3
Honduras,Brazil,0,5,Gold Cup,5
Ivory Coast,Ghana,0,2,African Cup of Nations,2
Guatemala,Saint Vincent and the Grenadines,3,0,Gold Cup,3
United States,El Salvador,2,0,Gold Cup,2
Armenia,Morocco,0,6,Friendly,6
Algeria,Sierra Leone,2,0,African Cup of Nations,2
DR Congo,Gabon,0,2,African Cup of Nations,2
Burkina Faso,Zambia,1,5,African Cup of Nations,4
Mexico,Brazil,2,0,Gold Cup,2
United States,Guatemala,3,0,Gold Cup,3
Saudi Arabia,Kyrgyzstan,3,0,AFC Asian Cup qualification,3
Sierra Leone,Zambia,0,4,African Cup of Nations,4
Liberia,DR Congo,0,2,African Cup of Nations,2
Mozambique,Ghana,0,2,African Cup of Nations,2
Tunisia,Ivory Coast,3,1,African Cup of Nations,2
Zambia,Egypt,3,1,African Cup of Nations,2
Saudi Arabia,Yemen,4,0,AFC Asian Cup qualification,4
China PR,Macau,7,1,AFC Asian Cup qualification,6
Hong Kong,Philippines,8,0,AFC Asian Cup qualification,8
Saudi Arabia,Kyrgyzstan,2,0,AFC Asian Cup qualification,2
South Africa,Ghana,3,0,African Cup of Nations,3
Zambia,Tunisia,2,4,African Cup of Nations,2
Hong Kong,Macau,4,1,AFC Asian Cup qualification,3
Philippines,China PR,0,7,AFC Asian Cup qualification,7
Kyrgyzstan,Yemen,3,1,AFC Asian Cup qualification,2
South Africa,Tunisia,2,0,African Cup of Nations,2
Hong Kong,China PR,0,2,AFC Asian Cup qualification,2
Macau,Philippines,5,1,AFC Asian Cup qualification,4
Canary Islands,Venezuela,5,1,Friendly,4
Iceland,Slovenia,1,7,Malta International Tournament,6
Malta,Russia,0,2,Malta International Tournament,2
Morocco,Luxembourg,2,0,Friendly,2
Iceland,Russia,0,3,Malta International Tournament,3
Australia,Japan,1,4,Friendly,3
Malta,Iceland,1,4,Malta International Tournament,3
Peru,Bolivia,1,3,Friendly,2
Russia,Slovenia,3,1,Malta International Tournament,2
Australia,Japan,3,0,Friendly,3
Bolivia,Paraguay,4,1,Friendly,3
Chile,Peru,4,0,Friendly,4
Oman,Ecuador,0,2,Friendly,2
Thailand,Finland,5,2,King's Cup,3
Japan,Poland,5,0,Lunar New Year Cup,5
France,Greece,3,1,Friendly,2
Israel,Lithuania,4,2,Friendly,2
Kuwait,Ecuador,0,3,Friendly,3
Thailand,Indonesia,4,1,Friendly,3
Australia,Sweden,0,2,Friendly,2
Azerbaijan,Faroe Islands,3,0,Friendly,3
Oman,Kuwait,0,3,Friendly,3
Jamaica,Guatemala,2,0,Friendly,2
Indonesia,India,7,1,AFC Asian Cup qualification,6
Syria,Kuwait,0,2,Friendly,2
Malaysia,India,5,2,AFC Asian Cup qualification,3
Trinidad and Tobago,Haiti,2,0,Friendly,2
Bolivia,Peru,2,0,Friendly,2
Croatia,South Korea,3,0,Friendly,3
Egypt,Morocco,0,2,United Arab Emirates Friendship Tournament,2
Colombia,Trinidad and Tobago,3,0,Friendly,3
Kuwait,Turkmenistan,2,0,AFC Asian Cup qualification,2
Croatia,Israel,2,0,Friendly,2
Czech Republic,Turkey,3,0,Friendly,3
Belgium,France,0,2,Friendly,2
Brazil,Ghana,8,2,Friendly,6
Cyprus,Georgia,0,2,Friendly,2
Germany,Denmark,2,0,Friendly,2
Guatemala,Venezuela,3,0,Friendly,3
Republic of Ireland,Russia,0,2,Friendly,2
Northern Ireland,Norway,0,2,Friendly,2
Slovakia,Belarus,4,0,Friendly,4
Saint Kitts and Nevis,Anguilla,8,0,CFU Caribbean Cup qualification,8
Colombia,Bolivia,4,1,Friendly,3
Sint Maarten,Anguilla,4,0,CFU Caribbean Cup qualification,4
Antigua and Barbuda,Dominica,1,3,FIFA World Cup qualification,2
Aruba,Dominican Republic,1,3,FIFA World Cup qualification,2
Saint Kitts and Nevis,Sint Maarten,3,0,CFU Caribbean Cup qualification,3
Grenada,Guyana,6,0,FIFA World Cup qualification,6
Croatia,Hungary,4,1,Friendly,3
Ethiopia,Ghana,2,0,Friendly,2
Paraguay,Bosnia and Herzegovina,3,0,Friendly,3
Qatar,Kuwait,3,1,Friendly,2
Argentina,Bolivia,3,1,FIFA World Cup qualification,2
Czech Republic,Republic of Ireland,2,0,Friendly,2
Denmark,Scotland,2,0,Friendly,2
Ecuador,Peru,4,1,FIFA World Cup qualification,3
Estonia,Iceland,0,3,Friendly,3
Greece,Slovenia,2,0,FIFA World Cup qualification,2
Hungary,Austria,0,2,Friendly,2
Jamaica,Barbados,2,0,CFU Caribbean Cup qualification,2
North Macedonia,Liechtenstein,3,0,FIFA World Cup qualification,3
Romania,Georgia,5,0,Friendly,5
Serbia,Faroe Islands,3,1,FIFA World Cup qualification,2
Switzerland,Wales,2,0,Friendly,2
Venezuela,Uruguay,0,2,FIFA World Cup qualification,2
Cayman Islands,Cuba,0,4,CFU Caribbean Cup qualification,4
Haiti,Dominican Republic,6,0,CFU Caribbean Cup qualification,6
Barbados,Jamaica,2,0,CFU Caribbean Cup qualification,2
DR Congo,Congo,3,1,Friendly,2
Saint Kitts and Nevis,Saint Lucia,5,1,FIFA World Cup qualification,4
Tajikistan,Uzbekistan,4,0,AFC Asian Cup qualification,4
Saint Vincent and the Grenadines,Puerto Rico,7,0,FIFA World Cup qualification,7
Haiti,Grenada,6,1,FIFA World Cup qualification,5
Lebanon,Turkmenistan,3,1,AFC Asian Cup qualification,2
Cayman Islands,Cuba,0,5,FIFA World Cup qualification,5
South Korea,Sweden,0,2,Friendly,2
Iran,Qatar,2,0,Friendly,2
England,Hungary,3,0,Friendly,3
Mexico,Slovakia,5,2,Friendly,3
China PR,England,0,3,Friendly,3
Kuwait,Syria,3,1,Friendly,2
Cuba,Saint Vincent and the Grenadines,2,0,CFU Caribbean Cup,2
Qatar,Russia,2,5,Friendly,3
Chile,Bolivia,2,0,Friendly,2
Ghana,Egypt,0,2,Friendly,2
Jamaica,Saint Kitts and Nevis,4,1,CFU Caribbean Cup,3
Trinidad and Tobago,Suriname,3,0,CFU Caribbean Cup,3
Tunisia,Senegal,2,0,Friendly,2
Bulgaria,North Macedonia,3,0,Friendly,3
Suriname,Jamaica,3,1,CFU Caribbean Cup,2
Trinidad and Tobago,Saint Kitts and Nevis,5,1,CFU Caribbean Cup,4
France,Finland,2,0,Friendly,2
Netherlands,China PR,2,0,Friendly,2
Hungary,Italy,0,2,Friendly,2
Namibia,Mozambique,2,0,FIFA World Cup qualification,2
Romania,Moldova,3,1,Friendly,2
Sudan,Zambia,2,0,FIFA World Cup qualification,2
Sweden,Belarus,5,1,FIFA World Cup qualification,4
Uganda,Angola,0,2,FIFA World Cup qualification,2
Bulgaria,United Arab Emirates,4,1,Friendly,3
Congo,Ivory Coast,2,0,FIFA World Cup qualification,2
Ecuador,Argentina,2,0,FIFA World Cup qualification,2
Kenya,Algeria,3,1,FIFA World Cup qualification,2
Mauritius,DR Congo,1,5,FIFA World Cup qualification,4
Norway,Azerbaijan,5,0,FIFA World Cup qualification,5
Russia,Poland,2,0,Friendly,2
Rwanda,Tunisia,1,3,FIFA World Cup qualification,2
San Marino,Wales,0,5,FIFA World Cup qualification,5
Serbia,Malta,6,0,FIFA World Cup qualification,6
Uruguay,Paraguay,0,2,FIFA World Cup qualification,2
Cuba,Suriname,4,0,CFU Caribbean Cup,4
Oman,Bahrain,3,0,Friendly,3
Germany,Liechtenstein,9,1,Friendly,8
Netherlands,Republic of Ireland,3,1,Friendly,2
France,Armenia,2,0,Friendly,2
Trinidad and Tobago,Cuba,2,0,CFU Caribbean Cup,2
Germany,Czech Republic,2,0,UEFA Euro,2
Lebanon,Kuwait,3,5,AFC Asian Cup qualification,2
Nigeria,Togo,1,3,Friendly,2
Panama,Belize,4,1,FIFA World Cup qualification,3
Iran,Nepal,8,0,AFC Asian Cup qualification,8
Sri Lanka,Oman,0,3,AFC Asian Cup qualification,3
Iran,Sri Lanka,7,0,AFC Asian Cup qualification,7
Nepal,Oman,0,7,AFC Asian Cup qualification,7
United States,Bolivia,0,2,USA Cup,2
Barbados,Trinidad and Tobago,0,4,Friendly,4
Switzerland,Netherlands,0,2,UEFA Euro,2
Iran,Oman,2,0,AFC Asian Cup qualification,2
Sri Lanka,Nepal,3,1,AFC Asian Cup qualification,2
Bolivia,Republic of Ireland,0,3,USA Cup,3
Dominican Republic,Trinidad and Tobago,1,4,FIFA World Cup qualification,3
England,Scotland,2,0,UEFA Euro,2
South Africa,Malawi,3,0,FIFA World Cup qualification,3
Angola,Uganda,3,1,FIFA World Cup qualification,2
Burkina Faso,Mauritania,2,0,FIFA World Cup qualification,2
DR Congo,Mauritius,2,0,FIFA World Cup qualification,2
Croatia,Denmark,3,0,UEFA Euro,3
Gabon,Eswatini,2,0,FIFA World Cup qualification,2
Guinea,Guinea-Bissau,3,1,FIFA World Cup qualification,2
Russia,Germany,0,3,UEFA Euro,3
Tunisia,Rwanda,2,0,FIFA World Cup qualification,2
Zambia,Sudan,3,0,FIFA World Cup qualification,3
Sri Lanka,Iran,0,4,AFC Asian Cup qualification,4
England,Netherlands,4,1,UEFA Euro,3
France,Bulgaria,3,1,UEFA Euro,2
Croatia,Portugal,0,3,UEFA Euro,3
Nepal,Iran,0,4,AFC Asian Cup qualification,4
Oman,Sri Lanka,10,0,AFC Asian Cup qualification,10
Turkey,Denmark,0,3,UEFA Euro,3
Uzbekistan,Tajikistan,5,0,AFC Asian Cup qualification,5
Peru,Armenia,4,0,Friendly,4
Nepal,Sri Lanka,0,2,AFC Asian Cup qualification,2
Syria,Kazakhstan,2,0,AFC Asian Cup qualification,2
Cuba,Haiti,6,1,FIFA World Cup qualification,5
Liberia,Gambia,4,0,FIFA World Cup qualification,4
Trinidad and Tobago,Dominican Republic,8,0,FIFA World Cup qualification,8
Myanmar,Singapore,0,4,AFC Asian Cup qualification,4
Thailand,Maldives,8,0,AFC Asian Cup qualification,8
China PR,New Zealand,2,0,Friendly,2
Maldives,Singapore,0,2,AFC Asian Cup qualification,2
Thailand,Myanmar,5,1,AFC Asian Cup qualification,4
Ecuador,Armenia,3,0,Friendly,3
Jamaica,Barbados,2,0,FIFA World Cup qualification,2
Myanmar,Maldives,3,1,AFC Asian Cup qualification,2
Maldives,Thailand,0,8,AFC Asian Cup qualification,8
Qatar,Kazakhstan,3,0,AFC Asian Cup qualification,3
Chile,Ecuador,4,1,FIFA World Cup qualification,3
Bolivia,Venezuela,6,1,FIFA World Cup qualification,5
Myanmar,Thailand,1,7,AFC Asian Cup qualification,6
Colombia,Uruguay,3,1,FIFA World Cup qualification,2
Singapore,Maldives,5,2,AFC Asian Cup qualification,3
Myanmar,Maldives,4,1,AFC Asian Cup qualification,3
Syria,Qatar,3,1,AFC Asian Cup qualification,2
Panama,Venezuela,0,2,Friendly,2
Paraguay,Bolivia,2,0,Friendly,2
Vietnam,Taiwan,4,1,AFC Asian Cup qualification,3
South Korea,Guam,9,0,AFC Asian Cup qualification,9
Vietnam,Guam,9,0,AFC Asian Cup qualification,9
Benin,Mauritania,4,1,African Cup of Nations qualification,3
China PR,Paraguay,0,2,Friendly,2
South Korea,Taiwan,4,0,AFC Asian Cup qualification,4
Jordan,Pakistan,4,0,AFC Asian Cup qualification,4
Iraq,Pakistan,3,0,AFC Asian Cup qualification,3
Vietnam,South Korea,0,4,AFC Asian Cup qualification,4
Ukraine,Lithuania,5,2,Friendly,3
Hungary,United Arab Emirates,3,1,Friendly,2
Peru,Costa Rica,3,0,Friendly,3
Romania,Israel,2,0,Friendly,2
Turkey,Moldova,2,0,Friendly,2
Togo,Benin,2,0,Friendly,2
Panama,Jamaica,2,0,Friendly,2
Honduras,Cuba,4,0,Friendly,4
Japan,Uruguay,5,3,Friendly,2
Namibia,Botswana,6,0,African Cup of Nations qualification,6
Morocco,DR Congo,7,0,Friendly,7
Canada,Panama,3,1,FIFA World Cup qualification,2
United States,El Salvador,3,1,Friendly,2
France,Mexico,2,0,Friendly,2
Liechtenstein,Republic of Ireland,0,5,FIFA World Cup qualification,5
Romania,Lithuania,3,0,FIFA World Cup qualification,3
Wales,San Marino,6,0,FIFA World Cup qualification,6
Colombia,Chile,4,1,FIFA World Cup qualification,3
Greece,Bosnia and Herzegovina,3,0,FIFA World Cup qualification,3
Moldova,England,0,3,FIFA World Cup qualification,3
Russia,Cyprus,4,0,FIFA World Cup qualification,4
Slovenia,Denmark,0,2,FIFA World Cup qualification,2
Cambodia,Vietnam,1,3,AFF Championship,2
Laos,Indonesia,1,5,AFF Championship,4
Philippines,Thailand,0,5,AFF Championship,5
Faroe Islands,Spain,2,6,FIFA World Cup qualification,4
Jamaica,Costa Rica,2,0,Friendly,2
Malaysia,Philippines,7,0,AFF Championship,7
Poland,Germany,0,2,Friendly,2
Singapore,Brunei,3,0,AFF Championship,3
Myanmar,Cambodia,5,0,AFF Championship,5
Singapore,Philippines,3,0,AFF Championship,3
Thailand,Brunei,6,0,AFF Championship,6
Myanmar,Vietnam,1,4,AFF Championship,3
Indonesia,Cambodia,3,0,AFF Championship,3
El Salvador,Cuba,5,0,FIFA World Cup qualification,5
Indonesia,Myanmar,6,1,AFF Championship,5
Brunei,Malaysia,0,6,AFF Championship,6
Laos,Myanmar,2,4,AFF Championship,2
Malaysia,Indonesia,3,1,AFF Championship,2
Thailand,Vietnam,4,2,AFF Championship,2
Australia,Ghana,2,0,Simba Tournament,2
Saint Vincent and the Grenadines,Mexico,0,3,FIFA World Cup qualification,3
Jamaica,Honduras,3,0,FIFA World Cup qualification,3
Czech Republic,Malta,6,0,FIFA World Cup qualification,6
South Africa,Australia,2,0,Simba Tournament,2
Qatar,Sri Lanka,3,0,FIFA World Cup qualification,3
Australia,Kenya,4,0,Simba Tournament,4
India,Philippines,2,0,FIFA World Cup qualification,2
Panama,Cuba,1,3,FIFA World Cup qualification,2
Slovakia,Malta,6,0,FIFA World Cup qualification,6
Qatar,Philippines,5,0,FIFA World Cup qualification,5
South Korea,China PR,3,1,Friendly,2
Oman,Mozambique,0,2,Friendly,2
Saudi Arabia,Zambia,1,3,Friendly,2
Philippines,Sri Lanka,0,3,FIFA World Cup qualification,3
Qatar,India,6,0,FIFA World Cup qualification,6
Saudi Arabia,New Zealand,3,0,Friendly,3
Latvia,Scotland,0,2,FIFA World Cup qualification,2
Lithuania,Iceland,2,0,FIFA World Cup qualification,2
Moldova,Italy,1,3,FIFA World Cup qualification,2
Wales,Netherlands,1,3,FIFA World Cup qualification,2
Algeria,Ivory Coast,4,1,African Cup of Nations qualification,3
Faroe Islands,Serbia,1,8,FIFA World Cup qualification,7
Sudan,Zimbabwe,0,3,African Cup of Nations qualification,3
Tunisia,Sierra Leone,2,0,African Cup of Nations qualification,2
Oman,Azerbaijan,2,0,Friendly,2
Bosnia and Herzegovina,Croatia,1,4,FIFA World Cup qualification,3
Albania,Portugal,0,3,FIFA World Cup qualification,3
Armenia,Germany,1,5,FIFA World Cup qualification,4
France,Turkey,4,0,Friendly,4
Iceland,Romania,0,4,FIFA World Cup qualification,4
Republic of Ireland,North Macedonia,3,0,FIFA World Cup qualification,3
Norway,Hungary,3,0,FIFA World Cup qualification,3
San Marino,Belgium,0,3,FIFA World Cup qualification,3
Venezuela,Argentina,2,5,FIFA World Cup qualification,3
Canada,Cuba,2,0,FIFA World Cup qualification,2
Saint Vincent and the Grenadines,Honduras,1,4,FIFA World Cup qualification,3
Canada,Cuba,2,0,FIFA World Cup qualification,2
Brazil,Lithuania,3,1,Friendly,2
Peru,United States,4,1,Friendly,3
Gabon,Burkina Faso,2,0,Friendly,2
Oman,Qatar,0,3,Gulf Cup,3
Saudi Arabia,Bahrain,3,1,Gulf Cup,2
Slovakia,Faroe Islands,3,0,FIFA World Cup qualification,3
Tahiti,Australia,0,6,Oceania Nations Cup,6
Mexico,Saint Vincent and the Grenadines,5,1,FIFA World Cup qualification,4
Australia,Tahiti,5,0,Oceania Nations Cup,5
Lithuania,Indonesia,4,0,Friendly,4
United States,Guatemala,2,0,FIFA World Cup qualification,2
Mexico,Honduras,3,1,FIFA World Cup qualification,2
Costa Rica,Panama,2,0,Friendly,2
Egypt,Namibia,7,1,FIFA World Cup qualification,6
Thailand,Bulgaria,0,4,Friendly,4
Georgia,England,0,2,FIFA World Cup qualification,2
Liechtenstein,North Macedonia,1,11,FIFA World Cup qualification,10
Morocco,Sierra Leone,4,0,FIFA World Cup qualification,4
Netherlands,Wales,7,1,FIFA World Cup qualification,6
Nigeria,Burkina Faso,2,0,FIFA World Cup qualification,2
Costa Rica,Guatemala,3,0,FIFA World Cup qualification,3
Jamaica,Saint Vincent and the Grenadines,5,0,FIFA World Cup qualification,5
Azerbaijan,Hungary,0,3,FIFA World Cup qualification,3
Cyprus,Israel,2,0,FIFA World Cup qualification,2
Guinea,Kenya,3,1,FIFA World Cup qualification,2
Luxembourg,Russia,0,4,FIFA World Cup qualification,4
Peru,Venezuela,4,1,FIFA World Cup qualification,3
Togo,Cameroon,2,4,FIFA World Cup qualification,2
Turkey,San Marino,7,0,FIFA World Cup qualification,7
United States,Trinidad and Tobago,2,0,FIFA World Cup qualification,2
Tonga,Cook Islands,2,0,FIFA World Cup qualification,2
Andorra,Estonia,1,6,Friendly,5
Brazil,Cameroon,2,0,Friendly,2
Spain,Slovakia,4,1,FIFA World Cup qualification,3
Estonia,Indonesia,3,0,Friendly,3
Saudi Arabia,Syria,3,1,Friendly,2
Honduras,Saint Vincent and the Grenadines,11,3,FIFA World Cup qualification,8
Saudi Arabia,Mali,1,3,Friendly,2
United Arab Emirates,Uzbekistan,4,2,Friendly,2
El Salvador,Mexico,1,3,Friendly,2
Kuwait,Mali,4,2,Friendly,2
United Arab Emirates,Uzbekistan,2,0,Friendly,2
South Korea,Colombia,4,1,Friendly,3
Indonesia,Iraq,0,4,Friendly,4
Mali,Burkina Faso,2,0,Friendly,2
Malta,North Macedonia,0,2,Friendly,2
Uganda,Kenya,2,0,CECAFA Cup,2
Saudi Arabia,Indonesia,4,1,Friendly,3
El Salvador,Cuba,3,0,FIFA World Cup qualification,3
Lebanon,Georgia,4,2,Friendly,2
Saudi Arabia,Thailand,6,0,AFC Asian Cup,6
China PR,Uzbekistan,0,2,AFC Asian Cup,2
South Korea,Indonesia,4,2,AFC Asian Cup,2
Thailand,Iran,1,3,AFC Asian Cup,2
Japan,Uzbekistan,4,0,AFC Asian Cup,4
Syria,China PR,0,3,AFC Asian Cup,3
Kuwait,South Korea,2,0,AFC Asian Cup,2
United Arab Emirates,Indonesia,2,0,AFC Asian Cup,2
Iraq,Thailand,4,1,AFC Asian Cup,3
Saudi Arabia,Iran,0,3,AFC Asian Cup,3
Morocco,Nigeria,2,0,King Hassan II Tournament,2
Belgium,Netherlands,0,3,FIFA World Cup qualification,3
Cyprus,Bulgaria,1,3,FIFA World Cup qualification,2
North Macedonia,Romania,0,3,FIFA World Cup qualification,3
Northern Ireland,Albania,2,0,FIFA World Cup qualification,2
Spain,Serbia,2,0,FIFA World Cup qualification,2
El Salvador,Canada,0,2,FIFA World Cup qualification,2
Kenya,Zambia,0,2,Friendly,2
Kuwait,Japan,2,0,AFC Asian Cup,2
Panama,Cuba,3,1,FIFA World Cup qualification,2
Uruguay,Peru,2,0,FIFA World Cup qualification,2
Venezuela,Colombia,0,2,FIFA World Cup qualification,2
South Korea,Iran,2,6,AFC Asian Cup,4
Malta,Spain,0,3,FIFA World Cup qualification,3
Basque Country,Estonia,3,1,Friendly,2
Chile,Armenia,7,0,Friendly,7
Egypt,Belarus,2,0,Friendly,2
Paraguay,Armenia,2,0,Friendly,2
Togo,Ghana,4,0,Friendly,4
Bolivia,Ecuador,2,0,FIFA World Cup qualification,2
Burkina Faso,Guinea,0,2,FIFA World Cup qualification,2
Venezuela,Paraguay,0,2,FIFA World Cup qualification,2
Zimbabwe,Togo,3,0,FIFA World Cup qualification,3
United States,Mexico,0,2,USA Cup,2
Italy,Northern Ireland,2,0,Friendly,2
New Zealand,Norway,0,3,Friendly,3
Portugal,France,0,2,Friendly,2
South Korea,New Zealand,3,1,Friendly,2
Malawi,Zambia,0,2,African Cup of Nations qualification,2
Cameroon,Namibia,4,0,African Cup of Nations qualification,4
Lebanon,Estonia,2,0,Friendly,2
Mozambique,Mauritius,3,0,African Cup of Nations qualification,3
Eswatini,Lesotho,3,1,Friendly,2
Mexico,Ecuador,3,1,Friendly,2
Ecuador,Uruguay,4,0,FIFA World Cup qualification,4
Northern Ireland,Belgium,3,0,Friendly,3
Spain,Malta,4,0,FIFA World Cup qualification,4
Cyprus,Latvia,2,0,Cyprus International Tournament,2
Tonga,Solomon Islands,0,4,FIFA World Cup qualification,4
Thailand,Sweden,1,3,King's Cup,2
Kuwait,Egypt,2,0,Friendly,2
Costa Rica,Venezuela,5,2,Friendly,3
Guyana,French Guiana,2,0,CFU Caribbean Cup qualification,2
China PR,Singapore,3,1,Dunhill Cup,2
Bosnia and Herzegovina,Vietnam,4,0,Dunhill Cup,4
Hong Kong,South Korea,0,2,FIFA World Cup qualification,2
Botswana,Lesotho,1,4,Friendly,3
Malaysia,China PR,0,2,Dunhill Cup,2
Bosnia and Herzegovina,Indonesia,2,0,Dunhill Cup,2
Brazil,Poland,4,2,Friendly,2
Vietnam,Zimbabwe,0,6,Dunhill Cup,6
China PR,Zimbabwe,3,1,Dunhill Cup,2
Azerbaijan,Estonia,0,2,Friendly,2
Botswana,Malawi,1,4,COSAFA Cup qualification,3
Solomon Islands,Tonga,9,0,FIFA World Cup qualification,9
Bosnia and Herzegovina,China PR,0,3,Dunhill Cup,3
Lesotho,Zambia,0,2,COSAFA Cup qualification,2
Mexico,Canada,4,0,FIFA World Cup qualification,4
Saudi Arabia,Syria,3,0,Friendly,3
Thailand,South Korea,1,3,FIFA World Cup qualification,2
Eswatini,Mozambique,0,4,COSAFA Cup qualification,4
Costa Rica,Cameroon,5,0,Friendly,5
Saudi Arabia,Indonesia,2,0,Friendly,2
Thailand,Hong Kong,2,0,FIFA World Cup qualification,2
Cyprus,Greece,0,4,Friendly,4
Saudi Arabia,Indonesia,3,1,Friendly,2
Thailand,Japan,3,1,Friendly,2
Taiwan,Saudi Arabia,0,2,FIFA World Cup qualification,2
Malaysia,Bangladesh,2,0,FIFA World Cup qualification,2
United States,Canada,3,0,FIFA World Cup qualification,3
Austria,Slovenia,0,2,Friendly,2
Bangladesh,Taiwan,1,3,FIFA World Cup qualification,2
Kuwait,Bahrain,3,1,Friendly,2
Malta,Hungary,1,4,Friendly,3
Bangladesh,Saudi Arabia,1,4,FIFA World Cup qualification,3
Malaysia,Taiwan,2,0,FIFA World Cup qualification,2
Azerbaijan,Turkmenistan,3,0,Friendly,3
Bolivia,Jamaica,6,0,Friendly,6
Macau,Japan,0,10,FIFA World Cup qualification,10
Nepal,Japan,0,6,FIFA World Cup qualification,6
Oman,Macau,4,0,FIFA World Cup qualification,4
Saudi Arabia,Bangladesh,3,0,FIFA World Cup qualification,3
England,Mexico,2,0,Friendly,2
Italy,Moldova,3,0,FIFA World Cup qualification,3
Netherlands,San Marino,4,0,FIFA World Cup qualification,4
Romania,Liechtenstein,8,0,FIFA World Cup qualification,8
Saudi Arabia,Malaysia,3,0,FIFA World Cup qualification,3
Scotland,Estonia,2,0,FIFA World Cup qualification,2
United Arab Emirates,Norway,1,4,Friendly,3
China PR,Iraq,0,2,Nehru Cup,2
Georgia,Armenia,7,0,Friendly,7
Luxembourg,Israel,0,3,FIFA World Cup qualification,3
Malta,Slovakia,0,2,FIFA World Cup qualification,2
Saudi Arabia,Taiwan,6,0,FIFA World Cup qualification,6
Brazil,Chile,4,0,Friendly,4
Bulgaria,Cyprus,4,1,FIFA World Cup qualification,3
Dominica,British Virgin Islands,6,1,CFU Caribbean Cup qualification,5
Hungary,Australia,1,3,Friendly,2
Scotland,Austria,2,0,FIFA World Cup qualification,2
Sint Maarten,Anguilla,3,0,CFU Caribbean Cup qualification,3
Trinidad and Tobago,Guyana,3,0,Friendly,3
Uruguay,Venezuela,3,1,FIFA World Cup qualification,2
British Virgin Islands,Anguilla,4,2,CFU Caribbean Cup qualification,2
Grenada,Guyana,5,1,CFU Caribbean Cup qualification,4
Angola,Togo,3,1,FIFA World Cup qualification,2
Congo,South Africa,2,0,FIFA World Cup qualification,2
Dominica,Anguilla,5,0,CFU Caribbean Cup qualification,5
Gabon,Morocco,0,4,FIFA World Cup qualification,4
Guyana,Barbados,0,2,CFU Caribbean Cup qualification,2
Indonesia,Cambodia,8,0,FIFA World Cup qualification,8
Kuwait,Iran,0,2,Friendly,2
Mexico,Jamaica,6,0,FIFA World Cup qualification,6
Honduras,Panama,5,0,UNCAF Cup,5
Thailand,Kuwait,3,1,Friendly,2
Costa Rica,Nicaragua,5,1,UNCAF Cup,4
Honduras,El Salvador,3,0,UNCAF Cup,3
Zambia,Malawi,4,0,COSAFA Cup,4
Jordan,Bahrain,4,1,FIFA World Cup qualification,3
Cameroon,Congo,2,0,Friendly,2
El Salvador,Panama,2,0,UNCAF Cup,2
Guatemala,Nicaragua,6,1,UNCAF Cup,5
China PR,Myanmar,5,0,Friendly,5
Iran,Kenya,3,0,Friendly,3
United Arab Emirates,Bahrain,3,0,FIFA World Cup qualification,3
China PR,South Korea,0,2,Friendly,2
Honduras,Costa Rica,0,4,UNCAF Cup,4
Turkmenistan,Azerbaijan,2,0,Friendly,2
United Arab Emirates,Jordan,2,0,FIFA World Cup qualification,2
Cameroon,Togo,2,0,FIFA World Cup qualification,2
Ghana,Gabon,3,0,FIFA World Cup qualification,3
Lebanon,Libya,2,0,Friendly,2
Tunisia,Liberia,2,0,FIFA World Cup qualification,2
Zambia,Congo,3,0,FIFA World Cup qualification,3
Chile,Venezuela,6,0,FIFA World Cup qualification,6
Slovakia,Iceland,3,1,Friendly,2
Austria,Estonia,2,0,FIFA World Cup qualification,2
Brazil,Mexico,4,0,Friendly,4
Denmark,Slovenia,4,0,FIFA World Cup qualification,4
England,Georgia,2,0,FIFA World Cup qualification,2
Germany,Ukraine,2,0,FIFA World Cup qualification,2
Israel,Cyprus,2,0,FIFA World Cup qualification,2
Italy,Poland,3,0,FIFA World Cup qualification,3
Latvia,Belarus,2,0,FIFA World Cup qualification,2
Liechtenstein,Lithuania,0,2,FIFA World Cup qualification,2
Paraguay,Uruguay,3,1,FIFA World Cup qualification,2
Russia,Luxembourg,3,0,FIFA World Cup qualification,3
San Marino,Netherlands,0,6,FIFA World Cup qualification,6
Turkey,Belgium,1,3,FIFA World Cup qualification,2
Fiji,New Caledonia,5,1,Friendly,4
Aruba,Jamaica,0,6,CFU Caribbean Cup qualification,6
Martinique,Dominica,7,0,CFU Caribbean Cup qualification,7
Tajikistan,Vietnam,4,0,FIFA World Cup qualification,4
Turkmenistan,China PR,1,4,FIFA World Cup qualification,3
Ivory Coast,Senegal,4,1,Friendly,3
Kuwait,Lebanon,2,0,FIFA World Cup qualification,2
Costa Rica,Jamaica,3,1,FIFA World Cup qualification,2
Kazakhstan,Pakistan,3,0,FIFA World Cup qualification,3
Yemen,Cambodia,7,0,FIFA World Cup qualification,7
Estonia,Latvia,1,3,FIFA World Cup qualification,2
Republic of Ireland,Liechtenstein,5,0,FIFA World Cup qualification,5
Pakistan,Iraq,2,6,FIFA World Cup qualification,4
Uzbekistan,Cambodia,6,0,FIFA World Cup qualification,6
Vietnam,China PR,1,3,FIFA World Cup qualification,2
El Salvador,Ecuador,0,2,Friendly,2
South Korea,Hong Kong,4,0,FIFA World Cup qualification,4
Norway,Brazil,4,2,Friendly,2
Burkina Faso,Mali,2,0,Friendly,2
Morocco,Ethiopia,4,0,African Cup of Nations qualification,4
Poland,England,0,2,FIFA World Cup qualification,2
Vietnam,Tajikistan,0,4,FIFA World Cup qualification,4
Zambia,Cameroon,3,0,Friendly,3
Maldives,Iran,0,17,FIFA World Cup qualification,17
England,Italy,2,0,Tournoi de France,2
Kyrgyzstan,Iran,0,7,FIFA World Cup qualification,7
South Africa,Netherlands,0,2,Friendly,2
Syria,Maldives,12,0,FIFA World Cup qualification,12
Kuwait,Singapore,4,0,FIFA World Cup qualification,4
Kyrgyzstan,Maldives,3,0,FIFA World Cup qualification,3
Belgium,San Marino,6,0,FIFA World Cup qualification,6
Georgia,Moldova,2,0,FIFA World Cup qualification,2
Nigeria,Kenya,3,0,FIFA World Cup qualification,3
Portugal,Albania,2,0,FIFA World Cup qualification,2
Argentina,Peru,2,0,FIFA World Cup qualification,2
Bulgaria,Luxembourg,4,0,FIFA World Cup qualification,4
Denmark,Bosnia and Herzegovina,2,0,FIFA World Cup qualification,2
Finland,Azerbaijan,3,0,FIFA World Cup qualification,3
Guinea,Burkina Faso,3,1,FIFA World Cup qualification,2
Latvia,Austria,1,3,FIFA World Cup qualification,2
Russia,Israel,2,0,FIFA World Cup qualification,2
Serbia,Slovakia,2,0,FIFA World Cup qualification,2
South Africa,Zambia,3,0,FIFA World Cup qualification,3
Vietnam,Turkmenistan,0,4,FIFA World Cup qualification,4
Iran,Kyrgyzstan,3,1,FIFA World Cup qualification,2
Maldives,Syria,0,12,FIFA World Cup qualification,12
Australia,Solomon Islands,13,0,FIFA World Cup qualification,13
Iran,Maldives,9,0,FIFA World Cup qualification,9
New Zealand,Papua New Guinea,7,0,FIFA World Cup qualification,7
Pakistan,Kazakhstan,0,7,FIFA World Cup qualification,7
Ghana,Serbia,1,3,Korea Cup,2
South Korea,Egypt,3,1,Korea Cup,2
Australia,Tahiti,5,0,FIFA World Cup qualification,5
Brazil,Costa Rica,5,0,Copa América,5
Maldives,Kyrgyzstan,0,6,FIFA World Cup qualification,6
Argentina,Chile,2,0,Copa América,2
South Korea,Ghana,3,0,Korea Cup,3
Paraguay,Ecuador,0,2,Copa América,2
Poland,Georgia,4,1,FIFA World Cup qualification,3
Bolivia,Peru,2,0,Copa América,2
Fiji,Papua New Guinea,3,1,FIFA World Cup qualification,2
Mozambique,Tanzania,3,0,COSAFA Cup,3
Solomon Islands,Tahiti,4,1,FIFA World Cup qualification,3
Uruguay,Venezuela,2,0,Copa América,2
Colombia,Costa Rica,4,1,Copa América,3
Egypt,Ghana,2,0,Korea Cup,2
Australia,Solomon Islands,6,2,FIFA World Cup qualification,4
New Zealand,Fiji,5,0,FIFA World Cup qualification,5
Peru,Venezuela,2,0,Copa América,2
Australia,Tahiti,2,0,FIFA World Cup qualification,2
Brazil,Colombia,2,0,Copa América,2
Iraq,Pakistan,6,1,FIFA World Cup qualification,5
Uzbekistan,Indonesia,3,0,FIFA World Cup qualification,3
Brazil,Paraguay,2,0,Copa América,2
China PR,Vietnam,4,0,FIFA World Cup qualification,4
Estonia,Andorra,4,1,Friendly,3
Japan,Macau,10,0,FIFA World Cup qualification,10
Lebanon,Kuwait,1,3,FIFA World Cup qualification,2
Mali,Benin,3,1,African Cup of Nations qualification,2
Nepal,Oman,0,6,FIFA World Cup qualification,6
Senegal,Ethiopia,3,0,African Cup of Nations qualification,3
Tajikistan,Turkmenistan,5,0,FIFA World Cup qualification,5
Bolivia,Mexico,3,1,Copa América,2
Japan,Nepal,3,0,FIFA World Cup qualification,3
Latvia,Andorra,4,1,Friendly,3
Macau,Oman,0,2,FIFA World Cup qualification,2
Brazil,Peru,7,0,Copa América,7
Namibia,Malawi,4,1,COSAFA Cup,3
New Zealand,Australia,0,3,FIFA World Cup qualification,3
Bolivia,Brazil,1,3,Copa América,2
Cambodia,Uzbekistan,1,4,FIFA World Cup qualification,3
Jamaica,Cuba,3,0,Friendly,3
Kazakhstan,Iraq,3,1,FIFA World Cup qualification,2
Jersey,Frøya,4,1,Island Games,3
Ynys Môn,Hitra,8,0,Island Games,8
Ynys Môn,Shetland,4,0,Island Games,4
Hitra,Isle of Wight,0,4,Island Games,4
Frøya,Gibraltar,0,4,Island Games,4
Gibraltar,Greenland,5,1,Island Games,4
Jersey,Guernsey,4,0,Island Games,4
Frøya,Hitra,4,1,Island Games,3
Isle of Wight,Guernsey,3,1,Island Games,2
Chile,Colombia,4,1,FIFA World Cup qualification,3
Australia,New Zealand,2,0,FIFA World Cup qualification,2
Antigua and Barbuda,Grenada,1,3,CFU Caribbean Cup,2
Saint Kitts and Nevis,Martinique,2,0,CFU Caribbean Cup,2
Antigua and Barbuda,Jamaica,0,2,CFU Caribbean Cup,2
Saint Kitts and Nevis,Trinidad and Tobago,0,3,CFU Caribbean Cup,3
Egypt,Senegal,2,0,African Cup of Nations qualification,2
Jamaica,Grenada,4,1,CFU Caribbean Cup,3
Mauritius,Mozambique,1,3,African Cup of Nations qualification,2
Togo,Liberia,4,0,African Cup of Nations qualification,4
Trinidad and Tobago,Saint Kitts and Nevis,4,0,CFU Caribbean Cup,4
Argentina,Venezuela,2,0,FIFA World Cup qualification,2
Algeria,Benin,2,0,African Cup of Nations qualification,2
Egypt,Ethiopia,8,1,African Cup of Nations qualification,7
Ivory Coast,Mali,4,2,African Cup of Nations qualification,2
Morocco,Senegal,3,0,African Cup of Nations qualification,3
Estonia,Faroe Islands,0,2,Friendly,2
Hungary,Malta,3,0,Friendly,3
Tunisia,Zambia,3,1,Friendly,2
Tunisia,Nigeria,2,0,Friendly,2
Japan,Brazil,0,3,Friendly,3
Burkina Faso,Kenya,2,4,FIFA World Cup qualification,2
Morocco,Gabon,2,0,FIFA World Cup qualification,2
Zambia,DR Congo,2,0,FIFA World Cup qualification,2
Egypt,Liberia,5,0,FIFA World Cup qualification,5
Ghana,Sierra Leone,0,2,FIFA World Cup qualification,2
Tunisia,Namibia,4,0,FIFA World Cup qualification,4
Bosnia and Herzegovina,Denmark,3,0,FIFA World Cup qualification,3
Colombia,Bolivia,3,0,FIFA World Cup qualification,3
Czech Republic,Faroe Islands,2,0,FIFA World Cup qualification,2
Estonia,Austria,0,3,FIFA World Cup qualification,3
Finland,Norway,0,4,FIFA World Cup qualification,4
Liechtenstein,Iceland,0,4,FIFA World Cup qualification,4
Northern Ireland,Germany,1,3,FIFA World Cup qualification,2
Portugal,Armenia,3,1,FIFA World Cup qualification,2
Romania,North Macedonia,4,2,FIFA World Cup qualification,2
Turkey,Wales,6,4,FIFA World Cup qualification,2
Venezuela,Peru,0,3,FIFA World Cup qualification,3
Lebanon,Iraq,0,2,Friendly,2
South Korea,Tajikistan,4,1,Friendly,3
Uzbekistan,Yemen,5,1,FIFA World Cup qualification,4
Jamaica,Trinidad and Tobago,6,1,Friendly,5
China PR,Kazakhstan,3,0,Friendly,3
United Arab Emirates,Iran,3,1,Friendly,2
Nepal,Pakistan,0,2,SAFF Cup,2
Armenia,Albania,3,0,FIFA World Cup qualification,3
Faroe Islands,Czech Republic,0,2,FIFA World Cup qualification,2
Iceland,Republic of Ireland,2,4,FIFA World Cup qualification,2
South Korea,Kazakhstan,3,0,FIFA World Cup qualification,3
Liechtenstein,Romania,1,8,FIFA World Cup qualification,7
Lithuania,North Macedonia,2,0,FIFA World Cup qualification,2
Netherlands,Belgium,3,1,FIFA World Cup qualification,2
Slovenia,Greece,0,3,FIFA World Cup qualification,3
Sri Lanka,Pakistan,2,0,SAFF Cup,2
India,Bangladesh,3,0,SAFF Cup,3
Japan,Uzbekistan,6,3,FIFA World Cup qualification,3
Luxembourg,Cyprus,1,3,FIFA World Cup qualification,2
Scotland,Belarus,4,1,FIFA World Cup qualification,3
Nepal,Sri Lanka,1,3,SAFF Cup,2
Brazil,Ecuador,4,2,Friendly,2
Denmark,Croatia,3,1,FIFA World Cup qualification,2
England,Moldova,4,0,FIFA World Cup qualification,4
Germany,Armenia,4,0,FIFA World Cup qualification,4
Hungary,Azerbaijan,3,1,FIFA World Cup qualification,2
Norway,Switzerland,5,0,FIFA World Cup qualification,5
Romania,Iceland,4,0,FIFA World Cup qualification,4
San Marino,Turkey,0,5,FIFA World Cup qualification,5
India,Pakistan,2,0,SAFF Cup,2
United Arab Emirates,Kazakhstan,4,0,FIFA World Cup qualification,4
China PR,Iran,2,4,FIFA World Cup qualification,2
India,Maldives,5,1,SAFF Cup,4
El Salvador,Canada,4,1,FIFA World Cup qualification,3
Indonesia,Tanzania,3,1,Friendly,2
Qatar,Kuwait,0,2,FIFA World Cup qualification,2
Indonesia,New Zealand,5,0,Friendly,5
Poland,Lithuania,2,0,Friendly,2
Saudi Arabia,Mali,5,1,Friendly,4
Iran,Qatar,3,0,FIFA World Cup qualification,3
South Korea,United Arab Emirates,3,0,FIFA World Cup qualification,3
Saint Kitts and Nevis,Cuba,0,2,Gold Cup qualification,2
Mexico,El Salvador,5,0,FIFA World Cup qualification,5
Moldova,Poland,0,3,FIFA World Cup qualification,3
Brazil,Morocco,2,0,Friendly,2
Armenia,Ukraine,0,2,FIFA World Cup qualification,2
Austria,Belarus,4,0,FIFA World Cup qualification,4
Cyprus,Luxembourg,2,0,FIFA World Cup qualification,2
Czech Republic,Slovakia,3,0,FIFA World Cup qualification,3
Georgia,Poland,3,0,FIFA World Cup qualification,3
Iceland,Liechtenstein,4,0,FIFA World Cup qualification,4
Malta,Serbia,0,5,FIFA World Cup qualification,5
Russia,Bulgaria,4,2,FIFA World Cup qualification,2
Scotland,Latvia,2,0,FIFA World Cup qualification,2
Slovenia,Croatia,1,3,FIFA World Cup qualification,2
Spain,Faroe Islands,3,1,FIFA World Cup qualification,2
Switzerland,Azerbaijan,5,0,FIFA World Cup qualification,5
Peru,Chile,0,4,FIFA World Cup qualification,4
Iran,China PR,4,1,FIFA World Cup qualification,3
Kazakhstan,United Arab Emirates,3,0,FIFA World Cup qualification,3
Uzbekistan,South Korea,1,5,FIFA World Cup qualification,4
Haiti,Martinique,3,0,Friendly,3
Saint Lucia,Jamaica,1,3,Friendly,2
Uzbekistan,Kazakhstan,4,0,FIFA World Cup qualification,4
Antigua and Barbuda,Jamaica,0,3,Friendly,3
Croatia,Ukraine,2,0,FIFA World Cup qualification,2
Hungary,Serbia,1,7,FIFA World Cup qualification,6
South Korea,Japan,0,2,FIFA World Cup qualification,2
Chile,Guatemala,4,1,Friendly,3
Qatar,Iran,2,0,FIFA World Cup qualification,2
Japan,Kazakhstan,5,1,FIFA World Cup qualification,4
Canada,United States,0,3,FIFA World Cup qualification,3
United Arab Emirates,South Korea,1,3,FIFA World Cup qualification,2
Brazil,Wales,3,0,Friendly,3
Mali,Mauritania,3,1,Friendly,2
England,Cameroon,2,0,Friendly,2
Germany,South Africa,3,0,Friendly,3
Serbia,Hungary,5,0,FIFA World Cup qualification,5
Chile,Bolivia,3,0,FIFA World Cup qualification,3
Costa Rica,Canada,3,1,FIFA World Cup qualification,2
Uruguay,Ecuador,5,3,FIFA World Cup qualification,2
United States,El Salvador,4,2,FIFA World Cup qualification,2
Morocco,Togo,3,0,Friendly,3
Gambia,Cape Verde,3,1,Amílcar Cabral Cup,2
Senegal,Cape Verde,2,0,Amílcar Cabral Cup,2
Guinea,Sierra Leone,3,0,Amílcar Cabral Cup,3
Mali,Guinea-Bissau,6,1,Amílcar Cabral Cup,5
Guinea,Guinea-Bissau,2,0,Amílcar Cabral Cup,2
Mexico,Australia,1,3,Confederations Cup,2
Saudi Arabia,Brazil,0,3,Confederations Cup,3
United Arab Emirates,Uruguay,0,2,Confederations Cup,2
Saudi Arabia,Mexico,0,5,Confederations Cup,5
Martinique,Trinidad and Tobago,3,0,Friendly,3
United Arab Emirates,Czech Republic,1,6,Confederations Cup,5
Egypt,Togo,7,2,Friendly,5
Brazil,Czech Republic,2,0,Confederations Cup,2
Brazil,Australia,6,0,Confederations Cup,6
Egypt,Cameroon,2,0,Friendly,2
Cameroon,Togo,3,1,Friendly,2
Basque Country,Yugoslavia,3,1,Friendly,2
Burkina Faso,Ivory Coast,2,0,Friendly,2
Malawi,Zimbabwe,0,2,Friendly,2
Burkina Faso,Mozambique,4,2,Friendly,2
Gambia,Zambia,0,2,Friendly,2
Lesotho,Zimbabwe,0,2,COSAFA Cup qualification,2
Ghana,Mozambique,3,1,Friendly,2
Costa Rica,Honduras,1,4,Friendly,3
El Salvador,Trinidad and Tobago,2,0,Friendly,2
Turkey,Albania,1,4,Friendly,3
Egypt,South Korea,0,2,King's Cup,2
Italy,Slovakia,3,0,Friendly,3
Tunisia,Serbia,0,3,Friendly,3
Ivory Coast,Mozambique,4,1,Friendly,3
Thailand,South Korea,0,2,King's Cup,2
Tunisia,Guinea,4,1,Friendly,3
Burkina Faso,Namibia,3,1,Friendly,2
Honduras,Trinidad and Tobago,1,3,Gold Cup,2
Togo,Mali,0,4,Friendly,4
United States,Cuba,3,0,Gold Cup,3
Cuba,Costa Rica,2,7,Gold Cup,5
Trinidad and Tobago,Mexico,2,4,Gold Cup,2
Morocco,Niger,3,0,Friendly,3
Mexico,Honduras,2,0,Gold Cup,2
Albania,Georgia,0,3,Malta International Tournament,3
El Salvador,Brazil,0,4,Gold Cup,4
Paraguay,Poland,4,0,Friendly,4
Finland,Slovakia,0,2,Cyprus International Tournament,2
Ghana,Tunisia,2,0,African Cup of Nations,2
Jamaica,El Salvador,2,0,Gold Cup,2
Egypt,Mozambique,2,0,African Cup of Nations,2
Malta,Georgia,1,3,Malta International Tournament,2
England,Chile,0,2,Friendly,2
Morocco,Mozambique,3,0,African Cup of Nations,3
Zambia,Egypt,0,4,African Cup of Nations,4
Australia,Japan,0,3,Friendly,3
Ivory Coast,Angola,5,2,African Cup of Nations,3
South Africa,Namibia,4,1,African Cup of Nations,3
Tunisia,Togo,3,1,African Cup of Nations,2
Zambia,Mozambique,3,1,African Cup of Nations,2
Israel,Turkey,4,0,Friendly,4
Oman,Germany,0,2,Friendly,2
United States,Netherlands,0,2,Friendly,2
Saudi Arabia,Germany,0,3,Friendly,3
Argentina,Serbia,3,1,Friendly,2
Belgium,United States,2,0,Friendly,2
Burkina Faso,Egypt,0,2,African Cup of Nations,2
Israel,Poland,2,0,Friendly,2
South Africa,Egypt,0,2,African Cup of Nations,2
Barbados,Saint Kitts and Nevis,6,2,Friendly,4
Saint Lucia,Saint Kitts and Nevis,2,0,Friendly,2
Japan,Hong Kong,5,1,Dynasty Cup,4
Saint Vincent and the Grenadines,Saint Kitts and Nevis,4,2,Friendly,2
Japan,China PR,0,2,Dynasty Cup,2
Argentina,Bulgaria,2,0,Friendly,2
Haiti,Puerto Rico,4,0,CFU Caribbean Cup qualification,4
Dominican Republic,Puerto Rico,3,1,CFU Caribbean Cup qualification,2
Myanmar,Brunei,4,1,AFF Championship,3
Haiti,Dominican Republic,5,0,CFU Caribbean Cup qualification,5
Myanmar,Laos,3,0,AFF Championship,3
Martinique,Barbados,4,1,CFU Caribbean Cup qualification,3
Malta,Finland,0,2,Friendly,2
Poland,Slovenia,2,0,Friendly,2
Spain,Sweden,4,0,Friendly,4
Singapore,Cambodia,3,0,AFF Championship,3
Saint Kitts and Nevis,British Virgin Islands,4,0,CFU Caribbean Cup qualification,4
Guadeloupe,British Virgin Islands,3,0,CFU Caribbean Cup qualification,3
Dominica,British Virgin Islands,4,1,CFU Caribbean Cup qualification,3
Grenada,Anguilla,14,1,CFU Caribbean Cup qualification,13
Guyana,Anguilla,14,0,CFU Caribbean Cup qualification,14
Zimbabwe,Namibia,5,2,COSAFA Cup,3
Iran,Hungary,0,2,Friendly,2
Austria,United States,0,3,Friendly,3
Croatia,Poland,4,1,Friendly,3
Denmark,Norway,0,2,Friendly,2
England,Portugal,3,0,Friendly,3
Republic of Ireland,Argentina,0,2,Friendly,2
Italy,Paraguay,3,1,Friendly,2
Serbia,South Korea,3,1,Friendly,2
Slovenia,Czech Republic,1,3,Friendly,2
Jersey,Guernsey,2,0,Friendly,2
Estonia,Mexico,0,6,Friendly,6
Cayman Islands,Bermuda,2,0,CFU Caribbean Cup qualification,2
Argentina,Bosnia and Herzegovina,5,0,Friendly,5
Latvia,Israel,1,5,Friendly,4
Cameroon,Burkina Faso,2,0,Friendly,2
Norway,Mexico,5,2,Friendly,3
Mozambique,Zimbabwe,0,2,COSAFA Cup,2
United States,Kuwait,2,0,Friendly,2
Argentina,South Africa,2,0,Friendly,2
Norway,Saudi Arabia,6,0,Friendly,6
Poland,Russia,3,1,Friendly,2
Saint Kitts and Nevis,Trinidad and Tobago,4,1,SKN Football Festival,3
Sweden,Denmark,3,0,Friendly,3
Serbia,Nigeria,3,0,Friendly,3
Germany,Colombia,3,1,Friendly,2
Luxembourg,Cameroon,0,2,Friendly,2
Netherlands,Paraguay,5,1,Friendly,4
Austria,Liechtenstein,6,0,Friendly,6
Andorra,Brazil,0,3,Friendly,3
Belgium,Colombia,2,0,Friendly,2
Croatia,Iran,2,0,Friendly,2
Malta,Wales,0,3,Friendly,3
Spain,Northern Ireland,4,1,Friendly,3
Estonia,Faroe Islands,5,0,UEFA Euro qualification,5
Bulgaria,Algeria,2,0,Friendly,2
Germany,Luxembourg,7,0,Friendly,7
Netherlands,Nigeria,5,1,Friendly,4
Croatia,Australia,7,0,Friendly,7
Romania,Moldova,5,1,Friendly,4
Tunisia,Wales,4,0,Friendly,4
Belarus,Lithuania,5,0,Friendly,5
France,South Africa,3,0,FIFA World Cup,3
South Korea,Mexico,1,3,FIFA World Cup,2
Jamaica,Croatia,1,3,FIFA World Cup,2
England,Tunisia,2,0,FIFA World Cup,2
Germany,United States,2,0,FIFA World Cup,2
Brazil,Morocco,3,0,FIFA World Cup,3
Italy,Cameroon,3,0,FIFA World Cup,3
France,Saudi Arabia,4,0,FIFA World Cup,4
Netherlands,South Korea,5,0,FIFA World Cup,5
Argentina,Jamaica,5,0,FIFA World Cup,5
Scotland,Morocco,0,3,FIFA World Cup,3
Nigeria,Paraguay,1,3,FIFA World Cup,2
Spain,Bulgaria,6,1,FIFA World Cup,5
Estonia,Latvia,0,2,Baltic Cup,2
Germany,Iran,2,0,FIFA World Cup,2
Colombia,England,0,2,FIFA World Cup,2
Latvia,Andorra,2,0,Friendly,2
Brazil,Chile,4,1,FIFA World Cup,3
Thailand,China PR,0,3,Friendly,3
Nigeria,Denmark,1,4,FIFA World Cup,3
Lithuania,Andorra,4,0,Friendly,4
Germany,Croatia,0,3,FIFA World Cup,3
Rwanda,Tanzania,2,0,Friendly,2
Uganda,Tanzania,3,0,Friendly,3
France,Brazil,3,0,FIFA World Cup,3
Lebanon,Palestine,3,1,Arab Cup qualification,2
Syria,Jordan,3,0,Arab Cup qualification,3
Curaçao,Haiti,0,4,CFU Caribbean Cup,4
Jamaica,Cayman Islands,4,0,CFU Caribbean Cup,4
Martinique,Dominica,5,1,CFU Caribbean Cup,4
Lebanon,Jordan,0,2,Arab Cup qualification,2
Antigua and Barbuda,Martinique,5,1,CFU Caribbean Cup,4
Curaçao,Cayman Islands,0,2,CFU Caribbean Cup,2
Senegal,Mali,3,1,Friendly,2
Trinidad and Tobago,Dominica,8,0,CFU Caribbean Cup,8
Trinidad and Tobago,Haiti,4,1,CFU Caribbean Cup,3
Kenya,Djibouti,3,0,African Cup of Nations qualification,3
Libya,Algeria,0,2,African Cup of Nations qualification,2
Palau,Guam,2,15,Friendly,13
Uganda,Rwanda,5,0,African Cup of Nations qualification,5
Equatorial Guinea,Gabon,0,2,African Cup of Nations qualification,2
Mali,Cape Verde,3,0,African Cup of Nations qualification,3
São Tomé and Príncipe,Togo,0,4,African Cup of Nations qualification,4
Guam,Northern Mariana Islands,0,3,Friendly,3
Algeria,Libya,3,0,African Cup of Nations qualification,3
Kenya,Djibouti,9,1,African Cup of Nations qualification,8
Thailand,Uzbekistan,4,1,Friendly,3
Angola,Benin,2,0,African Cup of Nations qualification,2
Gabon,Equatorial Guinea,3,0,African Cup of Nations qualification,3
Liberia,Niger,2,0,African Cup of Nations qualification,2
Poland,Israel,2,0,Friendly,2
Togo,São Tomé and Príncipe,2,0,African Cup of Nations qualification,2
Iceland,Latvia,4,1,Friendly,3
Lithuania,Belarus,0,3,Friendly,3
Ukraine,Georgia,4,0,Friendly,4
Mauritius,Lesotho,3,1,African Cup of Nations qualification,2
Malaysia,Singapore,0,2,AFF Championship,2
Vietnam,Laos,4,1,AFF Championship,3
Indonesia,Philippines,3,0,AFF Championship,3
Indonesia,Myanmar,6,2,AFF Championship,4
Thailand,Philippines,3,1,AFF Championship,2
Singapore,Laos,4,1,AFF Championship,3
Myanmar,Philippines,5,2,AFF Championship,3
Morocco,Senegal,2,0,Friendly,2
Romania,Liechtenstein,7,0,UEFA Euro qualification,7
Tonga,American Samoa,3,0,Oceania Nations Cup qualification,3
Tahiti,Tonga,5,0,Oceania Nations Cup qualification,5
Vietnam,Thailand,3,0,AFF Championship,3
Armenia,Andorra,3,1,UEFA Euro qualification,2
Fiji,New Caledonia,3,0,Oceania Nations Cup qualification,3
Republic of Ireland,Croatia,2,0,UEFA Euro qualification,2
Slovakia,Azerbaijan,3,0,UEFA Euro qualification,3
Solomon Islands,Papua New Guinea,3,1,Oceania Nations Cup qualification,2
Tahiti,Samoa,5,1,Oceania Nations Cup qualification,4
Turkey,Northern Ireland,3,0,UEFA Euro qualification,3
Wales,Italy,0,2,UEFA Euro qualification,2
Bulgaria,Poland,0,3,UEFA Euro qualification,3
Hungary,Portugal,1,3,UEFA Euro qualification,2
North Macedonia,Malta,4,0,UEFA Euro qualification,4
Norway,Latvia,1,3,UEFA Euro qualification,2
Samoa,Tonga,2,0,Oceania Nations Cup qualification,2
Tahiti,American Samoa,12,0,Oceania Nations Cup qualification,12
Cook Islands,Tahiti,0,5,Oceania Nations Cup qualification,5
Samoa,American Samoa,4,0,Oceania Nations Cup qualification,4
Fiji,Papua New Guinea,2,0,Oceania Nations Cup qualification,2
Vanuatu,Solomon Islands,3,1,Oceania Nations Cup qualification,2
Saudi Arabia,Tanzania,8,0,Friendly,8
Syria,Oman,3,0,Friendly,3
Kuwait,North Korea,4,0,Friendly,4
United Arab Emirates,Libya,5,1,Friendly,4
Bahrain,Syria,2,0,Friendly,2
Oman,Zambia,2,0,Friendly,2
Australia,Fiji,3,1,Oceania Nations Cup,2
Kuwait,Syria,4,0,Arab Cup,4
Qatar,Jordan,2,0,Arab Cup,2
Saudi Arabia,Lebanon,4,1,Arab Cup,3
United Arab Emirates,Sudan,4,1,Arab Cup,3
Australia,Cook Islands,16,0,Oceania Nations Cup,16
New Zealand,Vanuatu,8,1,Oceania Nations Cup,7
Fiji,Cook Islands,3,0,Oceania Nations Cup,3
Tahiti,Vanuatu,5,1,Oceania Nations Cup,4
Kuwait,United Arab Emirates,4,1,Arab Cup,3
Qatar,Saudi Arabia,1,3,Arab Cup,2
Australia,Tahiti,4,1,Oceania Nations Cup,3
Morocco,Sierra Leone,3,0,African Cup of Nations qualification,3
Cameroon,Ghana,1,3,African Cup of Nations qualification,2
Gabon,Mauritius,2,0,African Cup of Nations qualification,2
Mozambique,Eritrea,3,1,African Cup of Nations qualification,2
Tahiti,Fiji,2,4,Oceania Nations Cup,2
Togo,Guinea,2,0,African Cup of Nations qualification,2
Andorra,Ukraine,0,2,UEFA Euro qualification,2
Azerbaijan,Hungary,0,4,UEFA Euro qualification,4
Bosnia and Herzegovina,Czech Republic,1,3,UEFA Euro qualification,2
Cyprus,Austria,0,3,UEFA Euro qualification,3
Italy,Switzerland,2,0,UEFA Euro qualification,2
Liechtenstein,Slovakia,0,4,UEFA Euro qualification,4
Malta,Croatia,1,4,UEFA Euro qualification,3
Netherlands,Peru,2,0,Friendly,2
Poland,Luxembourg,3,0,UEFA Euro qualification,3
San Marino,Israel,0,5,UEFA Euro qualification,5
Kuwait,Iran,3,0,Friendly,3
Brazil,Ecuador,5,1,Friendly,4
Czech Republic,Estonia,4,1,UEFA Euro qualification,3
France,Andorra,2,0,UEFA Euro qualification,2
Greece,Georgia,3,0,UEFA Euro qualification,3
Republic of Ireland,Malta,5,0,UEFA Euro qualification,5
Lithuania,Bosnia and Herzegovina,4,2,UEFA Euro qualification,2
Luxembourg,England,0,3,UEFA Euro qualification,3
Moldova,Germany,1,3,UEFA Euro qualification,2
San Marino,Austria,1,4,UEFA Euro qualification,3
Slovakia,Portugal,0,3,UEFA Euro qualification,3
Turkey,Finland,1,3,UEFA Euro qualification,2
Ukraine,Armenia,2,0,UEFA Euro qualification,2
Oman,Burkina Faso,4,2,Friendly,2
Kuwait,Qatar,6,2,Gulf Cup,4
Bahrain,Kuwait,0,2,Gulf Cup,2
Oman,Kuwait,0,5,Gulf Cup,5
Slovakia,Poland,1,3,Friendly,2
Tunisia,Latvia,3,0,Friendly,3
United Arab Emirates,Kuwait,1,4,Gulf Cup,3
El Salvador,Mexico,0,2,Friendly,2
Brazil,Russia,5,1,Friendly,4
England,Czech Republic,2,0,Friendly,2
Georgia,Estonia,3,1,Friendly,2
Hungary,Switzerland,2,0,Friendly,2
Portugal,Israel,2,0,Friendly,2
India,Uzbekistan,0,4,Friendly,4
Guernsey,Kernow,1,6,Friendly,5
Singapore,United Arab Emirates,0,4,Friendly,4
Thailand,Nepal,2,0,Friendly,2
Mali,Ghana,0,2,Friendly,2
British Virgin Islands,Saint Vincent and the Grenadines,0,5,Friendly,5
Basque Country,Uruguay,5,1,Friendly,4
Catalonia,Nigeria,5,0,Friendly,5
Canary Islands,Latvia,4,0,Friendly,4
Israel,Serbia,2,0,Friendly,2
Ivory Coast,Togo,3,1,Friendly,2
Burkina Faso,Mali,4,1,Friendly,3
Israel,Estonia,7,0,Friendly,7
Nigeria,Burundi,2,0,African Cup of Nations qualification,2
Zimbabwe,Malawi,3,0,Friendly,3
Angola,Gabon,3,1,African Cup of Nations qualification,2
Ivory Coast,Namibia,3,0,African Cup of Nations qualification,3
Liberia,Uganda,2,0,African Cup of Nations qualification,2
Martinique,French Guiana,3,1,CFU Caribbean Cup qualification,2
Venezuela,Argentina,0,2,Friendly,2
British Virgin Islands,Montserrat,3,1,CFU Caribbean Cup qualification,2
Slovenia,Switzerland,0,2,Friendly,2
United States,Germany,3,0,Friendly,3
British Virgin Islands,Montserrat,3,0,CFU Caribbean Cup qualification,3
Oman,Slovenia,0,7,Friendly,7
Albania,North Macedonia,2,0,Friendly,2
Cyprus,San Marino,4,0,UEFA Euro qualification,4
England,France,0,2,Friendly,2
Republic of Ireland,Paraguay,2,0,Friendly,2
Malta,Serbia,0,3,UEFA Euro qualification,3
Bulgaria,Egypt,1,3,Lunar New Year Cup,2
Egypt,Mexico,0,3,Lunar New Year Cup,3
Bahamas,Turks and Caicos Islands,3,0,CFU Caribbean Cup qualification,3
Costa Rica,Jamaica,9,0,Friendly,9
Israel,Latvia,2,0,Friendly,2
South Africa,Gabon,4,1,African Cup of Nations qualification,3
Angola,Mauritius,0,2,African Cup of Nations qualification,2
British Virgin Islands,Antigua and Barbuda,0,2,Friendly,2
Ghana,Eritrea,5,0,African Cup of Nations qualification,5
Madagascar,DR Congo,3,1,African Cup of Nations qualification,2
Bulgaria,Slovakia,2,0,Friendly,2
Romania,Estonia,2,0,Friendly,2
Guatemala,Bolivia,0,3,Friendly,3
Jamaica,Paraguay,1,3,Friendly,2
Barbados,Guyana,2,0,CFU Caribbean Cup qualification,2
Bolivia,Paraguay,0,3,Friendly,3
Guatemala,Jamaica,2,4,Friendly,2
Barbados,Antigua and Barbuda,2,0,CFU Caribbean Cup qualification,2
Malta,Moldova,0,2,Friendly,2
Romania,Israel,0,2,Friendly,2
Switzerland,Austria,2,4,Friendly,2
United States,Guatemala,3,1,USA Cup,2
Barbados,Dominica,3,1,CFU Caribbean Cup qualification,2
Costa Rica,Belize,7,0,UNCAF Cup,7
Haiti,Puerto Rico,2,0,CFU Caribbean Cup qualification,2
British Virgin Islands,Puerto Rico,5,0,CFU Caribbean Cup qualification,5
Haiti,Dominican Republic,4,0,CFU Caribbean Cup qualification,4
Honduras,Belize,5,1,UNCAF Cup,4
Dominican Republic,Puerto Rico,2,0,CFU Caribbean Cup qualification,2
Haiti,British Virgin Islands,6,0,CFU Caribbean Cup qualification,6
Honduras,El Salvador,3,1,UNCAF Cup,2
Portugal,Azerbaijan,7,0,UEFA Euro qualification,7
Andorra,Iceland,0,2,UEFA Euro qualification,2
Armenia,Russia,0,3,UEFA Euro qualification,3
Czech Republic,Lithuania,2,0,UEFA Euro qualification,2
England,Poland,3,1,UEFA Euro qualification,2
Greece,Norway,0,2,UEFA Euro qualification,2
Hungary,Liechtenstein,5,0,UEFA Euro qualification,5
Northern Ireland,Germany,0,3,UEFA Euro qualification,3
Spain,Austria,9,0,UEFA Euro qualification,9
Sweden,Luxembourg,2,0,UEFA Euro qualification,2
Turkey,Moldova,2,0,UEFA Euro qualification,2
Costa Rica,El Salvador,4,0,UNCAF Cup,4
Honduras,Guatemala,0,2,UNCAF Cup,2
Israel,Cyprus,3,0,UEFA Euro qualification,3
Trinidad and Tobago,Jamaica,2,0,Friendly,2
France,Armenia,2,0,UEFA Euro qualification,2
Germany,Finland,2,0,UEFA Euro qualification,2
Jamaica,Paraguay,3,0,Friendly,3
Japan,Brazil,0,2,Friendly,2
Liechtenstein,Portugal,0,5,UEFA Euro qualification,5
Luxembourg,Bulgaria,0,2,UEFA Euro qualification,2
Russia,Andorra,6,1,UEFA Euro qualification,5
San Marino,Spain,0,6,UEFA Euro qualification,6
Switzerland,Wales,2,0,UEFA Euro qualification,2
Mali,Burkina Faso,5,2,Friendly,3
Algeria,Liberia,4,1,African Cup of Nations qualification,3
Uganda,Tunisia,0,2,African Cup of Nations qualification,2
Burkina Faso,Burundi,3,1,African Cup of Nations qualification,2
DR Congo,Madagascar,2,0,African Cup of Nations qualification,2
Ivory Coast,Congo,2,0,African Cup of Nations qualification,2
Mozambique,Cameroon,1,6,African Cup of Nations qualification,5
Saint Lucia,Martinique,3,1,CFU Caribbean Cup qualification,2
Paraguay,Colombia,0,2,Friendly,2
Pakistan,Bangladesh,0,4,SAFF Cup,4
Eswatini,Lesotho,4,1,Friendly,3
India,Pakistan,2,0,SAFF Cup,2
Austria,San Marino,7,0,UEFA Euro qualification,7
Georgia,Norway,1,4,UEFA Euro qualification,3
Republic of Ireland,Sweden,2,0,Friendly,2
India,Bangladesh,2,0,SAFF Cup,2
Maldives,Nepal,2,0,SAFF Cup,2
Guernsey,Jersey,2,0,Friendly,2
Curaçao,Grenada,1,3,CFU Caribbean Cup qualification,2
Bermuda,Bahamas,6,0,CFU Caribbean Cup qualification,6
Cuba,Cayman Islands,4,1,CFU Caribbean Cup qualification,3
Spain,Croatia,3,1,Friendly,2
Trinidad and Tobago,South Africa,2,0,Friendly,2
Bermuda,Cayman Islands,4,1,CFU Caribbean Cup qualification,3
Cuba,Bahamas,7,0,CFU Caribbean Cup qualification,7
Cayman Islands,Bahamas,4,1,CFU Caribbean Cup qualification,3
Eswatini,Mozambique,3,1,COSAFA Cup qualification,2
Slovakia,Bulgaria,2,0,Friendly,2
Norway,Jamaica,6,0,Friendly,6
Haiti,Honduras,0,2,Friendly,2
Botswana,Mozambique,0,2,COSAFA Cup qualification,2
Chile,Costa Rica,3,0,Friendly,3
Saint Kitts and Nevis,Antigua and Barbuda,4,1,Friendly,3
Canada,Guatemala,2,0,Friendly,2
Cuba,Haiti,3,1,CFU Caribbean Cup,2
Ecuador,Guatemala,3,1,Friendly,2
Germany,Moldova,6,1,UEFA Euro qualification,5
Poland,Bulgaria,2,0,UEFA Euro qualification,2
Azerbaijan,Liechtenstein,4,0,UEFA Euro qualification,4
Bosnia and Herzegovina,Lithuania,2,0,UEFA Euro qualification,2
Estonia,Czech Republic,0,2,UEFA Euro qualification,2
Finland,Turkey,2,4,UEFA Euro qualification,2
Guam,Micronesia,3,0,Friendly,3
Iceland,Armenia,2,0,UEFA Euro qualification,2
Italy,Wales,4,0,UEFA Euro qualification,4
Jamaica,Guadeloupe,5,1,CFU Caribbean Cup,4
Romania,Hungary,2,0,UEFA Euro qualification,2
South Africa,Mauritius,2,0,African Cup of Nations qualification,2
Spain,San Marino,9,0,UEFA Euro qualification,9
Trinidad and Tobago,Grenada,7,0,CFU Caribbean Cup,7
Ukraine,Andorra,4,0,UEFA Euro qualification,4
Gabon,Angola,3,1,African Cup of Nations qualification,2
Haiti,Saint Kitts and Nevis,2,0,CFU Caribbean Cup,2
Israel,Austria,5,0,UEFA Euro qualification,5
Mali,Congo,3,1,African Cup of Nations qualification,2
Tunisia,Algeria,2,0,African Cup of Nations qualification,2
Brazil,Netherlands,3,1,Friendly,2
Cuba,Saint Kitts and Nevis,2,0,CFU Caribbean Cup,2
Serbia,Malta,4,1,UEFA Euro qualification,3
Portugal,Liechtenstein,8,0,UEFA Euro qualification,8
Romania,Azerbaijan,4,0,UEFA Euro qualification,4
Wales,Denmark,0,2,UEFA Euro qualification,2
Cuba,Jamaica,2,0,CFU Caribbean Cup,2
Guam,Micronesia,4,1,Friendly,3
Trinidad and Tobago,Haiti,6,1,CFU Caribbean Cup,5
Brazil,Poland,2,0,Friendly,2
Egypt,Mexico,0,2,Korea Cup,2
Thailand,Brazil,0,2,Friendly,2
Algeria,Uganda,2,0,African Cup of Nations qualification,2
Congo,Namibia,3,0,African Cup of Nations qualification,3
Liberia,Tunisia,2,0,African Cup of Nations qualification,2
Venezuela,Peru,3,0,Friendly,3
Saudi Arabia,Jordan,2,0,Friendly,2
Peru,Venezuela,3,0,Friendly,3
Brazil,Latvia,3,0,Friendly,3
Gotland,Hitra,12,1,Island Games,11
Isle of Wight,Frøya,6,2,Island Games,4
Greenland,Saare County,4,1,Island Games,3
Gotland,Shetland,3,1,Island Games,2
Hitra,Isle of Man,0,13,Island Games,13
Frøya,Greenland,1,3,Island Games,2
Saare County,Isle of Wight,1,6,Island Games,5
Gibraltar,Jersey,1,5,Island Games,4
Shetland,Hitra,4,1,Island Games,3
Isle of Wight,Greenland,7,2,Island Games,5
Saare County,Frøya,1,4,Island Games,3
Brazil,Venezuela,7,0,Copa América,7
Argentina,Ecuador,3,1,Copa América,2
Guernsey,Frøya,4,2,Island Games,2
Greenland,Rhodes,0,2,Island Games,2
Gotland,Åland Islands,1,4,Island Games,3
Gotland,Greenland,7,2,Island Games,5
Isle of Wight,Ynys Môn,1,3,Island Games,2
Paraguay,Japan,4,0,Copa América,4
Gibraltar,Frøya,5,1,Island Games,4
Isle of Wight,Jersey,2,0,Island Games,2
Chile,Venezuela,3,0,Copa América,3
Malaysia,New Zealand,1,5,Friendly,4
Argentina,Colombia,0,3,Copa América,3
Malawi,Uganda,0,2,Friendly,2
Mexico,Venezuela,3,1,Copa América,2
Uruguay,Argentina,0,2,Copa América,2
Canada,Saudi Arabia,0,2,Friendly,2
Uzbekistan,Malaysia,3,0,Friendly,3
Micronesia,Northern Mariana Islands,7,0,Friendly,7
Mexico,Brazil,0,2,Copa América,2
Jamaica,Saudi Arabia,0,4,Friendly,4
Brazil,Uruguay,3,0,Copa América,3
Jordan,Syria,4,0,Friendly,4
Senegal,Eritrea,6,2,African Cup of Nations qualification,4
Brazil,Germany,4,0,Confederations Cup,4
Rwanda,Djibouti,4,1,CECAFA Cup,3
Ethiopia,Zanzibar,2,0,CECAFA Cup,2
Mexico,Saudi Arabia,5,1,Confederations Cup,4
Burundi,Somalia,3,0,CECAFA Cup,3
El Salvador,Guatemala,0,2,Friendly,2
Germany,New Zealand,2,0,Confederations Cup,2
Egypt,Saudi Arabia,1,5,Confederations Cup,4
Somalia,Uganda,0,2,CECAFA Cup,2
New Zealand,Brazil,0,2,Confederations Cup,2
United States,Germany,2,0,Confederations Cup,2
Brazil,Saudi Arabia,8,2,Confederations Cup,6
Kenya,Sudan,3,0,CECAFA Cup,3
Oman,Kyrgyzstan,3,0,AFC Asian Cup qualification,3
United States,Saudi Arabia,2,0,Confederations Cup,2
Iraq,Oman,2,0,AFC Asian Cup qualification,2
Iraq,Kyrgyzstan,5,1,AFC Asian Cup qualification,4
Senegal,Zimbabwe,2,0,African Cup of Nations qualification,2
Lesotho,Eswatini,0,3,Friendly,3
Zimbabwe,Eritrea,4,0,African Cup of Nations qualification,4
Belarus,Russia,0,2,Friendly,2
Czech Republic,Switzerland,3,0,Friendly,3
Estonia,Armenia,2,0,Friendly,2
Greece,El Salvador,3,1,Friendly,2
Portugal,Andorra,4,0,Friendly,4
Slovenia,Albania,2,0,UEFA Euro qualification,2
Uzbekistan,Azerbaijan,5,1,Friendly,4
Greece,El Salvador,3,0,Friendly,3
Argentina,Brazil,2,0,Friendly,2
Austria,Spain,1,3,UEFA Euro qualification,2
England,Luxembourg,6,0,UEFA Euro qualification,6
Faroe Islands,Estonia,0,2,UEFA Euro qualification,2
Iceland,Andorra,3,0,UEFA Euro qualification,3
Lithuania,Czech Republic,0,4,UEFA Euro qualification,4
Northern Ireland,Turkey,0,3,UEFA Euro qualification,3
Russia,Armenia,2,0,UEFA Euro qualification,2
Slovakia,Romania,1,5,UEFA Euro qualification,4
Serbia,North Macedonia,3,1,UEFA Euro qualification,2
Belgium,Morocco,4,0,Friendly,4
Brazil,Argentina,4,2,Friendly,2
Czech Republic,Bosnia and Herzegovina,3,0,UEFA Euro qualification,3
Germany,Northern Ireland,4,0,UEFA Euro qualification,4
Hungary,Azerbaijan,3,0,UEFA Euro qualification,3
Israel,San Marino,8,0,UEFA Euro qualification,8
North Macedonia,Serbia,2,4,UEFA Euro qualification,2
Norway,Slovenia,4,0,UEFA Euro qualification,4
Slovakia,Liechtenstein,2,0,UEFA Euro qualification,2
Spain,Cyprus,8,0,UEFA Euro qualification,8
Switzerland,Belarus,2,0,UEFA Euro qualification,2
Uruguay,Venezuela,2,0,Friendly,2
Bermuda,Cayman Islands,3,1,Friendly,2
Dominica,Saint Lucia,0,2,Friendly,2
Cayman Islands,Bahamas,4,0,Friendly,4
Greece,Albania,2,0,UEFA Euro qualification,2
Andorra,Armenia,0,3,UEFA Euro qualification,3
Czech Republic,Faroe Islands,2,0,UEFA Euro qualification,2
Estonia,Bosnia and Herzegovina,1,4,UEFA Euro qualification,3
Finland,Northern Ireland,4,1,UEFA Euro qualification,3
Liechtenstein,Romania,0,3,UEFA Euro qualification,3
Portugal,Hungary,3,0,UEFA Euro qualification,3
Scotland,Lithuania,3,0,UEFA Euro qualification,3
Slovenia,Greece,0,3,UEFA Euro qualification,3
Sweden,Poland,2,0,UEFA Euro qualification,2
Wales,Switzerland,0,2,UEFA Euro qualification,2
Austria,Cyprus,3,1,UEFA Euro qualification,2
Bulgaria,Luxembourg,3,0,UEFA Euro qualification,3
Cuba,El Salvador,3,1,Gold Cup qualification,2
Spain,Israel,3,0,UEFA Euro qualification,3
Hong Kong,Cambodia,4,1,AFC Asian Cup qualification,3
Cayman Islands,Jamaica,1,4,Friendly,3
Cambodia,Indonesia,1,5,AFC Asian Cup qualification,4
United Arab Emirates,Turkmenistan,3,1,United Arab Emirates Friendship Tournament,2
Iraq,Turkmenistan,3,0,United Arab Emirates Friendship Tournament,3
Gabon,Equatorial Guinea,4,0,UNIFFAC Cup,4
Central African Republic,Chad,4,1,UNIFFAC Cup,3
Chad,São Tomé and Príncipe,5,0,UNIFFAC Cup,5
Congo,Chad,0,2,UNIFFAC Cup,2
Equatorial Guinea,Central African Republic,4,2,UNIFFAC Cup,2
Central African Republic,São Tomé and Príncipe,3,0,UNIFFAC Cup,3
France,Croatia,3,0,Friendly,3
Greece,Nigeria,2,0,Friendly,2
Israel,Denmark,0,5,UEFA Euro qualification,5
Italy,Belgium,1,3,Friendly,2
Scotland,England,0,2,UEFA Euro qualification,2
Central African Republic,Congo,4,2,UNIFFAC Cup,2
Gabon,Chad,2,0,UNIFFAC Cup,2
Indonesia,Hong Kong,3,1,AFC Asian Cup qualification,2
São Tomé and Príncipe,Equatorial Guinea,2,0,UNIFFAC Cup,2
Denmark,Israel,3,0,UEFA Euro qualification,3
Spain,Argentina,0,2,Friendly,2
Indonesia,Cambodia,9,2,AFC Asian Cup qualification,7
Senegal,Ivory Coast,3,0,Friendly,3
Bangladesh,Uzbekistan,0,6,AFC Asian Cup qualification,6
Gabon,Nigeria,0,2,Friendly,2
United Arab Emirates,India,3,1,AFC Asian Cup qualification,2
Sri Lanka,Uzbekistan,0,6,AFC Asian Cup qualification,6
United Arab Emirates,Bangladesh,3,0,AFC Asian Cup qualification,3
Costa Rica,Slovakia,4,0,Friendly,4
Sri Lanka,Bangladesh,1,3,AFC Asian Cup qualification,2
Sri Lanka,India,1,3,AFC Asian Cup qualification,2
United Arab Emirates,Sri Lanka,6,0,AFC Asian Cup qualification,6
Senegal,Gambia,3,0,Friendly,3
Saint Lucia,Dominica,3,1,Friendly,2
Greece,Moldova,2,0,Friendly,2
Honduras,Zambia,7,1,Friendly,6
Tunisia,Ghana,2,0,Friendly,2
Libya,Gabon,2,0,Friendly,2
Ivory Coast,Burkina Faso,3,1,Friendly,2
Libya,Togo,2,0,Friendly,2
Basque Country,Nigeria,5,1,Friendly,4
Tunisia,Togo,7,0,Friendly,7
Ivory Coast,Egypt,2,0,Friendly,2
Bermuda,Canada,0,2,Friendly,2
Ghana,Tunisia,2,0,Friendly,2
Panama,Guatemala,2,0,Friendly,2
Malta,Qatar,2,0,Friendly,2
China PR,Philippines,8,0,AFC Asian Cup qualification,8
Egypt,Zambia,2,0,African Cup of Nations,2
Nigeria,Tunisia,4,2,African Cup of Nations,2
South Africa,Gabon,3,1,African Cup of Nations,2
Vietnam,Guam,11,0,AFC Asian Cup qualification,11
Qatar,Bosnia and Herzegovina,2,0,Friendly,2
Burkina Faso,Senegal,1,3,African Cup of Nations,2
China PR,Guam,19,0,AFC Asian Cup qualification,19
Spain,Poland,3,0,Friendly,3
Vietnam,Philippines,3,0,AFC Asian Cup qualification,3
Ghana,Togo,2,0,African Cup of Nations,2
Cameroon,Ivory Coast,3,0,African Cup of Nations,3
United States Virgin Islands,Saint Lucia,0,9,Friendly,9
Algeria,Gabon,3,1,African Cup of Nations,2
Philippines,Guam,2,0,AFC Asian Cup qualification,2
Vietnam,China PR,0,2,AFC Asian Cup qualification,2
United States Virgin Islands,Saint Lucia,0,2,Friendly,2
Ghana,Ivory Coast,0,2,African Cup of Nations,2
Kuwait,Syria,4,0,Friendly,4
Egypt,Burkina Faso,4,2,African Cup of Nations,2
Romania,Latvia,2,0,Cyprus International Tournament,2
Nigeria,Morocco,2,0,African Cup of Nations,2
Albania,Andorra,3,0,Malta International Tournament,3
Malta,Azerbaijan,3,0,Malta International Tournament,3
Singapore,Malaysia,3,1,Friendly,2
Syria,North Korea,5,1,Friendly,4
Honduras,El Salvador,5,1,Friendly,4
Cameroon,Tunisia,3,0,African Cup of Nations,3
Kuwait,Turkmenistan,6,1,AFC Asian Cup qualification,5
Nepal,Yemen,0,3,AFC Asian Cup qualification,3
Nigeria,South Africa,2,0,African Cup of Nations,2
Nepal,Bhutan,3,0,AFC Asian Cup qualification,3
United States,Haiti,3,0,Gold Cup,3
Mexico,Trinidad and Tobago,4,0,Gold Cup,4
Singapore,Japan,0,3,AFC Asian Cup qualification,3
Jamaica,Honduras,0,2,Gold Cup,2
Kuwait,Bhutan,20,0,AFC Asian Cup qualification,20
Turkmenistan,Nepal,5,0,AFC Asian Cup qualification,5
Chile,Slovakia,0,2,Friendly,2
Malaysia,Maldives,2,0,Friendly,2
Trinidad and Tobago,Guatemala,4,2,Gold Cup,2
Bhutan,Turkmenistan,0,8,AFC Asian Cup qualification,8
Honduras,Colombia,2,0,Gold Cup,2
Japan,Brunei,9,0,AFC Asian Cup qualification,9
Kuwait,Yemen,2,0,AFC Asian Cup qualification,2
Panama,El Salvador,4,1,Friendly,3
Malaysia,Maldives,3,0,Friendly,3
Kuwait,Nepal,5,0,AFC Asian Cup qualification,5
Yemen,Bhutan,11,2,AFC Asian Cup qualification,9
Dominica,Antigua and Barbuda,2,0,Friendly,2
Honduras,Peru,3,5,Gold Cup,2
Oman,Switzerland,1,4,Friendly,3
Macau,Japan,0,3,AFC Asian Cup qualification,3
Estonia,Finland,2,4,King's Cup,2
Greece,Austria,4,1,Friendly,3
Hungary,Australia,0,3,Friendly,3
Israel,Russia,4,1,Friendly,3
Luxembourg,Northern Ireland,1,3,Friendly,2
Oman,Slovenia,0,4,Friendly,4
Thailand,Brazil,0,7,King's Cup,7
Turkey,Norway,0,2,Friendly,2
British Virgin Islands,Anguilla,5,0,Friendly,5
Canada,Colombia,2,0,Gold Cup,2
Thailand,Finland,5,1,King's Cup,4
El Salvador,Panama,3,1,Friendly,2
Uzbekistan,Mongolia,8,1,Friendly,7
Zambia,Lesotho,2,0,Friendly,2
Honduras,Nicaragua,3,0,FIFA World Cup qualification,3
Trinidad and Tobago,Curaçao,5,0,FIFA World Cup qualification,5
Anguilla,Bahamas,1,3,FIFA World Cup qualification,2
Bolivia,Haiti,9,2,Friendly,7
British Virgin Islands,Bermuda,1,5,FIFA World Cup qualification,4
Cuba,Cayman Islands,4,0,FIFA World Cup qualification,4
Dominican Republic,Montserrat,3,0,FIFA World Cup qualification,3
El Salvador,Belize,5,0,FIFA World Cup qualification,5
Saint Vincent and the Grenadines,United States Virgin Islands,9,0,FIFA World Cup qualification,9
Ecuador,Honduras,1,3,Friendly,2
Cuba,Nicaragua,4,0,Friendly,4
Qatar,Sudan,3,0,Friendly,3
Aruba,Puerto Rico,4,2,FIFA World Cup qualification,2
Haiti,Dominica,4,0,FIFA World Cup qualification,4
Saint Kitts and Nevis,Turks and Caicos Islands,8,0,FIFA World Cup qualification,8
Bermuda,British Virgin Islands,9,0,FIFA World Cup qualification,9
Botswana,Eswatini,3,0,Friendly,3
Dominica,Haiti,1,3,FIFA World Cup qualification,2
Montserrat,Dominican Republic,1,3,FIFA World Cup qualification,2
Nicaragua,Panama,0,2,FIFA World Cup qualification,2
United States Virgin Islands,Saint Vincent and the Grenadines,1,5,FIFA World Cup qualification,4
Saint Kitts and Nevis,Turks and Caicos Islands,6,0,FIFA World Cup qualification,6
Chile,Honduras,5,2,Friendly,3
Malaysia,Taiwan,3,0,AFC Asian Cup qualification,3
Zambia,Botswana,3,0,COSAFA Cup,3
Thailand,Taiwan,2,0,AFC Asian Cup qualification,2
El Salvador,Haiti,3,1,Friendly,2
Malta,Northern Ireland,0,3,Friendly,3
Argentina,Chile,4,1,FIFA World Cup qualification,3
Bulgaria,Belarus,4,1,Friendly,3
Czech Republic,Australia,3,1,Friendly,2
Ecuador,Venezuela,2,0,FIFA World Cup qualification,2
Greece,Romania,2,0,Friendly,2
Peru,Paraguay,2,0,FIFA World Cup qualification,2
Scotland,France,0,2,Friendly,2
Spain,Italy,2,0,Friendly,2
Maldives,Iran,0,8,AFC Asian Cup qualification,8
Aruba,Barbados,1,3,FIFA World Cup qualification,2
Haiti,Bahamas,9,0,FIFA World Cup qualification,9
Bahrain,Maldives,4,1,AFC Asian Cup qualification,3
Palestine,Pakistan,2,0,AFC Asian Cup qualification,2
Qatar,Kazakhstan,3,1,AFC Asian Cup qualification,2
Trinidad and Tobago,Dominican Republic,3,0,FIFA World Cup qualification,3
Palestine,Jordan,1,5,AFC Asian Cup qualification,4
Qatar,Pakistan,5,0,AFC Asian Cup qualification,5
Thailand,North Korea,5,3,AFC Asian Cup qualification,2
Myanmar,Mongolia,2,0,AFC Asian Cup qualification,2
South Korea,Laos,9,0,AFC Asian Cup qualification,9
Kazakhstan,Palestine,2,0,AFC Asian Cup qualification,2
Malaysia,North Korea,1,4,AFC Asian Cup qualification,3
Pakistan,Jordan,0,5,AFC Asian Cup qualification,5
Myanmar,Laos,4,0,AFC Asian Cup qualification,4
South Korea,Mongolia,6,0,AFC Asian Cup qualification,6
Fiji,Papua New Guinea,5,0,Oceania Nations Cup qualification,5
Madagascar,Gabon,2,0,FIFA World Cup qualification,2
Malawi,Kenya,2,0,FIFA World Cup qualification,2
New Caledonia,Solomon Islands,4,2,Oceania Nations Cup qualification,2
Pakistan,Kazakhstan,0,4,AFC Asian Cup qualification,4
São Tomé and Príncipe,Sierra Leone,2,0,FIFA World Cup qualification,2
Equatorial Guinea,Congo,1,3,FIFA World Cup qualification,2
Iran,Bahrain,3,0,AFC Asian Cup qualification,3
South Korea,Myanmar,4,0,AFC Asian Cup qualification,4
Lesotho,South Africa,0,2,FIFA World Cup qualification,2
Libya,Mali,3,0,FIFA World Cup qualification,3
Egypt,Mauritius,2,0,FIFA World Cup qualification,2
Fiji,Vanuatu,4,1,Oceania Nations Cup qualification,3
New Caledonia,Papua New Guinea,6,1,Oceania Nations Cup qualification,5
Iran,Maldives,3,0,AFC Asian Cup qualification,3
Solomon Islands,Papua New Guinea,4,2,Oceania Nations Cup qualification,2
Vanuatu,New Caledonia,6,0,Oceania Nations Cup qualification,6
Papua New Guinea,Vanuatu,1,4,Oceania Nations Cup qualification,3
Bahamas,Haiti,0,4,FIFA World Cup qualification,4
Barbados,Aruba,4,0,FIFA World Cup qualification,4
Belize,El Salvador,1,3,FIFA World Cup qualification,2
Cameroon,Somalia,3,0,FIFA World Cup qualification,3
Algeria,Cape Verde,2,0,FIFA World Cup qualification,2
Morocco,Gambia,2,0,FIFA World Cup qualification,2
Namibia,Seychelles,3,0,FIFA World Cup qualification,3
Nigeria,Eritrea,4,0,FIFA World Cup qualification,4
Sierra Leone,São Tomé and Príncipe,4,0,FIFA World Cup qualification,4
Tunisia,Mauritania,3,0,FIFA World Cup qualification,3
Angola,Eswatini,7,1,FIFA World Cup qualification,6
Burkina Faso,Ethiopia,3,0,FIFA World Cup qualification,3
Cameroon,Somalia,3,0,FIFA World Cup qualification,3
DR Congo,Djibouti,9,1,FIFA World Cup qualification,8
Egypt,Mauritius,4,2,FIFA World Cup qualification,2
Guinea,Uganda,3,0,FIFA World Cup qualification,3
Ivory Coast,Rwanda,2,0,FIFA World Cup qualification,2
Mali,Libya,3,1,FIFA World Cup qualification,2
Togo,Guinea-Bissau,3,0,FIFA World Cup qualification,3
Zimbabwe,Central African Republic,3,1,FIFA World Cup qualification,2
Andorra,Belarus,2,0,Friendly,2
Czech Republic,Israel,4,1,Friendly,3
Italy,Portugal,2,0,Friendly,2
Norway,Belgium,0,2,Friendly,2
Romania,Cyprus,2,0,Friendly,2
Russia,United States,2,0,Friendly,2
Venezuela,Argentina,0,4,FIFA World Cup qualification,4
South Africa,Mauritius,3,0,COSAFA Cup,3
Dominica,Sint Maarten,3,1,Friendly,2
Guinea,Mali,3,1,Amílcar Cabral Cup,2
Honduras,Panama,3,1,FIFA World Cup qualification,2
Trinidad and Tobago,Haiti,3,1,FIFA World Cup qualification,2
Cape Verde,Guinea,2,0,Amílcar Cabral Cup,2
Guinea,Mali,2,0,Amílcar Cabral Cup,2
Thailand,Uzbekistan,2,0,Friendly,2
Saint Vincent and the Grenadines,Antigua and Barbuda,4,0,FIFA World Cup qualification,4
Panama,Nicaragua,4,0,FIFA World Cup qualification,4
Jordan,Kyrgyzstan,2,0,WAFF Championship,2
Wales,Brazil,0,3,Friendly,3
Iran,Kazakhstan,3,0,WAFF Championship,3
China PR,Serbia,0,2,Friendly,2
Kyrgyzstan,Lebanon,0,2,WAFF Championship,2
Algeria,Burkina Faso,2,0,Friendly,2
Kazakhstan,Syria,0,4,WAFF Championship,4
Iraq,Kyrgyzstan,4,0,WAFF Championship,4
Jamaica,Colombia,0,3,Friendly,3
Norway,Slovakia,2,0,Friendly,2
Croatia,France,0,2,Friendly,2
England,Ukraine,2,0,Friendly,2
Venezuela,Panama,3,1,Friendly,2
Botswana,Mozambique,2,0,Friendly,2
Jordan,Iraq,1,4,WAFF Championship,3
Portugal,Wales,3,0,Friendly,3
Singapore,Qatar,1,5,Friendly,4
Algeria,Guinea,4,0,Friendly,4
Honduras,Haiti,4,0,FIFA World Cup qualification,4
Paraguay,Ecuador,3,1,FIFA World Cup qualification,2
Slovenia,Saudi Arabia,2,0,Friendly,2
United States,South Africa,4,0,USA Cup,4
Colombia,Venezuela,3,0,FIFA World Cup qualification,3
Estonia,Belarus,2,0,Friendly,2
Netherlands,Poland,3,1,Friendly,2
Jamaica,Japan,0,4,King Hassan II Tournament,4
Morocco,France,1,5,King Hassan II Tournament,4
Nigeria,Malawi,4,1,Friendly,3
Germany,Liechtenstein,8,2,Friendly,6
Mexico,South Africa,4,2,USA Cup,2
Iran,North Macedonia,3,1,Friendly,2
France,Denmark,3,0,UEFA Euro,3
Tunisia,Senegal,4,1,Friendly,3
United States,Mexico,3,0,USA Cup,3
New Caledonia,Vanuatu,3,1,Friendly,2
Belgium,Italy,0,2,UEFA Euro,2
Bolivia,Slovakia,0,2,Kirin Cup,2
Netherlands,Denmark,3,0,UEFA Euro,3
Egypt,Ghana,2,0,Friendly,2
Haiti,Honduras,1,3,FIFA World Cup qualification,2
Madagascar,DR Congo,3,0,FIFA World Cup qualification,3
Nigeria,Sierra Leone,2,0,FIFA World Cup qualification,2
Guatemala,Antigua and Barbuda,8,1,FIFA World Cup qualification,7
Japan,Bolivia,2,0,Kirin Cup,2
Libya,Cameroon,0,3,FIFA World Cup qualification,3
South Africa,Eswatini,2,0,COSAFA Cup,2
Sudan,Liberia,2,0,FIFA World Cup qualification,2
Australia,Cook Islands,17,0,Oceania Nations Cup,17
Belgium,Turkey,0,2,UEFA Euro,2
Tahiti,New Zealand,0,2,Oceania Nations Cup,2
Portugal,Germany,3,0,UEFA Euro,3
Denmark,Czech Republic,0,2,UEFA Euro,2
New Zealand,Vanuatu,3,1,Oceania Nations Cup,2
Solomon Islands,Cook Islands,5,1,Oceania Nations Cup,4
Gabon,Congo,0,2,Friendly,2
Solomon Islands,Australia,0,6,Oceania Nations Cup,6
Italy,Romania,2,0,UEFA Euro,2
Turkey,Portugal,0,2,UEFA Euro,2
Ecuador,Panama,5,0,Friendly,5
Lebanon,Kuwait,3,1,Friendly,2
Netherlands,Serbia,6,1,UEFA Euro,5
New Zealand,Solomon Islands,2,0,Oceania Nations Cup,2
Australia,New Zealand,2,0,Oceania Nations Cup,2
Venezuela,Bolivia,4,2,FIFA World Cup qualification,2
Chile,Paraguay,3,1,FIFA World Cup qualification,2
Colombia,Argentina,1,3,FIFA World Cup qualification,2
Djibouti,Burundi,1,3,African Cup of Nations qualification,2
Costa Rica,Panama,5,1,Friendly,4
El Salvador,Mexico,0,3,Friendly,3
Uganda,Malawi,3,1,African Cup of Nations qualification,2
Benin,Namibia,2,0,African Cup of Nations qualification,2
Sudan,Eritrea,5,1,African Cup of Nations qualification,4
Guatemala,Haiti,4,1,Friendly,3
Rwanda,Uganda,2,0,Friendly,2
Trinidad and Tobago,Cuba,4,1,Friendly,3
Jamaica,Barbados,5,0,Friendly,5
Trinidad and Tobago,Jamaica,2,4,Friendly,2
Zambia,Togo,2,0,FIFA World Cup qualification,2
Cameroon,Angola,3,0,FIFA World Cup qualification,3
DR Congo,Congo,2,0,FIFA World Cup qualification,2
Ghana,Sierra Leone,5,0,FIFA World Cup qualification,5
Zimbabwe,South Africa,0,2,FIFA World Cup qualification,2
Libya,Chad,3,1,African Cup of Nations qualification,2
Gabon,São Tomé and Príncipe,4,1,African Cup of Nations qualification,3
Kenya,Eswatini,3,0,African Cup of Nations qualification,3
Namibia,Benin,8,2,African Cup of Nations qualification,6
Zambia,Ethiopia,2,0,African Cup of Nations qualification,2
Angola,Equatorial Guinea,4,1,African Cup of Nations qualification,3
Canada,Trinidad and Tobago,0,2,FIFA World Cup qualification,2
DR Congo,Central African Republic,2,0,African Cup of Nations qualification,2
El Salvador,Honduras,2,5,FIFA World Cup qualification,3
Guinea,Gambia,2,0,African Cup of Nations qualification,2
Ivory Coast,Niger,6,0,African Cup of Nations qualification,6
Uruguay,Venezuela,3,1,FIFA World Cup qualification,2
Argentina,Ecuador,2,0,FIFA World Cup qualification,2
Guatemala,Barbados,2,0,FIFA World Cup qualification,2
El Salvador,Saint Vincent and the Grenadines,7,1,FIFA World Cup qualification,6
Jamaica,Honduras,3,1,FIFA World Cup qualification,2
Venezuela,Chile,0,2,FIFA World Cup qualification,2
Brazil,Argentina,3,1,FIFA World Cup qualification,2
Iceland,Malta,5,0,Friendly,5
Lebanon,Oman,3,1,Friendly,2
Malaysia,Myanmar,6,0,Friendly,6
Costa Rica,Venezuela,1,5,Friendly,4
Bahrain,Jordan,0,2,Friendly,2
Lesotho,Zimbabwe,0,3,COSAFA Cup,3
Chile,Brazil,3,0,FIFA World Cup qualification,3
Malaysia,Oman,2,0,Merdeka Tournament,2
Mexico,Canada,2,0,FIFA World Cup qualification,2
Honduras,Saint Vincent and the Grenadines,6,0,FIFA World Cup qualification,6
Bosnia and Herzegovina,Turkey,2,0,Friendly,2
Bulgaria,Belgium,1,3,Friendly,2
Ecuador,Bolivia,2,0,FIFA World Cup qualification,2
Faroe Islands,Denmark,0,2,Nordic Championship,2
Finland,Norway,3,1,Nordic Championship,2
Germany,Spain,4,1,Friendly,3
Japan,United Arab Emirates,3,1,Friendly,2
Portugal,Lithuania,5,1,Friendly,4
Trinidad and Tobago,Panama,6,0,FIFA World Cup qualification,6
United States,Barbados,7,0,FIFA World Cup qualification,7
Malaysia,New Zealand,0,2,Merdeka Tournament,2
Haiti,Honduras,0,4,Friendly,4
Sierra Leone,Togo,2,0,African Cup of Nations qualification,2
Cayman Islands,Jamaica,0,6,Friendly,6
Zimbabwe,Lesotho,3,0,COSAFA Cup,3
Indonesia,Myanmar,4,1,Friendly,3
Iraq,Taiwan,3,0,Friendly,3
Austria,Iran,5,1,Friendly,4
China PR,Thailand,3,1,Friendly,2
Gabon,Morocco,2,0,African Cup of Nations qualification,2
Germany,Greece,2,0,FIFA World Cup qualification,2
Honduras,El Salvador,5,0,FIFA World Cup qualification,5
Iraq,Uzbekistan,2,0,Friendly,2
Nigeria,Namibia,4,0,African Cup of Nations qualification,4
Paraguay,Venezuela,3,0,FIFA World Cup qualification,3
Turkey,Moldova,2,0,FIFA World Cup qualification,2
Uganda,Guinea,3,1,African Cup of Nations qualification,2
Ukraine,Poland,1,3,FIFA World Cup qualification,2
Jamaica,Saint Vincent and the Grenadines,2,0,FIFA World Cup qualification,2
Brazil,Bolivia,5,0,FIFA World Cup qualification,5
China PR,Iraq,4,1,Friendly,3
Costa Rica,Barbados,3,0,FIFA World Cup qualification,3
Estonia,Portugal,1,3,FIFA World Cup qualification,2
Indonesia,Iraq,3,0,Friendly,3
Israel,Liechtenstein,2,0,FIFA World Cup qualification,2
Liberia,Mauritius,4,0,African Cup of Nations qualification,4
Luxembourg,Serbia,0,2,FIFA World Cup qualification,2
Mexico,Panama,7,1,FIFA World Cup qualification,6
Slovakia,North Macedonia,2,0,FIFA World Cup qualification,2
Thailand,Uzbekistan,4,2,Friendly,2
Togo,Sierra Leone,2,0,African Cup of Nations qualification,2
Trinidad and Tobago,Canada,4,0,FIFA World Cup qualification,4
Uruguay,Ecuador,4,0,FIFA World Cup qualification,4
Mexico,Ecuador,2,0,Friendly,2
Saudi Arabia,Syria,3,0,Friendly,3
Cayman Islands,Turks and Caicos Islands,3,0,Friendly,3
Saudi Arabia,United Arab Emirates,6,1,Friendly,5
China PR,Saudi Arabia,0,2,Friendly,2
North Macedonia,Azerbaijan,3,0,FIFA World Cup qualification,3
Australia,South Korea,2,4,United Arab Emirates Friendship Tournament,2
Bulgaria,Malta,3,0,FIFA World Cup qualification,3
Colombia,Paraguay,0,2,FIFA World Cup qualification,2
Cyprus,Netherlands,0,4,FIFA World Cup qualification,4
Czech Republic,Iceland,4,0,FIFA World Cup qualification,4
Italy,Romania,3,0,FIFA World Cup qualification,3
Latvia,Belgium,0,4,FIFA World Cup qualification,4
Lithuania,Georgia,0,4,FIFA World Cup qualification,4
Poland,Belarus,3,1,FIFA World Cup qualification,2
San Marino,Scotland,0,2,FIFA World Cup qualification,2
Spain,Israel,2,0,FIFA World Cup qualification,2
Switzerland,Faroe Islands,5,1,FIFA World Cup qualification,4
Tunisia,Gabon,4,2,African Cup of Nations qualification,2
Barbados,Guatemala,1,3,FIFA World Cup qualification,2
Mexico,Trinidad and Tobago,7,0,FIFA World Cup qualification,7
Qatar,Thailand,3,1,Friendly,2
Togo,Uganda,3,0,African Cup of Nations qualification,3
Uzbekistan,Turkmenistan,3,0,Friendly,3
Venezuela,Brazil,0,6,FIFA World Cup qualification,6
Albania,Greece,2,0,FIFA World Cup qualification,2
Republic of Ireland,Estonia,2,0,FIFA World Cup qualification,2
Israel,Bosnia and Herzegovina,3,1,FIFA World Cup qualification,2
Italy,Georgia,2,0,FIFA World Cup qualification,2
Lithuania,Hungary,1,6,FIFA World Cup qualification,5
Netherlands,Portugal,0,2,FIFA World Cup qualification,2
Russia,Luxembourg,3,0,FIFA World Cup qualification,3
Iraq,Thailand,2,0,AFC Asian Cup,2
Lebanon,Iran,0,4,AFC Asian Cup,4
Malaysia,Cambodia,2,0,Friendly,2
Saudi Arabia,Japan,1,4,AFC Asian Cup,3
Kenya,Tanzania,3,0,Friendly,3
China PR,Indonesia,4,0,AFC Asian Cup,4
Japan,Uzbekistan,8,1,AFC Asian Cup,7
South Korea,Indonesia,3,0,AFC Asian Cup,3
Saudi Arabia,Uzbekistan,5,0,AFC Asian Cup,5
China PR,Qatar,3,1,AFC Asian Cup,2
Malaysia,Sri Lanka,2,0,Friendly,2
Japan,Iraq,4,1,AFC Asian Cup,3
Malaysia,Sri Lanka,3,1,Friendly,2
United States,Mexico,2,0,Friendly,2
Singapore,Sri Lanka,4,0,Friendly,4
Oman,Yemen,4,0,Friendly,4
Zambia,Rwanda,0,2,Friendly,2
Oman,Yemen,4,0,Friendly,4
Indonesia,Philippines,3,0,AFF Championship,3
Thailand,Myanmar,3,1,AFF Championship,2
Cambodia,Vietnam,0,6,AFF Championship,6
Laos,Malaysia,0,5,AFF Championship,5
Myanmar,Philippines,3,0,AFF Championship,3
Singapore,Laos,3,0,AFF Championship,3
Thailand,Indonesia,4,1,AFF Championship,3
Cambodia,Laos,3,0,AFF Championship,3
Myanmar,Indonesia,0,5,AFF Championship,5
Thailand,Philippines,2,0,AFF Championship,2
Laos,Vietnam,0,5,AFF Championship,5
Saint Vincent and the Grenadines,Honduras,0,7,FIFA World Cup qualification,7
Albania,Malta,3,0,Friendly,3
Barbados,United States,0,4,FIFA World Cup qualification,4
Chile,Argentina,0,2,FIFA World Cup qualification,2
Cyprus,Andorra,5,0,FIFA World Cup qualification,5
El Salvador,Jamaica,2,0,FIFA World Cup qualification,2
Greece,Slovakia,0,2,Friendly,2
Republic of Ireland,Finland,3,0,Friendly,3
Paraguay,Peru,5,1,FIFA World Cup qualification,4
Scotland,Australia,0,2,Friendly,2
Turkey,France,0,4,Friendly,4
Thailand,Malaysia,2,0,AFF Championship,2
Thailand,Indonesia,4,1,AFF Championship,3
Vietnam,Malaysia,0,3,AFF Championship,3
Djibouti,Burundi,2,4,CECAFA Cup,2
Uganda,Somalia,6,0,CECAFA Cup,6
Iran,Guam,19,0,FIFA World Cup qualification,19
Ethiopia,Djibouti,4,2,CECAFA Cup,2
Tajikistan,Guam,16,0,FIFA World Cup qualification,16
Uganda,Djibouti,7,0,CECAFA Cup,7
Iran,Tajikistan,2,0,FIFA World Cup qualification,2
Uganda,Rwanda,3,1,CECAFA Cup,2
Mexico,Argentina,0,2,Friendly,2
Catalonia,Lithuania,5,0,Friendly,5
Andalusia,Morocco,2,0,Friendly,2
Costa Rica,Guatemala,5,2,FIFA World Cup qualification,3
Angola,Lesotho,2,0,Friendly,2
Egypt,Zambia,3,1,Friendly,2
Bosnia and Herzegovina,Bangladesh,2,0,Millennium Cup,2
Uzbekistan,Bahrain,5,0,Millennium Cup,5
India,Iceland,0,3,Millennium Cup,3
Egypt,Libya,4,0,African Cup of Nations qualification,4
Liberia,Congo,5,1,African Cup of Nations qualification,4
Romania,Hong Kong,4,2,Millennium Cup,2
Chile,Bahrain,2,0,Millennium Cup,2
Bangladesh,Serbia,1,4,Millennium Cup,3
Hong Kong,Jordan,0,2,Millennium Cup,2
Chile,Uzbekistan,2,0,Millennium Cup,2
Israel,Uzbekistan,2,0,Friendly,2
Kuwait,Syria,2,0,Friendly,2
Iran,China PR,4,0,Cup of Ancient Civilizations,4
Chile,Iceland,2,0,Millennium Cup,2
Ivory Coast,Sudan,2,0,African Cup of Nations qualification,2
Serbia,Romania,2,0,Millennium Cup,2
Burkina Faso,Mali,0,2,Friendly,2
Mexico,Bulgaria,0,2,Friendly,2
Benin,Cameroon,1,3,Friendly,2
Bosnia and Herzegovina,Serbia,0,2,Millennium Cup,2
Nigeria,Sudan,3,0,FIFA World Cup qualification,3
Angola,Libya,3,1,FIFA World Cup qualification,2
Ghana,Liberia,1,3,FIFA World Cup qualification,2
Madagascar,Ivory Coast,1,3,FIFA World Cup qualification,2
Togo,Cameroon,0,2,FIFA World Cup qualification,2
Grenada,Trinidad and Tobago,0,2,Friendly,2
Jordan,North Korea,0,2,Friendly,2
Thailand,Kyrgyzstan,3,1,Friendly,2
Saudi Arabia,Uganda,3,1,Friendly,2
Fiji,Malaysia,4,1,Friendly,3
Saint Martin,Montserrat,3,1,CFU Caribbean Cup qualification,2
Fiji,Malaysia,2,0,Friendly,2
Anguilla,Montserrat,4,1,CFU Caribbean Cup qualification,3
Saudi Arabia,Mongolia,6,0,FIFA World Cup qualification,6
Kyrgyzstan,Kuwait,0,3,FIFA World Cup qualification,3
Saudi Arabia,Bangladesh,3,0,FIFA World Cup qualification,3
Saint Martin,Anguilla,3,1,CFU Caribbean Cup qualification,2
Thailand,Sweden,1,4,King's Cup,3
United Arab Emirates,South Korea,1,4,United Arab Emirates Friendship Tournament,3
Armenia,Uzbekistan,2,0,Friendly,2
Mongolia,Bangladesh,0,3,FIFA World Cup qualification,3
Saudi Arabia,Vietnam,5,0,FIFA World Cup qualification,5
Thailand,Qatar,1,3,King's Cup,2
Thailand,China PR,1,5,King's Cup,4
Bangladesh,Vietnam,0,4,FIFA World Cup qualification,4
Saudi Arabia,Mongolia,6,0,FIFA World Cup qualification,6
China PR,Sweden,0,3,King's Cup,3
Saudi Arabia,Bangladesh,6,0,FIFA World Cup qualification,6
Thailand,Qatar,2,0,King's Cup,2
Vietnam,Mongolia,4,0,FIFA World Cup qualification,4
Saudi Arabia,Vietnam,4,0,FIFA World Cup qualification,4
Saint Kitts and Nevis,Saint Lucia,2,0,Friendly,2
Oman,Finland,0,2,Friendly,2
Martinique,Saint Lucia,4,2,Friendly,2
Bahrain,Singapore,2,0,FIFA World Cup qualification,2
Kuwait,Kyrgyzstan,2,0,FIFA World Cup qualification,2
Cayman Islands,Trinidad and Tobago,0,3,Friendly,3
Oman,Maldives,5,0,Friendly,5
Tunisia,DR Congo,6,0,FIFA World Cup qualification,6
Oman,Maldives,2,0,Friendly,2
Belgium,San Marino,10,1,FIFA World Cup qualification,9
England,Spain,3,0,Friendly,3
Jordan,Bulgaria,0,2,Friendly,2
Liechtenstein,Latvia,0,2,Friendly,2
Lithuania,Romania,0,3,Cyprus International Tournament,3
Malta,Sweden,0,3,Friendly,3
Northern Ireland,Norway,0,4,Friendly,4
Portugal,Andorra,3,0,FIFA World Cup qualification,3
Slovenia,Uruguay,0,2,Friendly,2
Switzerland,Poland,0,4,Friendly,4
United States,Mexico,2,0,FIFA World Cup qualification,2
Qatar,Malaysia,5,1,FIFA World Cup qualification,4
Hong Kong,Malaysia,0,2,FIFA World Cup qualification,2
Senegal,Namibia,4,0,FIFA World Cup qualification,4
Sierra Leone,Sudan,0,2,FIFA World Cup qualification,2
Zambia,Libya,2,0,FIFA World Cup qualification,2
Botswana,Mozambique,1,3,Friendly,2
Egypt,Algeria,5,2,FIFA World Cup qualification,3
Hong Kong,Qatar,0,2,FIFA World Cup qualification,2
Zimbabwe,Malawi,2,0,FIFA World Cup qualification,2
Grenada,Dominica,8,3,Windward Islands Tournament,5
Saint Lucia,Saint Vincent and the Grenadines,0,2,Windward Islands Tournament,2
Dominica,Saint Vincent and the Grenadines,0,2,Windward Islands Tournament,2
Gabon,Mali,2,0,Friendly,2
Honduras,Chile,3,1,Friendly,2
Libya,Egypt,2,0,African Cup of Nations qualification,2
Andorra,Netherlands,0,5,FIFA World Cup qualification,5
British Virgin Islands,United States Virgin Islands,2,0,Friendly,2
Croatia,Latvia,4,1,FIFA World Cup qualification,3
Cyprus,Republic of Ireland,0,4,FIFA World Cup qualification,4
France,Japan,5,0,Friendly,5
Luxembourg,Faroe Islands,0,2,FIFA World Cup qualification,2
Malta,Denmark,0,5,FIFA World Cup qualification,5
Morocco,Tunisia,2,0,African Cup of Nations qualification,2
Romania,Italy,0,2,FIFA World Cup qualification,2
Senegal,Uganda,3,0,African Cup of Nations qualification,3
South Africa,Mauritius,3,0,African Cup of Nations qualification,3
Spain,Liechtenstein,5,0,FIFA World Cup qualification,5
Trinidad and Tobago,Guatemala,3,1,Friendly,2
Costa Rica,Trinidad and Tobago,3,0,FIFA World Cup qualification,3
Angola,Burkina Faso,2,0,African Cup of Nations qualification,2
Ghana,DR Congo,3,0,African Cup of Nations qualification,3
Mexico,Jamaica,4,0,FIFA World Cup qualification,4
Qatar,Hong Kong,3,0,FIFA World Cup qualification,3
Colombia,Bolivia,2,0,FIFA World Cup qualification,2
Peru,Chile,3,1,FIFA World Cup qualification,2
Albania,England,1,3,FIFA World Cup qualification,2
Andorra,Republic of Ireland,0,3,FIFA World Cup qualification,3
Argentina,Venezuela,5,0,FIFA World Cup qualification,5
Georgia,Romania,0,2,FIFA World Cup qualification,2
Greece,Germany,2,4,FIFA World Cup qualification,2
Italy,Lithuania,4,0,FIFA World Cup qualification,4
Liechtenstein,Bosnia and Herzegovina,0,3,FIFA World Cup qualification,3
Martinique,Guadeloupe,4,1,Friendly,3
Moldova,Sweden,0,2,FIFA World Cup qualification,2
Poland,Armenia,4,0,FIFA World Cup qualification,4
Scotland,San Marino,4,0,FIFA World Cup qualification,4
Slovakia,Azerbaijan,3,1,FIFA World Cup qualification,2
Switzerland,Luxembourg,5,0,FIFA World Cup qualification,5
Maldives,Cambodia,6,0,FIFA World Cup qualification,6
Cuba,Dominica,3,1,CFU Caribbean Cup qualification,2
Guyana,Saint Martin,2,0,CFU Caribbean Cup qualification,2
Suriname,Aruba,5,0,CFU Caribbean Cup qualification,5
Grenada,Aruba,4,2,CFU Caribbean Cup qualification,2
Guyana,Dominica,2,0,CFU Caribbean Cup qualification,2
Martinique,British Virgin Islands,6,0,CFU Caribbean Cup qualification,6
Brunei,Yemen,0,5,FIFA World Cup qualification,5
Fiji,American Samoa,13,0,FIFA World Cup qualification,13
Barbados,Aruba,5,2,CFU Caribbean Cup qualification,3
Guyana,Cuba,0,3,CFU Caribbean Cup qualification,3
Indonesia,Maldives,5,0,FIFA World Cup qualification,5
Mali,Liberia,3,0,Friendly,3
Suriname,Grenada,3,1,CFU Caribbean Cup qualification,2
American Samoa,Samoa,0,8,FIFA World Cup qualification,8
Australia,Tonga,22,0,FIFA World Cup qualification,22
Haiti,United States Virgin Islands,12,1,CFU Caribbean Cup qualification,11
Australia,American Samoa,31,0,FIFA World Cup qualification,31
Samoa,Fiji,1,6,FIFA World Cup qualification,5
Guadeloupe,United States Virgin Islands,11,0,CFU Caribbean Cup qualification,11
Iraq,Macau,8,0,FIFA World Cup qualification,8
Nepal,Kazakhstan,0,6,FIFA World Cup qualification,6
American Samoa,Tonga,0,5,FIFA World Cup qualification,5
Australia,Fiji,2,0,FIFA World Cup qualification,2
Brunei,United Arab Emirates,0,12,FIFA World Cup qualification,12
Haiti,Guadeloupe,2,0,CFU Caribbean Cup qualification,2
Iraq,Nepal,9,1,FIFA World Cup qualification,8
Kazakhstan,Macau,3,0,FIFA World Cup qualification,3
Saint Lucia,United States Virgin Islands,14,1,CFU Caribbean Cup qualification,13
Australia,Samoa,11,0,FIFA World Cup qualification,11
Nepal,Macau,4,1,FIFA World Cup qualification,3
Tonga,Fiji,1,8,FIFA World Cup qualification,7
Burkina Faso,Malawi,4,2,FIFA World Cup qualification,2
Kazakhstan,Nepal,4,0,FIFA World Cup qualification,4
Macau,Iraq,0,5,FIFA World Cup qualification,5
Morocco,Namibia,3,0,FIFA World Cup qualification,3
Senegal,Algeria,3,0,FIFA World Cup qualification,3
China PR,Maldives,10,1,FIFA World Cup qualification,9
Indonesia,Cambodia,6,0,FIFA World Cup qualification,6
Ivory Coast,Congo,2,0,FIFA World Cup qualification,2
Liberia,Sudan,2,0,FIFA World Cup qualification,2
Iraq,Nepal,4,2,FIFA World Cup qualification,2
Kazakhstan,Macau,5,0,FIFA World Cup qualification,5
Turkmenistan,Jordan,2,0,FIFA World Cup qualification,2
Uzbekistan,Taiwan,7,0,FIFA World Cup qualification,7
Belize,Nicaragua,2,0,Friendly,2
Egypt,Canada,3,0,Friendly,3
Panama,Haiti,2,0,Friendly,2
Austria,Liechtenstein,2,0,FIFA World Cup qualification,2
Denmark,Slovenia,3,0,Friendly,3
France,Portugal,4,0,Friendly,4
Republic of Ireland,Andorra,3,1,FIFA World Cup qualification,2
Lebanon,Philippines,3,0,Friendly,3
Macau,Nepal,1,6,FIFA World Cup qualification,5
Malta,Iceland,1,4,FIFA World Cup qualification,3
Netherlands,Cyprus,4,0,FIFA World Cup qualification,4
Switzerland,Sweden,0,2,Friendly,2
Turkey,Albania,0,2,Friendly,2
Taiwan,Jordan,0,2,FIFA World Cup qualification,2
Taiwan,Turkmenistan,0,5,FIFA World Cup qualification,5
Bangladesh,Bhutan,3,1,Friendly,2
Congo,Madagascar,2,0,FIFA World Cup qualification,2
Cambodia,Indonesia,0,2,FIFA World Cup qualification,2
Mozambique,South Africa,0,3,COSAFA Cup,3
Oman,Laos,12,0,FIFA World Cup qualification,12
Syria,Philippines,12,0,FIFA World Cup qualification,12
Jordan,Taiwan,6,0,FIFA World Cup qualification,6
Turkmenistan,Uzbekistan,2,5,FIFA World Cup qualification,3
Oman,Laos,7,0,FIFA World Cup qualification,7
Syria,Philippines,5,1,FIFA World Cup qualification,4
United Arab Emirates,Brunei,4,0,FIFA World Cup qualification,4
Madagascar,Tunisia,0,2,FIFA World Cup qualification,2
Nigeria,Liberia,2,0,FIFA World Cup qualification,2
Saint Kitts and Nevis,Puerto Rico,2,0,Friendly,2
Taiwan,Uzbekistan,0,4,FIFA World Cup qualification,4
Angola,Cameroon,2,0,FIFA World Cup qualification,2
Cambodia,China PR,0,4,FIFA World Cup qualification,4
Maldives,Indonesia,0,2,FIFA World Cup qualification,2
Guernsey,Jersey,4,1,Friendly,3
Oman,Philippines,7,0,FIFA World Cup qualification,7
Syria,Laos,11,0,FIFA World Cup qualification,11
Trinidad and Tobago,Grenada,5,3,Friendly,2
Oman,Philippines,2,0,FIFA World Cup qualification,2
Syria,Laos,9,0,FIFA World Cup qualification,9
China PR,Indonesia,5,1,FIFA World Cup qualification,4
Lebanon,Pakistan,6,0,FIFA World Cup qualification,6
Thailand,Sri Lanka,4,2,FIFA World Cup qualification,2
Lebanon,Sri Lanka,4,0,FIFA World Cup qualification,4
Thailand,Pakistan,3,0,FIFA World Cup qualification,3
Trinidad and Tobago,Barbados,5,0,CFU Caribbean Cup,5
Haiti,Saint Kitts and Nevis,7,2,CFU Caribbean Cup,5
Martinique,Barbados,3,1,CFU Caribbean Cup,2
Andalusia,Iraq,3,1,Friendly,2
Laos,Philippines,2,0,FIFA World Cup qualification,2
China PR,Cambodia,3,1,FIFA World Cup qualification,2
India,Brunei,5,0,FIFA World Cup qualification,5
Suriname,Saint Kitts and Nevis,0,4,CFU Caribbean Cup,4
Haiti,Martinique,5,0,CFU Caribbean Cup,5
Singapore,New Zealand,3,0,Friendly,3
Trinidad and Tobago,Cuba,2,0,CFU Caribbean Cup,2
Costa Rica,Belize,4,0,UNCAF Cup,4
El Salvador,Nicaragua,3,0,UNCAF Cup,3
England,Mexico,4,0,Friendly,4
Honduras,Nicaragua,10,2,UNCAF Cup,8
Oman,Syria,2,0,FIFA World Cup qualification,2
Trinidad and Tobago,Haiti,3,0,CFU Caribbean Cup,3
Pakistan,Lebanon,1,8,FIFA World Cup qualification,7
Thailand,Sri Lanka,3,0,FIFA World Cup qualification,3
Indonesia,China PR,0,2,FIFA World Cup qualification,2
Panama,Nicaragua,6,0,UNCAF Cup,6
Sri Lanka,Lebanon,0,5,FIFA World Cup qualification,5
Thailand,Pakistan,6,0,FIFA World Cup qualification,6
Germany,Slovakia,2,0,Friendly,2
South Korea,France,0,5,Confederations Cup,5
Mexico,Australia,0,2,Confederations Cup,2
Sri Lanka,Pakistan,3,1,FIFA World Cup qualification,2
Brazil,Cameroon,2,0,Confederations Cup,2
Japan,Canada,3,0,Confederations Cup,3
Guatemala,Costa Rica,2,0,UNCAF Cup,2
Belgium,Latvia,3,1,FIFA World Cup qualification,2
Croatia,San Marino,4,0,FIFA World Cup qualification,4
Estonia,Netherlands,2,4,FIFA World Cup qualification,2
Iceland,Malta,3,0,FIFA World Cup qualification,3
Japan,Cameroon,2,0,Confederations Cup,2
Liechtenstein,Israel,0,3,FIFA World Cup qualification,3
Romania,Hungary,2,0,FIFA World Cup qualification,2
Slovenia,Luxembourg,2,0,FIFA World Cup qualification,2
Spain,Bosnia and Herzegovina,4,1,FIFA World Cup qualification,3
Sweden,Slovakia,2,0,FIFA World Cup qualification,2
Turkey,Azerbaijan,3,0,FIFA World Cup qualification,3
Uganda,Togo,0,3,African Cup of Nations qualification,3
Argentina,Colombia,3,0,FIFA World Cup qualification,3
Bolivia,Venezuela,5,0,FIFA World Cup qualification,5
France,Mexico,4,0,Confederations Cup,4
Guatemala,Panama,3,1,UNCAF Cup,2
Libya,Ivory Coast,0,3,African Cup of Nations qualification,3
Cameroon,Canada,2,0,Confederations Cup,2
Solomon Islands,Cook Islands,9,1,FIFA World Cup qualification,8
Vanuatu,Tahiti,1,6,FIFA World Cup qualification,5
Albania,Germany,0,2,FIFA World Cup qualification,2
Azerbaijan,Slovakia,2,0,FIFA World Cup qualification,2
Cook Islands,Vanuatu,1,8,FIFA World Cup qualification,7
Czech Republic,Northern Ireland,3,1,FIFA World Cup qualification,2
Estonia,Republic of Ireland,0,2,FIFA World Cup qualification,2
Faroe Islands,Serbia,0,6,FIFA World Cup qualification,6
Greece,England,0,2,FIFA World Cup qualification,2
Hungary,Georgia,4,1,FIFA World Cup qualification,3
New Zealand,Tahiti,5,0,FIFA World Cup qualification,5
Portugal,Cyprus,6,0,FIFA World Cup qualification,6
San Marino,Belgium,1,4,FIFA World Cup qualification,3
Sweden,Moldova,6,0,FIFA World Cup qualification,6
New Zealand,Cook Islands,2,0,FIFA World Cup qualification,2
Vanuatu,Solomon Islands,2,7,FIFA World Cup qualification,5
Jamaica,Cuba,4,1,Friendly,3
Cook Islands,Tahiti,0,6,FIFA World Cup qualification,6
New Zealand,Solomon Islands,5,1,FIFA World Cup qualification,4
New Zealand,Vanuatu,7,0,FIFA World Cup qualification,7
Tahiti,Solomon Islands,2,0,FIFA World Cup qualification,2
Namibia,Nigeria,0,2,African Cup of Nations qualification,2
Trinidad and Tobago,Honduras,2,4,FIFA World Cup qualification,2
Honduras,Mexico,3,1,FIFA World Cup qualification,2
New Zealand,Australia,0,2,FIFA World Cup qualification,2
United States,Trinidad and Tobago,2,0,FIFA World Cup qualification,2
Malaysia,Bahrain,2,4,Merdeka Tournament,2
Malaysia,Slovakia,0,2,Merdeka Tournament,2
Bermuda,Trinidad and Tobago,0,5,Friendly,5
Australia,New Zealand,4,1,FIFA World Cup qualification,3
Bahrain,Slovakia,2,0,Merdeka Tournament,2
Bahrain,Uzbekistan,0,2,Merdeka Tournament,2
Paraguay,Serbia,2,0,Kirin Cup,2
Greenland,Tibet,4,1,Friendly,3
Namibia,Algeria,0,4,FIFA World Cup qualification,4
Cameroon,Togo,2,0,FIFA World Cup qualification,2
Ivory Coast,Madagascar,6,0,FIFA World Cup qualification,6
Japan,Paraguay,2,0,Kirin Cup,2
Sudan,Nigeria,0,4,FIFA World Cup qualification,4
Tunisia,Congo,6,0,FIFA World Cup qualification,6
Latvia,Estonia,3,1,Baltic Cup,2
Estonia,Lithuania,2,5,Baltic Cup,3
Latvia,Lithuania,4,1,Baltic Cup,3
Ynys Môn,Saare County,4,1,Island Games,3
Jersey,Orkney,12,0,Island Games,12
Isle of Man,Falkland Islands,9,0,Island Games,9
Orkney,Gibraltar,0,2,Island Games,2
Greenland,Rhodes,0,2,Island Games,2
Guernsey,Falkland Islands,3,0,Island Games,3
Singapore,Saudi Arabia,0,3,Friendly,3
Rhodes,Isle of Wight,1,4,Island Games,3
Colombia,Venezuela,2,0,Copa América,2
Ecuador,Chile,1,4,Copa América,3
Greenland,Falkland Islands,4,0,Island Games,4
Isle of Man,Rhodes,1,3,Island Games,2
Gibraltar,Shetland,2,0,Island Games,2
Egypt,Namibia,8,2,FIFA World Cup qualification,6
Orkney,Falkland Islands,1,4,Island Games,3
Greenland,Saare County,2,0,Island Games,2
Gibraltar,Rhodes,2,0,Island Games,2
Isle of Wight,Jersey,0,2,Island Games,2
South Africa,Malawi,2,0,FIFA World Cup qualification,2
Brazil,Peru,2,0,Copa América,2
DR Congo,Tunisia,0,3,FIFA World Cup qualification,3
Togo,Libya,2,0,FIFA World Cup qualification,2
Honduras,Bolivia,2,0,Copa América,2
Colombia,Chile,2,0,Copa América,2
Ecuador,Venezuela,4,0,Copa América,4
Brazil,Paraguay,3,1,Copa América,2
Bolivia,Costa Rica,0,4,Copa América,4
Malaysia,Saudi Arabia,0,4,Friendly,4
Namibia,Senegal,0,5,FIFA World Cup qualification,5
Chile,Mexico,0,2,Copa América,2
Brazil,Honduras,0,2,Copa América,2
Colombia,Peru,3,0,Copa América,3
Colombia,Honduras,2,0,Copa América,2
Libya,Zambia,2,4,FIFA World Cup qualification,2
Saint Kitts and Nevis,Martinique,4,2,SKN Football Festival,2
Nigeria,Ghana,3,0,FIFA World Cup qualification,3
Sudan,Sierra Leone,3,0,FIFA World Cup qualification,3
Grenada,Jamaica,2,0,Friendly,2
China PR,Trinidad and Tobago,3,0,Friendly,3
Iran,Oman,5,2,Friendly,3
Brazil,Panama,5,0,Friendly,5
Iran,Bosnia and Herzegovina,4,0,Friendly,4
Singapore,Thailand,0,5,Friendly,5
Venezuela,Uruguay,2,0,FIFA World Cup qualification,2
Bosnia and Herzegovina,Malta,2,0,Friendly,2
Brazil,Paraguay,2,0,FIFA World Cup qualification,2
Czech Republic,South Korea,5,0,Friendly,5
Ecuador,Argentina,0,2,FIFA World Cup qualification,2
England,Netherlands,0,2,Friendly,2
Finland,Belgium,4,1,Friendly,3
Hungary,Germany,2,5,Friendly,3
Japan,Australia,3,0,Friendly,3
Luxembourg,Georgia,0,3,Friendly,3
Portugal,Moldova,3,0,Friendly,3
Serbia,Faroe Islands,2,0,FIFA World Cup qualification,2
Sweden,South Africa,3,0,Friendly,3
Iraq,Thailand,4,0,FIFA World Cup qualification,4
United Arab Emirates,Uzbekistan,4,1,FIFA World Cup qualification,3
Bahrain,Iraq,2,0,FIFA World Cup qualification,2
Iran,Saudi Arabia,2,0,FIFA World Cup qualification,2
China PR,United Arab Emirates,3,0,FIFA World Cup qualification,3
Malawi,Zimbabwe,0,2,COSAFA Cup,2
Oman,China PR,0,2,FIFA World Cup qualification,2
United Arab Emirates,Qatar,0,2,FIFA World Cup qualification,2
Albania,Finland,0,2,FIFA World Cup qualification,2
Andorra,Portugal,1,7,FIFA World Cup qualification,6
Belarus,Ukraine,0,2,FIFA World Cup qualification,2
Georgia,Hungary,3,1,FIFA World Cup qualification,2
Germany,England,1,5,FIFA World Cup qualification,4
Iceland,Czech Republic,3,1,FIFA World Cup qualification,2
Malta,Bulgaria,0,2,FIFA World Cup qualification,2
Moldova,Azerbaijan,2,0,FIFA World Cup qualification,2
Poland,Norway,3,0,FIFA World Cup qualification,3
Spain,Austria,4,0,FIFA World Cup qualification,4
Trinidad and Tobago,Costa Rica,0,2,FIFA World Cup qualification,2
Chile,Venezuela,0,2,FIFA World Cup qualification,2
Peru,Uruguay,0,2,FIFA World Cup qualification,2
Austria,Bosnia and Herzegovina,2,0,FIFA World Cup qualification,2
Belarus,Poland,4,1,FIFA World Cup qualification,3
Belgium,Scotland,2,0,FIFA World Cup qualification,2
Bulgaria,Denmark,0,2,FIFA World Cup qualification,2
Costa Rica,United States,2,0,FIFA World Cup qualification,2
Cyprus,Portugal,1,3,FIFA World Cup qualification,2
England,Albania,2,0,FIFA World Cup qualification,2
Faroe Islands,Russia,0,3,FIFA World Cup qualification,3
Finland,Greece,5,1,FIFA World Cup qualification,4
Georgia,Lithuania,2,0,FIFA World Cup qualification,2
Hungary,Romania,0,2,FIFA World Cup qualification,2
Liechtenstein,Spain,0,2,FIFA World Cup qualification,2
Luxembourg,Switzerland,0,3,FIFA World Cup qualification,3
Mexico,Trinidad and Tobago,3,0,FIFA World Cup qualification,3
Netherlands,Estonia,5,0,FIFA World Cup qualification,5
Northern Ireland,Iceland,3,0,FIFA World Cup qualification,3
Paraguay,Bolivia,5,1,FIFA World Cup qualification,4
San Marino,Croatia,0,4,FIFA World Cup qualification,4
Slovakia,Moldova,4,2,FIFA World Cup qualification,2
Ukraine,Armenia,3,0,FIFA World Cup qualification,3
Saudi Arabia,United Arab Emirates,0,2,Friendly,2
Uzbekistan,Oman,5,0,FIFA World Cup qualification,5
China PR,Uzbekistan,2,0,FIFA World Cup qualification,2
Thailand,Saudi Arabia,1,3,FIFA World Cup qualification,2
Bahrain,Saudi Arabia,0,4,FIFA World Cup qualification,4
Oman,Qatar,0,3,FIFA World Cup qualification,3
Thailand,Oman,2,0,Friendly,2
Japan,Senegal,0,2,Friendly,2
Armenia,Norway,1,4,FIFA World Cup qualification,3
Bolivia,Ecuador,1,5,FIFA World Cup qualification,4
Czech Republic,Bulgaria,6,0,FIFA World Cup qualification,6
Denmark,Iceland,6,0,FIFA World Cup qualification,6
France,Algeria,4,1,Friendly,3
Republic of Ireland,Cyprus,4,0,FIFA World Cup qualification,4
Moldova,Turkey,0,3,FIFA World Cup qualification,3
Netherlands,Andorra,4,0,FIFA World Cup qualification,4
Portugal,Estonia,5,0,FIFA World Cup qualification,5
Russia,Switzerland,4,0,FIFA World Cup qualification,4
Serbia,Luxembourg,6,2,FIFA World Cup qualification,4
Slovenia,Faroe Islands,3,0,FIFA World Cup qualification,3
Venezuela,Peru,3,0,FIFA World Cup qualification,3
Bosnia and Herzegovina,Liechtenstein,5,0,FIFA World Cup qualification,5
Brazil,Chile,2,0,FIFA World Cup qualification,2
North Macedonia,Slovakia,0,5,FIFA World Cup qualification,5
Sweden,Azerbaijan,3,0,FIFA World Cup qualification,3
Gambia,Morocco,0,2,Friendly,2
China PR,Qatar,3,0,FIFA World Cup qualification,3
Oman,Uzbekistan,4,2,FIFA World Cup qualification,2
Algeria,Burkina Faso,2,0,Friendly,2
Bahamas,Haiti,0,2,Friendly,2
Bahrain,Iran,3,1,FIFA World Cup qualification,2
Saudi Arabia,Thailand,4,1,FIFA World Cup qualification,3
Tanzania,Kenya,3,1,Friendly,2
Mexico,El Salvador,4,1,Friendly,3
United Arab Emirates,Iran,0,3,FIFA World Cup qualification,3
Benin,Guinea-Bissau,2,7,Amílcar Cabral Cup,5
Benin,Mauritania,2,0,Amílcar Cabral Cup,2
Mali,Guinea-Bissau,2,0,Amílcar Cabral Cup,2
Bolivia,Brazil,3,1,FIFA World Cup qualification,2
Colombia,Chile,3,1,FIFA World Cup qualification,2
Argentina,Peru,2,0,FIFA World Cup qualification,2
Venezuela,Paraguay,3,1,FIFA World Cup qualification,2
Greece,Estonia,4,2,Friendly,2
Republic of Ireland,Iran,2,0,FIFA World Cup qualification,2
South Korea,Croatia,2,0,Friendly,2
Mexico,Honduras,3,0,FIFA World Cup qualification,3
Brazil,Venezuela,3,0,FIFA World Cup qualification,3
Germany,Ukraine,4,1,FIFA World Cup qualification,3
Hungary,North Macedonia,5,0,Friendly,5
Latvia,Russia,1,3,Friendly,2
Paraguay,Colombia,0,4,FIFA World Cup qualification,4
Portugal,Angola,5,1,Friendly,4
Turkey,Austria,5,0,FIFA World Cup qualification,5
Uruguay,Australia,3,0,FIFA World Cup qualification,3
Mali,Ivory Coast,0,3,Friendly,3
Rwanda,Somalia,3,0,CECAFA Cup,3
Uganda,Djibouti,10,1,CECAFA Cup,9
Burundi,Djibouti,3,1,CECAFA Cup,2
Kenya,Somalia,3,0,CECAFA Cup,3
Ethiopia,Zanzibar,5,0,CECAFA Cup,5
Tanzania,Djibouti,4,1,CECAFA Cup,3
Uganda,Burundi,0,2,CECAFA Cup,2
Oman,Syria,2,0,Friendly,2
Senegal,Burkina Faso,2,4,Friendly,2
Oman,North Macedonia,2,0,Friendly,2
Saudi Arabia,Zimbabwe,0,2,Friendly,2
Tunisia,Liberia,7,2,Friendly,5
Bahrain,Finland,0,2,Prime Minister's Cup,2
Egypt,Ghana,2,0,Friendly,2
Martinique,Guadeloupe,1,3,Friendly,2
Kuwait,Zimbabwe,3,0,Friendly,3
Burkina Faso,Cameroon,1,3,Friendly,2
Qatar,Zimbabwe,0,2,Friendly,2
Bahrain,Albania,3,0,Prime Minister's Cup,3
Finland,North Macedonia,3,0,Prime Minister's Cup,3
Iraq,Oman,2,0,Friendly,2
Qatar,Iraq,1,3,Friendly,2
Algeria,Benin,4,0,Friendly,4
Gambia,Morocco,0,2,Friendly,2
Haiti,Canada,0,2,Gold Cup,2
Martinique,Costa Rica,0,2,Gold Cup,2
Kuwait,Oman,1,3,Gulf Cup,2
Antigua and Barbuda,Dominica,4,0,Friendly,4
Ecuador,Haiti,0,2,Gold Cup,2
Saudi Arabia,Bahrain,3,1,Gulf Cup,2
United Arab Emirates,Qatar,0,2,Gulf Cup,2
Mexico,Guatemala,3,1,Gold Cup,2
Canada,Ecuador,0,2,Gold Cup,2
United States,El Salvador,4,0,Gold Cup,4
Saudi Arabia,Oman,2,0,Gulf Cup,2
Mali,Algeria,2,0,African Cup of Nations,2
Cameroon,Togo,3,0,African Cup of Nations,3
DR Congo,Ivory Coast,3,1,African Cup of Nations,2
Costa Rica,South Korea,3,1,Gold Cup,2
South Africa,Morocco,3,1,African Cup of Nations,2
Saudi Arabia,Qatar,3,1,Gulf Cup,2
Brazil,Bolivia,6,0,Friendly,6
United States,Costa Rica,2,0,Gold Cup,2
Mali,South Africa,2,0,African Cup of Nations,2
Senegal,DR Congo,2,0,African Cup of Nations,2
Mali,Cameroon,0,3,African Cup of Nations,3
Thailand,Singapore,4,0,King's Cup,4
Moldova,Jordan,2,0,Malta International Tournament,2
Czech Republic,Hungary,2,0,Cyprus International Tournament,2
North Korea,Singapore,4,2,King's Cup,2
Slovenia,Honduras,1,5,Lunar New Year Cup,4
Germany,Israel,7,1,Friendly,6
Republic of Ireland,Russia,2,0,Friendly,2
Lithuania,Jordan,0,3,Malta International Tournament,3
Malta,Moldova,3,0,Malta International Tournament,3
Northern Ireland,Poland,1,4,Friendly,3
Qatar,Singapore,3,0,King's Cup,3
Qatar,Singapore,2,0,King's Cup,2
Botswana,Eswatini,6,2,Friendly,4
United States,Honduras,4,0,Friendly,4
Brazil,Iceland,6,1,Friendly,5
American Samoa,New Caledonia,0,10,Oceania Nations Cup qualification,10
Samoa,Tonga,2,0,Oceania Nations Cup qualification,2
American Samoa,Tonga,2,7,Oceania Nations Cup qualification,5
New Caledonia,Papua New Guinea,1,4,Oceania Nations Cup qualification,3
Mexico,Albania,4,0,Friendly,4
Estonia,Saudi Arabia,2,0,Friendly,2
Papua New Guinea,Tonga,5,0,Oceania Nations Cup qualification,5
Samoa,American Samoa,5,0,Oceania Nations Cup qualification,5
Botswana,Namibia,3,1,Friendly,2
New Caledonia,Tonga,9,0,Oceania Nations Cup qualification,9
Samoa,Papua New Guinea,1,4,Oceania Nations Cup qualification,3
American Samoa,Papua New Guinea,0,7,Oceania Nations Cup qualification,7
Samoa,New Caledonia,0,5,Oceania Nations Cup qualification,5
Finland,South Korea,0,2,Friendly,2
Austria,Slovakia,2,0,Friendly,2
Belize,Guyana,3,1,Friendly,2
Bulgaria,Ecuador,0,3,Friendly,3
France,Scotland,5,0,Friendly,5
Georgia,South Africa,4,1,Friendly,3
Germany,United States,4,2,Friendly,2
Republic of Ireland,Denmark,3,0,Friendly,3
Luxembourg,Latvia,0,3,Friendly,3
Moldova,Hungary,0,2,Friendly,2
Poland,Japan,0,2,Friendly,2
Portugal,Finland,1,4,Friendly,3
Romania,Ukraine,4,1,Friendly,3
Lesotho,Mozambique,0,2,COSAFA Cup,2
Singapore,Maldives,2,0,Friendly,2
Andorra,Albania,2,0,Friendly,2
Belize,Nicaragua,7,1,Friendly,6
Croatia,Bosnia and Herzegovina,2,0,Friendly,2
Denmark,Israel,3,1,Friendly,2
England,Paraguay,4,0,Friendly,4
Hungary,Belarus,2,5,Friendly,3
Northern Ireland,Spain,0,5,Friendly,5
Serbia,Lithuania,4,1,Friendly,3
Turkey,Chile,2,0,Friendly,2
South Korea,Costa Rica,2,0,Friendly,2
Nigeria,Kenya,3,0,Friendly,3
Zimbabwe,Eswatini,0,2,COSAFA Cup,2
Hungary,Croatia,0,2,Friendly,2
Germany,Kuwait,7,0,Friendly,7
Norway,Japan,3,0,Friendly,3
Slovakia,Uzbekistan,4,1,Friendly,3
Greece,Cyprus,3,1,Friendly,2
Switzerland,Canada,1,3,Friendly,2
China PR,Uruguay,0,2,Friendly,2
South Korea,Scotland,4,1,Friendly,3
United States,Jamaica,5,0,Friendly,5
Slovenia,Ghana,2,0,Friendly,2
Ukraine,Serbia,2,0,Friendly,2
Canary Islands,Venezuela,0,2,Friendly,2
Germany,Austria,6,2,Friendly,4
Tanzania,Kenya,0,5,Friendly,5
Catalonia,Brazil,1,3,Friendly,2
Belarus,Ukraine,2,0,Friendly,2
United States,Netherlands,0,2,Friendly,2
Scotland,South Africa,0,2,Friendly,2
South Africa,Turkey,2,0,Friendly,2
China PR,Portugal,0,2,Friendly,2
Malaysia,Brazil,0,4,Friendly,4
Kuwait,Iran,1,3,Friendly,2
Germany,Saudi Arabia,8,0,FIFA World Cup,8
Spain,Slovenia,3,1,FIFA World Cup,2
Italy,Ecuador,2,0,FIFA World Cup,2
China PR,Costa Rica,0,2,FIFA World Cup,2
South Korea,Poland,2,0,FIFA World Cup,2
Russia,Tunisia,2,0,FIFA World Cup,2
Andorra,Armenia,0,2,Friendly,2
Spain,Paraguay,3,1,FIFA World Cup,2
Brazil,China PR,4,0,FIFA World Cup,4
Malawi,Botswana,2,0,Friendly,2
Portugal,Poland,4,0,FIFA World Cup,4
Cameroon,Germany,0,2,FIFA World Cup,2
Denmark,France,2,0,FIFA World Cup,2
Saudi Arabia,Republic of Ireland,0,3,FIFA World Cup,3
Slovenia,Paraguay,1,3,FIFA World Cup,2
Costa Rica,Brazil,2,5,FIFA World Cup,3
Turkey,China PR,3,0,FIFA World Cup,3
Japan,Tunisia,2,0,FIFA World Cup,2
Poland,United States,3,1,FIFA World Cup,2
Denmark,England,0,3,FIFA World Cup,3
Brazil,Belgium,2,0,FIFA World Cup,2
Mexico,United States,0,2,FIFA World Cup,2
Grenada,British Virgin Islands,5,0,Friendly,5
Bhutan,Montserrat,4,0,The Other Final,4
Germany,Brazil,0,2,FIFA World Cup,2
New Zealand,Tahiti,4,0,Oceania Nations Cup,4
Australia,Vanuatu,2,0,Oceania Nations Cup,2
Grenada,Saint Martin,8,3,Gold Cup qualification,5
Zambia,Mozambique,3,0,COSAFA Cup,3
Guadeloupe,Puerto Rico,4,0,Gold Cup qualification,4
New Zealand,Papua New Guinea,9,1,Oceania Nations Cup,8
Australia,New Caledonia,11,0,Oceania Nations Cup,11
New Zealand,Solomon Islands,6,1,Oceania Nations Cup,5
Papua New Guinea,Tahiti,1,3,Oceania Nations Cup,2
Australia,Fiji,8,0,Oceania Nations Cup,8
New Zealand,Vanuatu,3,0,Oceania Nations Cup,3
British Virgin Islands,Saint Lucia,1,3,Gold Cup qualification,2
Iraq,Syria,2,0,Friendly,2
Puerto Rico,Guadeloupe,0,2,Gold Cup qualification,2
Saint Kitts and Nevis,Taiwan,3,0,SKN Football Festival,3
Sudan,Chad,2,0,Friendly,2
Saint Kitts and Nevis,Barbados,3,0,SKN Football Festival,3
Aruba,Suriname,0,2,Gold Cup qualification,2
Saint Lucia,British Virgin Islands,8,1,Gold Cup qualification,7
Chad,Uganda,0,2,Friendly,2
Grenada,Taiwan,5,2,Friendly,3
Sudan,Ethiopia,3,0,Friendly,3
Saint Martin,Grenada,1,7,Gold Cup qualification,6
Egypt,Ethiopia,4,1,Friendly,3
Saint Lucia,Jamaica,1,3,Friendly,2
Suriname,Aruba,6,0,Gold Cup qualification,6
Dominican Republic,United States Virgin Islands,6,1,Gold Cup qualification,5
Dominican Republic,United States Virgin Islands,5,1,Gold Cup qualification,4
Egypt,Uganda,2,0,Friendly,2
Azerbaijan,Uzbekistan,2,0,Friendly,2
Bosnia and Herzegovina,Serbia,0,2,Friendly,2
Czech Republic,Slovakia,4,1,Friendly,3
Faroe Islands,Liechtenstein,3,1,Friendly,2
Finland,Republic of Ireland,0,3,Friendly,3
Iceland,Andorra,3,0,Friendly,3
Latvia,Belarus,2,4,Friendly,2
Lithuania,Israel,2,4,Friendly,2
Luxembourg,Morocco,0,2,Friendly,2
North Macedonia,Malta,5,0,Friendly,5
Turkey,Georgia,3,0,Friendly,3
Venezuela,Bolivia,2,0,Friendly,2
Egypt,Sudan,3,0,Friendly,3
South Africa,Eswatini,4,1,COSAFA Cup,3
Congo,DR Congo,1,3,Friendly,2
India,Jamaica,0,3,Friendly,3
Zimbabwe,Lesotho,2,0,Friendly,2
Palestine,Iraq,0,2,WAFF Championship,2
Libya,Togo,4,0,Friendly,4
Iran,Lebanon,2,0,WAFF Championship,2
Luxembourg,Israel,0,5,Friendly,5
Czech Republic,Serbia,5,0,Friendly,5
Mauritania,Cape Verde,0,2,African Cup of Nations qualification,2
Austria,Moldova,2,0,UEFA Euro qualification,2
Azerbaijan,Italy,0,2,UEFA Euro qualification,2
Belgium,Bulgaria,0,2,UEFA Euro qualification,2
Bosnia and Herzegovina,Romania,0,3,UEFA Euro qualification,3
Finland,Wales,0,2,UEFA Euro qualification,2
Greece,Spain,0,2,UEFA Euro qualification,2
Iceland,Hungary,0,2,Friendly,2
Kenya,Togo,3,0,African Cup of Nations qualification,3
Lithuania,Germany,0,2,UEFA Euro qualification,2
Netherlands,Belarus,3,0,UEFA Euro qualification,3
Niger,Ethiopia,3,1,African Cup of Nations qualification,2
Russia,Republic of Ireland,4,2,UEFA Euro qualification,2
San Marino,Poland,0,2,UEFA Euro qualification,2
Slovenia,Malta,3,0,UEFA Euro qualification,3
Turkey,Slovakia,3,0,UEFA Euro qualification,3
Benin,Tanzania,4,0,African Cup of Nations qualification,4
Equatorial Guinea,Sierra Leone,1,3,African Cup of Nations qualification,2
Guinea,Liberia,3,0,African Cup of Nations qualification,3
Switzerland,Georgia,4,1,UEFA Euro qualification,3
Ivory Coast,Gambia,5,0,Friendly,5
Malawi,South Africa,1,3,COSAFA Cup,2
Morocco,Niger,6,1,Friendly,5
Mali,Mauritania,2,0,Friendly,2
Martinique,Saint Lucia,4,0,Friendly,4
Algeria,Chad,4,1,African Cup of Nations qualification,3
Belarus,Austria,0,2,UEFA Euro qualification,2
Bulgaria,Croatia,2,0,UEFA Euro qualification,2
Denmark,Luxembourg,2,0,UEFA Euro qualification,2
Finland,Azerbaijan,3,0,UEFA Euro qualification,3
France,Slovenia,5,0,UEFA Euro qualification,5
Iceland,Scotland,0,2,UEFA Euro qualification,2
Lithuania,Faroe Islands,2,0,UEFA Euro qualification,2
Malta,Israel,0,2,UEFA Euro qualification,2
Moldova,Czech Republic,0,2,UEFA Euro qualification,2
Sierra Leone,Gabon,2,0,African Cup of Nations qualification,2
Spain,Northern Ireland,3,0,UEFA Euro qualification,3
Ukraine,Greece,2,0,UEFA Euro qualification,2
DR Congo,Botswana,2,0,African Cup of Nations qualification,2
Ghana,Rwanda,4,2,African Cup of Nations qualification,2
Mali,Seychelles,3,0,African Cup of Nations qualification,3
Morocco,Equatorial Guinea,5,0,African Cup of Nations qualification,5
Mozambique,Congo,0,3,African Cup of Nations qualification,3
Scotland,Canada,3,1,Friendly,2
Austria,Netherlands,0,3,UEFA Euro qualification,3
Czech Republic,Belarus,2,0,UEFA Euro qualification,2
Greece,Armenia,2,0,UEFA Euro qualification,2
Hungary,San Marino,3,0,UEFA Euro qualification,3
Iceland,Lithuania,3,0,UEFA Euro qualification,3
Luxembourg,Romania,0,7,UEFA Euro qualification,7
Malta,France,0,4,UEFA Euro qualification,4
Norway,Bosnia and Herzegovina,2,0,UEFA Euro qualification,2
Poland,New Zealand,2,0,Friendly,2
Russia,Albania,4,1,UEFA Euro qualification,3
Serbia,Finland,2,0,UEFA Euro qualification,2
Turkey,Liechtenstein,5,0,UEFA Euro qualification,5
Venezuela,Ecuador,2,0,Friendly,2
Tanzania,Uganda,0,2,Friendly,2
Jersey,Kernow,0,3,Friendly,3
Saint Lucia,Martinique,0,2,Friendly,2
Grenada,Barbados,0,2,Gold Cup qualification,2
Jamaica,Guadeloupe,2,0,Gold Cup qualification,2
Grenada,Jamaica,1,4,Gold Cup qualification,3
Trinidad and Tobago,Saint Kitts and Nevis,2,0,Gold Cup qualification,2
United States,El Salvador,2,0,Friendly,2
Azerbaijan,Wales,0,2,UEFA Euro qualification,2
Denmark,Poland,2,0,Friendly,2
Estonia,Iceland,2,0,Friendly,2
France,Serbia,3,0,Friendly,3
Germany,Netherlands,1,3,Friendly,2
Japan,Argentina,0,2,Friendly,2
Morocco,Mali,1,3,Friendly,2
Portugal,Scotland,2,0,Friendly,2
Haiti,Curaçao,3,0,Gold Cup qualification,3
Cayman Islands,Cuba,0,5,Gold Cup qualification,5
Martinique,Dominican Republic,4,0,Gold Cup qualification,4
Jordan,Singapore,3,1,Friendly,2
Cayman Islands,Martinique,0,3,Gold Cup qualification,3
Somalia,Uganda,0,2,CECAFA Cup,2
Uganda,Ethiopia,3,0,CECAFA Cup,3
Tanzania,Burundi,2,0,CECAFA Cup,2
Kenya,Eritrea,4,1,CECAFA Cup,3
Bahrain,Jordan,0,3,Prime Minister's Cup,3
China PR,Syria,3,1,Prime Minister's Cup,2
Zanzibar,Uganda,0,2,CECAFA Cup,2
Chile,Palestine,3,1,Friendly,2
Malaysia,Cambodia,5,0,Friendly,5
Singapore,Philippines,2,0,Friendly,2
Tanzania,Rwanda,3,0,CECAFA Cup,3
Jordan,Syria,3,0,Prime Minister's Cup,3
Uganda,Kenya,1,3,CECAFA Cup,2
Vietnam,Cambodia,9,2,AFF Championship,7
Indonesia,Cambodia,4,2,AFF Championship,2
Philippines,Myanmar,1,6,AFF Championship,5
Yemen,Syria,0,4,Arab Cup,4
Singapore,Malaysia,0,4,AFF Championship,4
Thailand,Laos,5,1,AFF Championship,4
Bahrain,Syria,2,0,Arab Cup,2
Myanmar,Cambodia,5,0,AFF Championship,5
Vietnam,Philippines,4,1,AFF Championship,3
Thailand,Malaysia,1,3,AFF Championship,2
Bahrain,Yemen,3,1,Arab Cup,2
Syria,Lebanon,4,1,Arab Cup,3
Myanmar,Vietnam,2,4,AFF Championship,2
Indonesia,Philippines,13,1,AFF Championship,12
Lebanon,Yemen,4,2,Arab Cup,2
Syria,Saudi Arabia,0,3,Arab Cup,3
Vietnam,Thailand,0,4,AFF Championship,4
Catalonia,China PR,2,0,Friendly,2
Maldives,Bhutan,6,0,SAFF Cup,6
Afghanistan,India,0,4,SAFF Cup,4
Nepal,Bhutan,2,0,SAFF Cup,2
Bangladesh,Bhutan,3,0,SAFF Cup,3
United States,Canada,4,0,Friendly,4
Ghana,Benin,3,0,Friendly,3
Honduras,Argentina,1,3,Friendly,2
Cameroon,Ivory Coast,0,3,Friendly,3
Honduras,Nicaragua,2,0,UNCAF Cup,2
Albania,Vietnam,5,0,Friendly,5
Algeria,Belgium,1,3,Friendly,2
Egypt,Denmark,1,4,Friendly,3
England,Australia,1,3,Friendly,2
France,Czech Republic,0,2,Friendly,2
Israel,Armenia,2,0,Friendly,2
Libya,Canada,2,4,Friendly,2
Scotland,Republic of Ireland,0,2,Friendly,2
Slovenia,Switzerland,1,5,Friendly,4
Spain,Germany,3,1,Friendly,2
Cyprus,Slovakia,1,3,Cyprus International Tournament,2
El Salvador,Nicaragua,3,0,UNCAF Cup,3
North Macedonia,Poland,0,3,Friendly,3
Panama,Guatemala,2,0,UNCAF Cup,2
Guatemala,Nicaragua,5,0,UNCAF Cup,5
El Salvador,Guatemala,0,2,UNCAF Cup,2
Thailand,Sweden,1,4,King's Cup,3
Hong Kong,Taiwan,2,0,EAFF Championship,2
North Korea,Sweden,0,4,King's Cup,4
Macau,Mongolia,2,0,EAFF Championship,2
Thailand,Qatar,3,1,King's Cup,2
Peru,Haiti,5,1,Friendly,4
Hong Kong,Macau,3,0,EAFF Championship,3
Mongolia,Guam,2,0,EAFF Championship,2
Guam,Macau,0,2,EAFF Championship,2
Guam,Taiwan,0,7,EAFF Championship,7
Hong Kong,Mongolia,10,0,EAFF Championship,10
Hong Kong,Guam,11,0,EAFF Championship,11
Singapore,Maldives,4,1,Friendly,3
Sudan,DR Congo,1,3,Friendly,2
DR Congo,Congo,3,0,Friendly,3
Rwanda,Burundi,4,2,Friendly,2
Nepal,Afghanistan,4,0,AFC Asian Cup qualification,4
Egypt,Qatar,6,0,Friendly,6
Mexico,Bolivia,2,0,Friendly,2
Nepal,Kyrgyzstan,0,2,AFC Asian Cup qualification,2
Macau,Pakistan,0,3,AFC Asian Cup qualification,3
Myanmar,Brunei,5,0,AFC Asian Cup qualification,5
Kenya,Tanzania,4,0,Friendly,4
Singapore,Macau,2,0,AFC Asian Cup qualification,2
North Korea,India,2,0,AFC Asian Cup qualification,2
Rwanda,Zambia,0,3,Friendly,3
Hong Kong,Laos,5,1,AFC Asian Cup qualification,4
Maldives,Myanmar,0,2,AFC Asian Cup qualification,2
Singapore,Pakistan,3,0,AFC Asian Cup qualification,3
Jamaica,Saint Lucia,5,0,Gold Cup qualification,5
Trinidad and Tobago,Antigua and Barbuda,2,0,Gold Cup qualification,2
Cameroon,Madagascar,2,0,Friendly,2
Cuba,Antigua and Barbuda,2,0,Gold Cup qualification,2
Albania,Russia,3,1,UEFA Euro qualification,2
Bosnia and Herzegovina,Luxembourg,2,0,UEFA Euro qualification,2
Croatia,Belgium,4,0,UEFA Euro qualification,4
France,Malta,6,0,UEFA Euro qualification,6
Gabon,Equatorial Guinea,4,0,African Cup of Nations qualification,4
Italy,Finland,2,0,UEFA Euro qualification,2
Kenya,Mauritania,4,0,African Cup of Nations qualification,4
Liechtenstein,England,0,2,UEFA Euro qualification,2
North Macedonia,Slovakia,0,2,UEFA Euro qualification,2
Romania,Denmark,2,5,UEFA Euro qualification,3
South Africa,Madagascar,2,0,Friendly,2
Sudan,Benin,3,0,African Cup of Nations qualification,3
United States,Venezuela,2,0,Friendly,2
Wales,Azerbaijan,4,0,UEFA Euro qualification,4
Chad,Namibia,2,0,African Cup of Nations qualification,2
Chile,Peru,2,0,Friendly,2
Eritrea,Mali,0,2,African Cup of Nations qualification,2
Guadeloupe,Antigua and Barbuda,2,0,Gold Cup qualification,2
Guinea,Niger,2,0,African Cup of Nations qualification,2
Jamaica,Haiti,3,0,Gold Cup qualification,3
Trinidad and Tobago,Cuba,1,3,Gold Cup qualification,2
Zimbabwe,Seychelles,3,1,African Cup of Nations qualification,2
Croatia,Andorra,2,0,UEFA Euro qualification,2
Czech Republic,Austria,4,0,UEFA Euro qualification,4
Denmark,Bosnia and Herzegovina,0,2,UEFA Euro qualification,2
England,Turkey,2,0,UEFA Euro qualification,2
Luxembourg,Norway,0,2,UEFA Euro qualification,2
Northern Ireland,Greece,0,2,UEFA Euro qualification,2
Peru,Chile,3,0,Friendly,3
Poland,San Marino,5,0,UEFA Euro qualification,5
Slovakia,Liechtenstein,4,0,UEFA Euro qualification,4
Slovenia,Cyprus,4,1,UEFA Euro qualification,3
Spain,Armenia,3,0,UEFA Euro qualification,3
Venezuela,Jamaica,2,0,Friendly,2
Bhutan,Guam,6,0,AFC Asian Cup qualification,6
Algeria,Madagascar,3,1,Friendly,2
Guam,Mongolia,0,5,AFC Asian Cup qualification,5
Trinidad and Tobago,Honduras,0,2,Gold Cup qualification,2
Madagascar,Mali,0,2,Friendly,2
Martinique,Honduras,2,4,Gold Cup qualification,2
Andorra,Estonia,0,2,UEFA Euro qualification,2
Belgium,Poland,3,1,Friendly,2
Bulgaria,Albania,2,0,Friendly,2
Czech Republic,Turkey,4,0,Friendly,4
Finland,Iceland,3,0,Friendly,3
France,Egypt,5,0,Friendly,5
Hungary,Luxembourg,5,1,Friendly,4
Israel,Cyprus,2,0,UEFA Euro qualification,2
Latvia,San Marino,3,0,UEFA Euro qualification,3
Libya,Argentina,1,3,Friendly,2
Malta,Slovenia,1,3,UEFA Euro qualification,2
Scotland,Austria,0,2,Friendly,2
Spain,Ecuador,4,0,Friendly,4
Venezuela,Trinidad and Tobago,3,0,Friendly,3
Fiji,Tuvalu,9,0,Friendly,9
Norway,Finland,2,0,Friendly,2
Togo,Benin,3,1,Friendly,2
United States,Wales,2,0,Friendly,2
Nigeria,Ghana,3,1,Friendly,2
Gambia,Mauritania,4,1,Friendly,3
Germany,Canada,4,1,Friendly,3
Italy,Northern Ireland,2,0,Friendly,2
Poland,Kazakhstan,3,0,Friendly,3
Belarus,Netherlands,0,2,UEFA Euro qualification,2
Burkina Faso,Mozambique,4,0,African Cup of Nations qualification,4
Estonia,Andorra,2,0,UEFA Euro qualification,2
Finland,Serbia,3,0,UEFA Euro qualification,3
Hungary,Latvia,3,1,UEFA Euro qualification,2
North Macedonia,Liechtenstein,3,1,UEFA Euro qualification,2
Nigeria,Malawi,4,1,African Cup of Nations qualification,3
Romania,Bosnia and Herzegovina,2,0,UEFA Euro qualification,2
San Marino,Sweden,0,6,UEFA Euro qualification,6
Senegal,Gambia,3,1,African Cup of Nations qualification,2
Zambia,Tanzania,2,0,African Cup of Nations qualification,2
Benin,Sudan,3,0,African Cup of Nations qualification,3
DR Congo,Eswatini,2,0,African Cup of Nations qualification,2
Egypt,Mauritius,7,0,African Cup of Nations qualification,7
Ivory Coast,Burundi,6,1,African Cup of Nations qualification,5
Japan,Argentina,1,4,Kirin Cup,3
South Korea,Uruguay,0,2,Friendly,2
Togo,Cape Verde,5,2,African Cup of Nations qualification,3
Portugal,Bolivia,4,0,Friendly,4
Austria,Belarus,5,0,UEFA Euro qualification,5
Belgium,Andorra,3,0,UEFA Euro qualification,3
Czech Republic,Moldova,5,0,UEFA Euro qualification,5
Faroe Islands,Germany,0,2,UEFA Euro qualification,2
Finland,Italy,0,2,UEFA Euro qualification,2
Republic of Ireland,Georgia,2,0,UEFA Euro qualification,2
Lithuania,Iceland,0,3,UEFA Euro qualification,3
Luxembourg,Denmark,0,2,UEFA Euro qualification,2
Nigeria,Brazil,0,3,Friendly,3
San Marino,Hungary,0,5,UEFA Euro qualification,5
Sweden,Poland,3,0,UEFA Euro qualification,3
Andorra,Gabon,0,2,Friendly,2
Ghana,Kenya,1,3,Friendly,2
Papua New Guinea,Solomon Islands,3,5,Friendly,2
Senegal,Lesotho,3,0,African Cup of Nations qualification,3
New Zealand,Japan,0,3,Confederations Cup,3
Colombia,New Zealand,3,1,Confederations Cup,2
Egypt,Madagascar,6,0,African Cup of Nations qualification,6
Morocco,Gabon,2,0,African Cup of Nations qualification,2
Burkina Faso,Congo,3,0,African Cup of Nations qualification,3
Cape Verde,Mauritania,3,0,African Cup of Nations qualification,3
Ethiopia,Niger,2,0,African Cup of Nations qualification,2
France,New Zealand,5,0,Confederations Cup,5
Sierra Leone,Equatorial Guinea,2,0,African Cup of Nations qualification,2
Togo,Kenya,2,0,African Cup of Nations qualification,2
Panama,Cuba,2,0,Friendly,2
Saare County,Ynys Môn,0,2,Island Games,2
Frøya,Jersey,1,5,Island Games,4
Guernsey,Alderney,7,1,Island Games,6
Gibraltar,Sark,19,0,Island Games,19
Papua New Guinea,New Caledonia,0,2,South Pacific Games,2
Tahiti,Micronesia,17,0,South Pacific Games,17
Isle of Man,Saare County,4,0,Island Games,4
Jersey,Shetland,5,0,Island Games,5
Guernsey,Orkney,10,0,Island Games,10
Sark,Isle of Wight,0,20,Island Games,20
Gibraltar,Greenland,2,0,Island Games,2
Fiji,Tuvalu,4,0,South Pacific Games,4
Micronesia,New Caledonia,0,18,South Pacific Games,18
Shetland,Frøya,3,1,Island Games,2
Orkney,Alderney,3,1,Island Games,2
Greenland,Sark,16,0,Island Games,16
Estonia,Lithuania,1,5,Baltic Cup,4
Solomon Islands,Kiribati,7,0,South Pacific Games,7
Tahiti,Papua New Guinea,3,0,South Pacific Games,3
Tonga,New Caledonia,0,4,South Pacific Games,4
Frøya,Sark,15,0,Island Games,15
Alderney,Greenland,0,3,Island Games,3
Gotland,Saare County,3,0,Island Games,3
Orkney,Gibraltar,1,7,Island Games,6
Guernsey,Isle of Wight,3,1,Island Games,2
Orkney,Shetland,0,6,Island Games,6
Gibraltar,Ynys Môn,0,2,Island Games,2
Jersey,Isle of Wight,3,0,Island Games,3
Guernsey,Isle of Man,3,1,Island Games,2
Fiji,Kiribati,12,0,South Pacific Games,12
Libya,Eswatini,6,2,African Cup of Nations qualification,4
Seychelles,Mali,0,2,African Cup of Nations qualification,2
Tahiti,New Caledonia,0,4,South Pacific Games,4
Tonga,Micronesia,7,0,South Pacific Games,7
Tuvalu,Solomon Islands,0,4,South Pacific Games,4
Zimbabwe,Eritrea,2,0,African Cup of Nations qualification,2
Angola,Malawi,5,1,African Cup of Nations qualification,4
Benin,Zambia,3,0,African Cup of Nations qualification,3
Burundi,South Africa,0,2,African Cup of Nations qualification,2
Central African Republic,Burkina Faso,0,3,African Cup of Nations qualification,3
Gabon,Sierra Leone,2,0,African Cup of Nations qualification,2
Guinea,Ethiopia,3,0,African Cup of Nations qualification,3
Madagascar,Mauritius,0,2,African Cup of Nations qualification,2
United States,Paraguay,2,0,Friendly,2
Kiribati,Vanuatu,0,18,South Pacific Games,18
Papua New Guinea,Micronesia,10,0,South Pacific Games,10
Tahiti,Tonga,4,0,South Pacific Games,4
Jamaica,Paraguay,2,0,Friendly,2
Fiji,New Caledonia,2,0,South Pacific Games,2
United States,El Salvador,2,0,Gold Cup,2
Eswatini,Madagascar,2,0,COSAFA Cup,2
Canada,Cuba,0,2,Gold Cup,2
United States,Martinique,2,0,Gold Cup,2
Guatemala,Jamaica,0,2,Gold Cup,2
Cuba,Costa Rica,0,3,Gold Cup,3
Colombia,Brazil,0,2,Gold Cup,2
Costa Rica,El Salvador,5,2,Gold Cup,3
United States,Cuba,5,0,Gold Cup,5
Mexico,Jamaica,5,0,Gold Cup,5
Mexico,Costa Rica,2,0,Gold Cup,2
Zambia,Mozambique,4,2,COSAFA Cup,2
Haiti,Trinidad and Tobago,2,0,SKN Football Festival,2
Singapore,Hong Kong,4,1,Friendly,3
Iraq,Uruguay,2,5,Friendly,3
Angola,DR Congo,0,2,Friendly,2
Austria,Costa Rica,2,0,Friendly,2
Bulgaria,Lithuania,3,0,Friendly,3
Ecuador,Guatemala,2,0,Friendly,2
England,Croatia,3,1,Friendly,2
Japan,Nigeria,3,0,Friendly,3
Latvia,Uzbekistan,0,3,Friendly,3
North Macedonia,Albania,3,1,Friendly,2
Mexico,Peru,1,3,Friendly,2
Switzerland,France,0,2,Friendly,2
Turkey,Moldova,2,0,Friendly,2
Ukraine,Romania,0,2,Friendly,2
Bolivia,Panama,3,0,Friendly,3
Zimbabwe,Eswatini,2,0,COSAFA Cup,2
Singapore,Kuwait,1,3,AFC Asian Cup qualification,2
Iran,Jordan,4,1,AFC Asian Cup qualification,3
Andorra,Croatia,0,3,UEFA Euro qualification,3
Belarus,Czech Republic,1,3,UEFA Euro qualification,2
Bulgaria,Estonia,2,0,UEFA Euro qualification,2
Ecuador,Venezuela,2,0,FIFA World Cup qualification,2
France,Cyprus,5,0,UEFA Euro qualification,5
Georgia,Albania,3,0,UEFA Euro qualification,3
Italy,Wales,4,0,UEFA Euro qualification,4
Latvia,Poland,0,2,UEFA Euro qualification,2
Liechtenstein,Turkey,0,3,UEFA Euro qualification,3
Netherlands,Austria,3,1,UEFA Euro qualification,2
Peru,Paraguay,4,1,FIFA World Cup qualification,3
Portugal,Spain,0,3,Friendly,3
Romania,Luxembourg,4,0,UEFA Euro qualification,4
Scotland,Faroe Islands,3,1,UEFA Euro qualification,2
Slovenia,Israel,3,1,UEFA Euro qualification,2
Eswatini,Botswana,0,3,Friendly,3
Sweden,San Marino,5,0,UEFA Euro qualification,5
Angola,Namibia,2,0,Friendly,2
Costa Rica,China PR,2,0,Friendly,2
Uruguay,Bolivia,5,0,FIFA World Cup qualification,5
Venezuela,Argentina,0,3,FIFA World Cup qualification,3
Albania,Georgia,3,1,UEFA Euro qualification,2
Andorra,Bulgaria,0,3,UEFA Euro qualification,3
Bolivia,Colombia,4,0,FIFA World Cup qualification,4
Czech Republic,Netherlands,3,1,UEFA Euro qualification,2
England,Liechtenstein,2,0,UEFA Euro qualification,2
Faroe Islands,Lithuania,1,3,UEFA Euro qualification,2
Latvia,Hungary,3,1,UEFA Euro qualification,2
Morocco,Trinidad and Tobago,2,0,Friendly,2
Paraguay,Uruguay,4,1,FIFA World Cup qualification,3
Poland,Sweden,0,2,UEFA Euro qualification,2
Russia,Switzerland,4,1,UEFA Euro qualification,3
Slovenia,France,0,2,UEFA Euro qualification,2
Singapore,Oman,1,3,Friendly,2
Namibia,Angola,1,3,Friendly,2
South Korea,Vietnam,5,0,AFC Asian Cup qualification,5
Nepal,Oman,0,7,AFC Asian Cup qualification,7
Benin,Gabon,0,4,Friendly,4
Kuwait,Singapore,4,0,AFC Asian Cup qualification,4
Syria,Yemen,8,2,Friendly,6
Vietnam,Nepal,5,0,AFC Asian Cup qualification,5
South Korea,Nepal,16,0,AFC Asian Cup qualification,16
Vietnam,Oman,0,6,AFC Asian Cup qualification,6
Lesotho,Eswatini,5,2,Friendly,3
Zimbabwe,Malawi,2,0,COSAFA Cup,2
Indonesia,Bhutan,2,0,AFC Asian Cup qualification,2
Saudi Arabia,Yemen,7,0,AFC Asian Cup qualification,7
Iraq,Bahrain,5,1,AFC Asian Cup qualification,4
Kuwait,Palestine,4,0,AFC Asian Cup qualification,4
Lesotho,South Africa,0,3,Friendly,3
Malaysia,Myanmar,4,0,AFC Asian Cup qualification,4
Saudi Arabia,Bhutan,6,0,AFC Asian Cup qualification,6
Yemen,Indonesia,0,3,AFC Asian Cup qualification,3
Bhutan,Yemen,0,8,AFC Asian Cup qualification,8
Myanmar,Bahrain,1,3,AFC Asian Cup qualification,2
Saudi Arabia,Indonesia,5,0,AFC Asian Cup qualification,5
Armenia,Spain,0,4,UEFA Euro qualification,4
Belgium,Estonia,2,0,UEFA Euro qualification,2
Botswana,Lesotho,4,1,FIFA World Cup qualification,3
France,Israel,3,0,UEFA Euro qualification,3
Germany,Iceland,3,0,UEFA Euro qualification,3
Italy,Azerbaijan,4,0,UEFA Euro qualification,4
Liechtenstein,Slovakia,0,2,UEFA Euro qualification,2
Netherlands,Moldova,5,0,UEFA Euro qualification,5
Portugal,Albania,5,3,Friendly,2
Russia,Georgia,3,1,UEFA Euro qualification,2
Seychelles,Zambia,0,4,FIFA World Cup qualification,4
Switzerland,Republic of Ireland,2,0,UEFA Euro qualification,2
Uganda,Mauritius,3,0,FIFA World Cup qualification,3
Sudan,Eritrea,3,0,FIFA World Cup qualification,3
Chad,Angola,3,1,FIFA World Cup qualification,2
Ethiopia,Malawi,1,3,FIFA World Cup qualification,2
Gambia,Liberia,2,0,FIFA World Cup qualification,2
Iran,New Zealand,3,0,Friendly,3
Iraq,Myanmar,3,0,AFC Asian Cup qualification,3
Rwanda,Namibia,3,0,FIFA World Cup qualification,3
Zimbabwe,Mauritania,3,0,FIFA World Cup qualification,3
Bhutan,Indonesia,0,2,AFC Asian Cup qualification,2
Saudi Arabia,Yemen,3,1,AFC Asian Cup qualification,2
Mexico,Uruguay,0,2,Friendly,2
Saudi Arabia,Bhutan,4,0,AFC Asian Cup qualification,4
Syria,Sri Lanka,5,0,AFC Asian Cup qualification,5
Thailand,India,2,0,Friendly,2
Saudi Arabia,Indonesia,6,0,AFC Asian Cup qualification,6
Yemen,Bhutan,4,0,AFC Asian Cup qualification,4
Syria,Sri Lanka,8,0,AFC Asian Cup qualification,8
Oman,Nepal,6,0,AFC Asian Cup qualification,6
Singapore,Palestine,2,0,AFC Asian Cup qualification,2
Bahrain,Myanmar,4,0,AFC Asian Cup qualification,4
Iraq,Malaysia,5,1,AFC Asian Cup qualification,4
Nepal,Vietnam,0,2,AFC Asian Cup qualification,2
Oman,South Korea,3,1,AFC Asian Cup qualification,2
Bahrain,Malaysia,3,1,AFC Asian Cup qualification,2
Myanmar,Iraq,1,3,AFC Asian Cup qualification,2
India,Rwanda,3,1,Afro-Asian Games,2
Burkina Faso,Zimbabwe,1,4,Afro-Asian Games,3
Nepal,South Korea,0,7,AFC Asian Cup qualification,7
Oman,Vietnam,2,0,AFC Asian Cup qualification,2
North Korea,Iran,1,3,AFC Asian Cup qualification,2
India,Zimbabwe,5,3,Afro-Asian Games,2
Uzbekistan,Hong Kong,4,1,AFC Asian Cup qualification,3
Syria,United Arab Emirates,1,3,AFC Asian Cup qualification,2
Uzbekistan,Thailand,3,0,AFC Asian Cup qualification,3
Mozambique,Eswatini,2,0,Friendly,2
Equatorial Guinea,São Tomé and Príncipe,3,1,Friendly,2
Iran,North Korea,3,0,AFC Asian Cup qualification,3
Lebanon,Jordan,0,2,AFC Asian Cup qualification,2
Poland,Italy,3,1,Friendly,2
Turkmenistan,Sri Lanka,3,0,AFC Asian Cup qualification,3
Algeria,Niger,6,0,FIFA World Cup qualification,6
Mali,Guinea-Bissau,2,0,FIFA World Cup qualification,2
United Arab Emirates,Syria,3,1,AFC Asian Cup qualification,2
Albania,Estonia,2,0,Friendly,2
Argentina,Bolivia,3,0,FIFA World Cup qualification,3
Czech Republic,Canada,5,1,Friendly,4
Gabon,Burundi,4,1,FIFA World Cup qualification,3
Germany,France,0,3,Friendly,3
Kenya,Tanzania,3,0,FIFA World Cup qualification,3
Angola,Chad,2,0,FIFA World Cup qualification,2
Cape Verde,Eswatini,3,0,FIFA World Cup qualification,3
Ghana,Somalia,5,0,FIFA World Cup qualification,5
Jamaica,El Salvador,3,0,Friendly,3
Liberia,Gambia,3,0,FIFA World Cup qualification,3
Libya,São Tomé and Príncipe,8,0,FIFA World Cup qualification,8
Mauritius,Uganda,3,1,FIFA World Cup qualification,2
Togo,Equatorial Guinea,2,0,FIFA World Cup qualification,2
Tajikistan,Uzbekistan,1,4,AFC Asian Cup qualification,3
Thailand,Hong Kong,4,0,AFC Asian Cup qualification,4
Republic of Ireland,Canada,3,0,Friendly,3
Jordan,North Korea,3,0,AFC Asian Cup qualification,3
United Arab Emirates,Sri Lanka,3,1,AFC Asian Cup qualification,2
Ghana,Somalia,2,0,FIFA World Cup qualification,2
Lebanon,Iran,0,3,AFC Asian Cup qualification,3
Netherlands,Scotland,6,0,UEFA Euro qualification,6
Norway,Spain,0,3,UEFA Euro qualification,3
Portugal,Kuwait,8,0,Friendly,8
Qatar,Singapore,2,0,AFC Asian Cup qualification,2
Tunisia,South Africa,2,0,Friendly,2
Turkmenistan,Afghanistan,11,0,FIFA World Cup qualification,11
Thailand,Uzbekistan,4,1,AFC Asian Cup qualification,3
United Arab Emirates,Sri Lanka,3,0,AFC Asian Cup qualification,3
Afghanistan,Turkmenistan,0,2,FIFA World Cup qualification,2
Taiwan,Macau,3,0,FIFA World Cup qualification,3
Bangladesh,Tajikistan,0,2,FIFA World Cup qualification,2
Macau,Taiwan,1,3,FIFA World Cup qualification,2
Pakistan,Kyrgyzstan,0,2,FIFA World Cup qualification,2
Singapore,Qatar,0,2,Friendly,2
Sudan,Zanzibar,4,0,CECAFA Cup,4
Tajikistan,Bangladesh,2,0,FIFA World Cup qualification,2
Kyrgyzstan,Pakistan,4,0,FIFA World Cup qualification,4
Maldives,Mongolia,12,0,FIFA World Cup qualification,12
Sri Lanka,Laos,3,0,FIFA World Cup qualification,3
Hong Kong,South Korea,1,3,EAFF Championship,2
Japan,China PR,2,0,EAFF Championship,2
Sudan,Rwanda,3,0,CECAFA Cup,3
China PR,Hong Kong,3,1,EAFF Championship,2
Uganda,Rwanda,2,0,CECAFA Cup,2
Malta,Poland,0,4,Friendly,4
Botswana,Zimbabwe,0,2,Friendly,2
Lithuania,Poland,1,3,Friendly,2
Iraq,Kenya,2,0,Prime Minister's Cup,2
Kuwait,Lebanon,2,0,Friendly,2
Egypt,Iraq,2,0,Prime Minister's Cup,2
Latvia,Kuwait,0,2,Friendly,2
Oman,Estonia,3,1,Friendly,2
United Arab Emirates,Saudi Arabia,0,2,Gulf Cup,2
Bahamas,Haiti,0,6,Friendly,6
Catalonia,Ecuador,4,2,Friendly,2
Kuwait,United Arab Emirates,0,2,Gulf Cup,2
Bahrain,Yemen,5,1,Gulf Cup,4
Oman,United Arab Emirates,2,0,Gulf Cup,2
Bermuda,Barbados,0,4,Friendly,4
Kuwait,Yemen,4,0,Gulf Cup,4
Qatar,Yemen,3,0,Gulf Cup,3
United Arab Emirates,Bahrain,1,3,Gulf Cup,2
Egypt,Rwanda,5,1,Friendly,4
Yemen,Saudi Arabia,0,2,Gulf Cup,2
Kuwait,Bahrain,0,4,Gulf Cup,4
Mauritius,South Africa,2,0,COSAFA Cup,2
Barbados,Grenada,2,0,Friendly,2
Oman,Qatar,2,0,Gulf Cup,2
Yemen,United Arab Emirates,0,3,Gulf Cup,3
Tunisia,Benin,2,0,Friendly,2
Algeria,Mali,0,2,Friendly,2
Libya,Kenya,2,0,Friendly,2
Curaçao,Suriname,2,0,Friendly,2
Guadeloupe,Saint Lucia,2,0,Friendly,2
Libya,Kenya,2,0,Friendly,2
Sweden,Norway,0,3,Lunar New Year Cup,3
Norway,Honduras,3,1,Lunar New Year Cup,2
Kenya,Mali,1,3,African Cup of Nations,2
South Africa,Benin,2,0,African Cup of Nations,2
Curaçao,Aruba,6,1,Friendly,5
Singapore,Norway,2,5,Friendly,3
Tunisia,DR Congo,3,0,African Cup of Nations,3
Cameroon,Zimbabwe,5,3,African Cup of Nations,2
British Virgin Islands,United States Virgin Islands,5,0,Friendly,5
Burkina Faso,Mali,1,3,African Cup of Nations,2
Senegal,Kenya,3,0,African Cup of Nations,3
Dominica,United States Virgin Islands,5,0,Friendly,5
Morocco,Benin,4,0,African Cup of Nations,4
Nigeria,South Africa,4,0,African Cup of Nations,4
Burkina Faso,Kenya,0,3,African Cup of Nations,3
Japan,Malaysia,4,0,Friendly,4
Morocco,Algeria,3,1,African Cup of Nations,2
Morocco,Mali,4,0,African Cup of Nations,4
Japan,Iraq,2,0,Friendly,2
Qatar,Bahrain,2,0,Friendly,2
South Korea,Oman,5,0,Friendly,5
Barbados,Guyana,0,2,Friendly,2
Malta,Estonia,5,2,Malta International Tournament,3
Antigua and Barbuda,Curaçao,2,0,FIFA World Cup qualification,2
Belgium,France,0,2,Friendly,2
Cyprus,Belarus,0,2,Cyprus International Tournament,2
Greece,Bulgaria,2,0,Friendly,2
Haiti,Turks and Caicos Islands,5,0,FIFA World Cup qualification,5
Hungary,Armenia,2,0,Cyprus International Tournament,2
Iran,Qatar,3,1,FIFA World Cup qualification,2
Jamaica,Uruguay,2,0,Friendly,2
Jordan,Laos,5,0,FIFA World Cup qualification,5
South Korea,Lebanon,2,0,FIFA World Cup qualification,2
Latvia,Kazakhstan,3,1,Cyprus International Tournament,2
Malaysia,Hong Kong,1,3,FIFA World Cup qualification,2
Northern Ireland,Norway,1,4,Friendly,3
Palestine,Taiwan,8,0,FIFA World Cup qualification,8
Poland,Slovenia,2,0,Friendly,2
Romania,Georgia,3,0,Cyprus International Tournament,3
Saudi Arabia,Indonesia,3,0,FIFA World Cup qualification,3
Turkmenistan,Sri Lanka,2,0,FIFA World Cup qualification,2
Vietnam,Maldives,4,0,FIFA World Cup qualification,4
United States Virgin Islands,Saint Kitts and Nevis,0,4,FIFA World Cup qualification,4
Wales,Scotland,4,0,Friendly,4
Cyprus,Georgia,3,1,Cyprus International Tournament,2
Belarus,Latvia,4,1,Cyprus International Tournament,3
Georgia,Armenia,0,2,Cyprus International Tournament,2
Poland,Faroe Islands,6,0,Friendly,6
Turks and Caicos Islands,Haiti,0,2,FIFA World Cup qualification,2
Faroe Islands,Luxembourg,4,2,Friendly,2
Grenada,Guyana,5,0,FIFA World Cup qualification,5
Bermuda,Montserrat,13,0,FIFA World Cup qualification,13
Guyana,Grenada,1,3,FIFA World Cup qualification,2
China PR,Myanmar,2,0,Friendly,2
Cuba,Panama,3,0,Friendly,3
Saint Kitts and Nevis,British Virgin Islands,4,0,Friendly,4
Dominican Republic,Anguilla,6,0,FIFA World Cup qualification,6
Montserrat,Bermuda,0,7,FIFA World Cup qualification,7
Bahrain,Jordan,0,2,Friendly,2
Cuba,Cayman Islands,3,0,FIFA World Cup qualification,3
Suriname,Aruba,8,1,FIFA World Cup qualification,7
Bahamas,Dominica,1,3,FIFA World Cup qualification,2
Saint Lucia,British Virgin Islands,9,0,FIFA World Cup qualification,9
Bolivia,Chile,0,2,FIFA World Cup qualification,2
Bermuda,Nicaragua,3,0,Friendly,3
Curaçao,Antigua and Barbuda,3,0,FIFA World Cup qualification,3
El Salvador,Guatemala,0,3,Friendly,3
Germany,Belgium,3,0,Friendly,3
India,Oman,1,5,FIFA World Cup qualification,4
Laos,Iran,0,7,FIFA World Cup qualification,7
Malaysia,Kuwait,0,2,FIFA World Cup qualification,2
Mexico,Costa Rica,2,0,Friendly,2
Morocco,Angola,3,1,Friendly,2
Peru,Colombia,0,2,FIFA World Cup qualification,2
Spain,Denmark,2,0,Friendly,2
Saint Kitts and Nevis,United States Virgin Islands,7,0,FIFA World Cup qualification,7
Tunisia,Ivory Coast,0,2,Friendly,2
Turkmenistan,Indonesia,3,1,FIFA World Cup qualification,2
Uruguay,Venezuela,0,3,FIFA World Cup qualification,3
Vietnam,Lebanon,0,2,FIFA World Cup qualification,2
Yemen,Thailand,0,3,FIFA World Cup qualification,3
Mozambique,Eswatini,2,0,Friendly,2
Mozambique,Madagascar,2,0,COSAFA Cup,2
Curaçao,Dominican Republic,3,1,Friendly,2
Austria,Luxembourg,4,1,Friendly,3
Bulgaria,Cameroon,3,0,Friendly,3
El Salvador,Colombia,0,2,Friendly,2
Hungary,Brazil,1,4,Friendly,3
Ivory Coast,Guinea,4,2,Friendly,2
Netherlands,Greece,4,0,Friendly,4
Panama,Bermuda,4,1,Friendly,3
Romania,Germany,5,1,Friendly,4
Nicaragua,Bermuda,2,0,Friendly,2
Nicaragua,Bermuda,2,0,Friendly,2
Jersey,Guernsey,3,0,Friendly,3
Samoa,American Samoa,4,0,FIFA World Cup qualification,4
Solomon Islands,Tonga,6,0,FIFA World Cup qualification,6
Tahiti,Cook Islands,2,0,FIFA World Cup qualification,2
American Samoa,Vanuatu,1,9,FIFA World Cup qualification,8
Fiji,Papua New Guinea,4,2,FIFA World Cup qualification,2
Solomon Islands,Cook Islands,5,0,FIFA World Cup qualification,5
Fiji,American Samoa,11,0,FIFA World Cup qualification,11
Samoa,Vanuatu,0,3,FIFA World Cup qualification,3
Solomon Islands,New Caledonia,2,0,FIFA World Cup qualification,2
American Samoa,Papua New Guinea,0,10,FIFA World Cup qualification,10
New Caledonia,Cook Islands,8,0,FIFA World Cup qualification,8
Samoa,Fiji,0,4,FIFA World Cup qualification,4
Tahiti,Tonga,2,0,FIFA World Cup qualification,2
Fiji,Vanuatu,0,3,FIFA World Cup qualification,3
New Caledonia,Tonga,8,0,FIFA World Cup qualification,8
Samoa,Papua New Guinea,1,4,FIFA World Cup qualification,3
Australia,Turkey,1,3,Friendly,2
Zambia,Malawi,0,2,Friendly,2
DR Congo,Angola,1,3,Friendly,2
Trinidad and Tobago,Iraq,2,0,Friendly,2
Egypt,Zimbabwe,2,0,Friendly,2
Sudan,Zambia,0,2,Friendly,2
Catalonia,Brazil,2,5,Friendly,3
Germany,Malta,7,0,Friendly,7
Azerbaijan,Uzbekistan,3,1,Friendly,2
Finland,Sweden,1,3,Friendly,2
France,Andorra,4,0,Friendly,4
Egypt,Gabon,2,0,Friendly,2
Republic of Ireland,Nigeria,0,3,Friendly,3
Portugal,Luxembourg,3,0,Friendly,3
Scotland,Trinidad and Tobago,4,1,Friendly,3
Saint Vincent and the Grenadines,Martinique,2,0,Friendly,2
Tunisia,Italy,0,4,Friendly,4
Australia,Tahiti,9,0,Oceania Nations Cup,9
New Zealand,Solomon Islands,3,0,Oceania Nations Cup,3
Nigeria,Jamaica,2,0,Friendly,2
Oman,Maldives,3,0,Friendly,3
Qatar,Turkmenistan,5,0,Friendly,5
Netherlands,Faroe Islands,3,0,Friendly,3
Uruguay,Peru,1,3,FIFA World Cup qualification,2
Australia,Fiji,6,1,Oceania Nations Cup,5
Brazil,Argentina,3,1,FIFA World Cup qualification,2
Czech Republic,Bulgaria,3,1,Friendly,2
Grenada,Saint Lucia,2,0,Friendly,2
New Zealand,Vanuatu,2,4,Oceania Nations Cup,2
Saint Kitts and Nevis,Northern Ireland,0,2,Friendly,2
Switzerland,Germany,0,2,Friendly,2
Tahiti,Solomon Islands,0,4,Oceania Nations Cup,4
United States,Honduras,4,0,Friendly,4
Liechtenstein,Greece,0,2,Friendly,2
Oman,Maldives,4,1,Friendly,3
Australia,Vanuatu,3,0,Oceania Nations Cup,3
Costa Rica,Nicaragua,5,1,Friendly,4
New Zealand,Tahiti,10,0,Oceania Nations Cup,10
England,Iceland,6,1,Friendly,5
Nigeria,Rwanda,2,0,FIFA World Cup qualification,2
Portugal,Lithuania,4,1,Friendly,3
Senegal,Congo,2,0,FIFA World Cup qualification,2
Spain,Andorra,4,0,Friendly,4
Sweden,Poland,3,1,Friendly,2
Tunisia,Botswana,4,1,FIFA World Cup qualification,3
Colombia,Uruguay,5,0,FIFA World Cup qualification,5
Czech Republic,Estonia,2,0,Friendly,2
Fiji,New Zealand,0,2,Oceania Nations Cup,2
Germany,Hungary,0,2,Friendly,2
Ivory Coast,Libya,2,0,FIFA World Cup qualification,2
Sudan,Egypt,0,3,FIFA World Cup qualification,3
Trinidad and Tobago,Northern Ireland,0,3,Friendly,3
Bahrain,Kyrgyzstan,5,0,FIFA World Cup qualification,5
China PR,Malaysia,4,0,FIFA World Cup qualification,4
Iraq,Taiwan,6,1,FIFA World Cup qualification,5
Japan,India,7,0,FIFA World Cup qualification,7
South Korea,Vietnam,2,0,FIFA World Cup qualification,2
Kuwait,Hong Kong,4,0,FIFA World Cup qualification,4
Lebanon,Maldives,3,0,FIFA World Cup qualification,3
Oman,Singapore,7,0,FIFA World Cup qualification,7
Qatar,Laos,5,0,FIFA World Cup qualification,5
Saudi Arabia,Turkmenistan,3,0,FIFA World Cup qualification,3
Thailand,North Korea,1,4,FIFA World Cup qualification,3
United Arab Emirates,Yemen,3,0,FIFA World Cup qualification,3
Uzbekistan,Palestine,3,0,FIFA World Cup qualification,3
Estonia,North Macedonia,2,4,Friendly,2
Barbados,Saint Kitts and Nevis,0,2,FIFA World Cup qualification,2
Burkina Faso,Benin,4,2,Friendly,2
Canada,Belize,4,0,FIFA World Cup qualification,4
Cape Verde,Senegal,1,3,Friendly,2
Dominican Republic,Trinidad and Tobago,0,2,FIFA World Cup qualification,2
Mozambique,Malawi,2,0,COSAFA Cup,2
Panama,Saint Lucia,4,0,FIFA World Cup qualification,4
United States,Grenada,3,0,FIFA World Cup qualification,3
Sweden,Bulgaria,5,0,UEFA Euro,5
Canada,Belize,4,0,FIFA World Cup qualification,4
Portugal,Russia,2,0,UEFA Euro,2
England,Switzerland,3,0,UEFA Euro,3
Iran,Lebanon,4,0,WAFF Championship,4
Bulgaria,Denmark,0,2,UEFA Euro,2
Botswana,Malawi,2,0,FIFA World Cup qualification,2
Dominica,Mexico,0,10,FIFA World Cup qualification,10
Honduras,Curaçao,4,0,FIFA World Cup qualification,4
Rwanda,Gabon,3,1,FIFA World Cup qualification,2
Syria,Lebanon,3,1,WAFF Championship,2
Congo,Liberia,3,0,FIFA World Cup qualification,3
Ghana,South Africa,3,0,FIFA World Cup qualification,3
Guatemala,Suriname,3,1,FIFA World Cup qualification,2
Jamaica,Haiti,3,0,FIFA World Cup qualification,3
Saint Lucia,Panama,0,3,FIFA World Cup qualification,3
Togo,Senegal,3,1,FIFA World Cup qualification,2
Trinidad and Tobago,Dominican Republic,4,0,FIFA World Cup qualification,4
Saint Vincent and the Grenadines,Nicaragua,4,1,FIFA World Cup qualification,3
Croatia,England,2,4,UEFA Euro,2
Iran,Syria,7,1,WAFF Championship,6
Jordan,Iraq,2,0,WAFF Championship,2
Switzerland,France,1,3,UEFA Euro,2
Netherlands,Latvia,3,0,UEFA Euro,3
Iran,Syria,4,1,WAFF Championship,3
Iraq,Jordan,1,3,WAFF Championship,2
Argentina,Colombia,0,2,Friendly,2
Czech Republic,Denmark,3,0,UEFA Euro,3
Mexico,Dominica,8,0,FIFA World Cup qualification,8
Eswatini,Zimbabwe,0,5,COSAFA Cup,5
China PR,Lebanon,6,0,Friendly,6
Rwanda,Zimbabwe,0,2,FIFA World Cup qualification,2
South Africa,Burkina Faso,2,0,FIFA World Cup qualification,2
Cameroon,Ivory Coast,2,0,FIFA World Cup qualification,2
Thailand,Bahrain,0,2,Friendly,2
Argentina,Ecuador,6,1,Copa América,5
Japan,Slovakia,3,1,Kirin Cup,2
Peru,Venezuela,3,1,Copa América,2
South Korea,Bahrain,2,0,Friendly,2
Brazil,Costa Rica,4,1,Copa América,3
Serbia,Slovakia,2,0,Kirin Cup,2
Malaysia,Singapore,2,0,Friendly,2
Argentina,Uruguay,4,2,Copa América,2
Colombia,Costa Rica,2,0,Copa América,2
Mexico,Brazil,0,4,Copa América,4
Paraguay,Uruguay,1,3,Copa América,2
Kuwait,United Arab Emirates,3,1,AFC Asian Cup,2
Argentina,Colombia,3,0,Copa América,3
Iran,Thailand,3,0,AFC Asian Cup,3
China PR,Indonesia,5,0,AFC Asian Cup,5
Jordan,Kuwait,2,0,AFC Asian Cup,2
United Arab Emirates,South Korea,0,2,AFC Asian Cup,2
Thailand,Japan,1,4,AFC Asian Cup,3
Bahrain,Indonesia,3,1,AFC Asian Cup,2
South Korea,Kuwait,4,0,AFC Asian Cup,4
Oman,Thailand,2,0,AFC Asian Cup,2
China PR,Iraq,3,0,AFC Asian Cup,3
Zambia,Mauritius,3,1,COSAFA Cup,2
El Salvador,Honduras,0,4,Friendly,4
El Salvador,Guatemala,0,2,Friendly,2
Iran,Bahrain,4,2,AFC Asian Cup,2
China PR,Japan,1,3,AFC Asian Cup,2
Guatemala,Trinidad and Tobago,4,1,Friendly,3
Austria,Germany,1,3,Friendly,2
Canada,Guatemala,0,2,FIFA World Cup qualification,2
DR Congo,Mali,0,3,Friendly,3
Costa Rica,Honduras,2,5,FIFA World Cup qualification,3
England,Ukraine,3,0,Friendly,3
Haiti,Brazil,0,6,Friendly,6
Iceland,Italy,2,0,Friendly,2
Kenya,Uganda,4,1,Friendly,3
Latvia,Wales,0,2,Friendly,2
Poland,Denmark,1,5,Friendly,4
Scotland,Hungary,0,3,Friendly,3
Slovakia,Luxembourg,3,1,FIFA World Cup qualification,2
Tunisia,South Africa,0,2,Friendly,2
Zimbabwe,Botswana,2,0,Friendly,2
North Macedonia,Armenia,3,0,FIFA World Cup qualification,3
Saint Vincent and the Grenadines,Trinidad and Tobago,0,2,FIFA World Cup qualification,2
Vietnam,Myanmar,5,0,Friendly,5
Zimbabwe,Uganda,2,0,Friendly,2
Libya,Benin,4,1,FIFA World Cup qualification,3
Netherlands,Liechtenstein,3,0,Friendly,3
Burkina Faso,Uganda,2,0,FIFA World Cup qualification,2
Croatia,Hungary,3,0,FIFA World Cup qualification,3
Estonia,Luxembourg,4,0,FIFA World Cup qualification,4
Finland,Andorra,3,0,FIFA World Cup qualification,3
Iceland,Bulgaria,1,3,FIFA World Cup qualification,2
Republic of Ireland,Cyprus,3,0,FIFA World Cup qualification,3
Latvia,Portugal,0,2,FIFA World Cup qualification,2
Malta,Sweden,0,7,FIFA World Cup qualification,7
Northern Ireland,Poland,0,3,FIFA World Cup qualification,3
Peru,Argentina,1,3,FIFA World Cup qualification,2
San Marino,Serbia,0,3,FIFA World Cup qualification,3
Singapore,Indonesia,2,0,Friendly,2
Slovenia,Moldova,3,0,FIFA World Cup qualification,3
Switzerland,Faroe Islands,6,0,FIFA World Cup qualification,6
United States,El Salvador,2,0,FIFA World Cup qualification,2
Algeria,Gabon,0,3,FIFA World Cup qualification,3
Brazil,Bolivia,3,1,FIFA World Cup qualification,2
Ghana,Cape Verde,2,0,FIFA World Cup qualification,2
Guinea,Botswana,4,0,FIFA World Cup qualification,4
Ivory Coast,Sudan,5,0,FIFA World Cup qualification,5
Togo,Congo,2,0,FIFA World Cup qualification,2
Zimbabwe,Nigeria,0,3,FIFA World Cup qualification,3
Andorra,Romania,1,5,FIFA World Cup qualification,4
Armenia,Finland,0,2,FIFA World Cup qualification,2
Austria,Azerbaijan,2,0,FIFA World Cup qualification,2
El Salvador,Jamaica,0,3,FIFA World Cup qualification,3
Faroe Islands,France,0,2,FIFA World Cup qualification,2
Georgia,Albania,2,0,FIFA World Cup qualification,2
Hong Kong,Kuwait,0,2,FIFA World Cup qualification,2
India,Japan,0,4,FIFA World Cup qualification,4
Jordan,Iran,0,2,FIFA World Cup qualification,2
North Korea,Thailand,4,1,FIFA World Cup qualification,3
Laos,Qatar,1,6,FIFA World Cup qualification,5
Lithuania,San Marino,4,0,FIFA World Cup qualification,4
Maldives,Lebanon,2,5,FIFA World Cup qualification,3
Netherlands,Czech Republic,2,0,FIFA World Cup qualification,2
Palestine,Uzbekistan,0,3,FIFA World Cup qualification,3
Portugal,Estonia,4,0,FIFA World Cup qualification,4
Singapore,Oman,0,2,FIFA World Cup qualification,2
Slovakia,Liechtenstein,7,0,FIFA World Cup qualification,7
Trinidad and Tobago,Mexico,1,3,FIFA World Cup qualification,2
Yemen,United Arab Emirates,3,1,FIFA World Cup qualification,2
Taiwan,Iraq,1,4,FIFA World Cup qualification,3
Gabon,Benin,2,0,Friendly,2
Lebanon,Kuwait,1,3,Friendly,2
Mexico,Saint Vincent and the Grenadines,7,0,FIFA World Cup qualification,7
Albania,Denmark,0,2,FIFA World Cup qualification,2
Argentina,Uruguay,4,2,FIFA World Cup qualification,2
Austria,Poland,1,3,FIFA World Cup qualification,2
Belarus,Moldova,4,0,FIFA World Cup qualification,4
Costa Rica,Guatemala,5,0,FIFA World Cup qualification,5
El Salvador,United States,0,2,FIFA World Cup qualification,2
England,Wales,2,0,FIFA World Cup qualification,2
Finland,Armenia,3,1,FIFA World Cup qualification,2
Iran,Germany,0,2,Friendly,2
Luxembourg,Russia,0,4,FIFA World Cup qualification,4
Slovakia,Latvia,4,1,FIFA World Cup qualification,3
Solomon Islands,Australia,1,5,Oceania Nations Cup,4
Spain,Belgium,2,0,FIFA World Cup qualification,2
Sweden,Hungary,3,0,FIFA World Cup qualification,3
Turkey,Kazakhstan,4,0,FIFA World Cup qualification,4
Venezuela,Brazil,2,5,FIFA World Cup qualification,3
Ecuador,Chile,2,0,FIFA World Cup qualification,2
Liberia,Senegal,0,3,FIFA World Cup qualification,3
Trinidad and Tobago,Saint Kitts and Nevis,5,1,FIFA World Cup qualification,4
Australia,Solomon Islands,6,0,Oceania Nations Cup,6
Indonesia,Saudi Arabia,1,3,FIFA World Cup qualification,2
Armenia,Czech Republic,0,3,FIFA World Cup qualification,3
Bulgaria,Malta,4,1,FIFA World Cup qualification,3
Canada,Costa Rica,1,3,FIFA World Cup qualification,2
Cyprus,France,0,2,FIFA World Cup qualification,2
Hong Kong,Malaysia,2,0,FIFA World Cup qualification,2
Iceland,Sweden,1,4,FIFA World Cup qualification,3
Republic of Ireland,Faroe Islands,2,0,FIFA World Cup qualification,2
Luxembourg,Liechtenstein,0,4,FIFA World Cup qualification,4
Maldives,Vietnam,3,0,FIFA World Cup qualification,3
Mexico,Trinidad and Tobago,3,0,FIFA World Cup qualification,3
Netherlands,Finland,3,1,FIFA World Cup qualification,2
Norway,Slovenia,3,0,FIFA World Cup qualification,3
Portugal,Russia,7,1,FIFA World Cup qualification,6
Serbia,San Marino,5,0,FIFA World Cup qualification,5
Singapore,India,2,0,FIFA World Cup qualification,2
Saint Kitts and Nevis,Saint Vincent and the Grenadines,0,3,FIFA World Cup qualification,3
Thailand,United Arab Emirates,3,0,FIFA World Cup qualification,3
Ukraine,Georgia,2,0,FIFA World Cup qualification,2
United States,Panama,6,0,FIFA World Cup qualification,6
Venezuela,Ecuador,3,1,FIFA World Cup qualification,2
Jersey,Kernow,1,4,Friendly,3
Saint Lucia,Grenada,3,1,Friendly,2
Ecuador,Jordan,0,3,Friendly,3
Saint Kitts and Nevis,Montserrat,6,1,CFU Caribbean Cup qualification,5
Saint Kitts and Nevis,Antigua and Barbuda,2,0,CFU Caribbean Cup qualification,2
Kuwait,Kyrgyzstan,3,0,Friendly,3
Martinique,Dominica,5,1,CFU Caribbean Cup qualification,4
Mexico,Guatemala,2,0,Friendly,2
United Arab Emirates,Jordan,4,0,Friendly,4
Guadeloupe,Dominica,7,0,CFU Caribbean Cup qualification,7
Saint Kitts and Nevis,Mexico,0,5,FIFA World Cup qualification,5
Dominica,French Guiana,0,4,CFU Caribbean Cup qualification,4
Iraq,Palestine,4,1,FIFA World Cup qualification,3
Andorra,Netherlands,0,3,FIFA World Cup qualification,3
Bahrain,Tajikistan,4,0,FIFA World Cup qualification,4
Belgium,Serbia,0,2,FIFA World Cup qualification,2
China PR,Hong Kong,7,0,FIFA World Cup qualification,7
Germany,Cameroon,3,0,Friendly,3
Greece,Kazakhstan,3,1,FIFA World Cup qualification,2
Indonesia,Turkmenistan,3,1,FIFA World Cup qualification,2
Iran,Laos,7,0,FIFA World Cup qualification,7
South Korea,Maldives,2,0,FIFA World Cup qualification,2
Kuwait,Malaysia,6,1,FIFA World Cup qualification,5
Liechtenstein,Latvia,1,3,FIFA World Cup qualification,2
Luxembourg,Portugal,0,5,FIFA World Cup qualification,5
North Macedonia,Czech Republic,0,2,FIFA World Cup qualification,2
Malta,Hungary,0,2,FIFA World Cup qualification,2
Mexico,Saint Kitts and Nevis,8,0,FIFA World Cup qualification,8
Morocco,Burkina Faso,4,0,Friendly,4
Panama,El Salvador,3,0,FIFA World Cup qualification,3
Qatar,Jordan,2,0,FIFA World Cup qualification,2
Russia,Estonia,4,0,FIFA World Cup qualification,4
Saudi Arabia,Sri Lanka,3,0,FIFA World Cup qualification,3
Scotland,Sweden,1,4,Friendly,3
Turkey,Ukraine,0,3,FIFA World Cup qualification,3
Uzbekistan,Taiwan,6,1,FIFA World Cup qualification,5
Haiti,United States Virgin Islands,11,0,CFU Caribbean Cup qualification,11
Jamaica,Saint Martin,12,0,CFU Caribbean Cup qualification,12
Trinidad and Tobago,Puerto Rico,5,0,CFU Caribbean Cup qualification,5
Jamaica,United States Virgin Islands,11,1,CFU Caribbean Cup qualification,10
Saint Martin,Haiti,0,2,CFU Caribbean Cup qualification,2
Trinidad and Tobago,Grenada,2,0,CFU Caribbean Cup qualification,2
Bermuda,British Virgin Islands,0,2,CFU Caribbean Cup qualification,2
Grenada,Puerto Rico,5,2,CFU Caribbean Cup qualification,3
Jamaica,Haiti,3,1,CFU Caribbean Cup qualification,2
Qatar,Lebanon,4,1,Friendly,3
Hungary,Estonia,5,0,King's Cup,5
Iraq,Yemen,3,1,Friendly,2
Qatar,Yemen,3,0,Friendly,3
Kuwait,Tajikistan,3,0,Friendly,3
Laos,Indonesia,0,6,AFF Championship,6
Malaysia,Timor-Leste,5,0,AFF Championship,5
Vietnam,Cambodia,9,1,AFF Championship,8
Iraq,Oman,1,3,Gulf Cup,2
Malaysia,Philippines,4,1,AFF Championship,3
Rwanda,Zanzibar,4,2,CECAFA Cup,2
Vietnam,Indonesia,0,3,AFF Championship,3
British Virgin Islands,Trinidad and Tobago,0,4,CFU Caribbean Cup qualification,4
Cuba,Martinique,2,0,CFU Caribbean Cup qualification,2
Timor-Leste,Thailand,0,8,AFF Championship,8
Uganda,Somalia,2,0,CECAFA Cup,2
Burundi,Rwanda,3,1,CECAFA Cup,2
Indonesia,Cambodia,8,0,AFF Championship,8
Singapore,Laos,6,2,AFF Championship,4
Zanzibar,Tanzania,4,2,CECAFA Cup,2
Saudi Arabia,Yemen,2,0,Gulf Cup,2
Cambodia,Singapore,0,3,AFF Championship,3
Saint Kitts and Nevis,Haiti,0,2,CFU Caribbean Cup qualification,2
Tanzania,Burundi,0,2,CECAFA Cup,2
Vietnam,Laos,3,0,AFF Championship,3
Myanmar,Timor-Leste,3,1,AFF Championship,2
Japan,Germany,0,3,Friendly,3
Thailand,Philippines,3,1,AFF Championship,2
Bahrain,Saudi Arabia,3,0,Gulf Cup,3
Ethiopia,Tanzania,2,0,CECAFA Cup,2
Kuwait,Yemen,3,0,Gulf Cup,3
Sudan,Somalia,4,0,CECAFA Cup,4
Ethiopia,Zanzibar,3,0,CECAFA Cup,3
South Korea,Germany,3,1,Friendly,2
Tanzania,Rwanda,1,5,CECAFA Cup,4
Trinidad and Tobago,British Virgin Islands,2,0,CFU Caribbean Cup qualification,2
Qatar,Kuwait,2,0,Gulf Cup,2
Martinique,Cuba,0,2,CFU Caribbean Cup qualification,2
Thailand,Germany,1,5,Friendly,4
Bahrain,Kuwait,3,1,Gulf Cup,2
Ethiopia,Burundi,3,0,CECAFA Cup,3
Basque Country,Honduras,2,0,Friendly,2
Catalonia,Argentina,0,3,Friendly,3
Singapore,Myanmar,4,2,AFF Championship,2
Malaysia,Indonesia,1,4,AFF Championship,3
Egypt,Uganda,3,0,Friendly,3
Indonesia,Singapore,1,3,AFF Championship,2
Jamaica,French Guiana,5,0,CFU Caribbean Cup qualification,5
Barbados,Grenada,3,0,Friendly,3
Trinidad and Tobago,Azerbaijan,2,0,Friendly,2
Saudi Arabia,Tajikistan,3,0,Friendly,3
Ecuador,Panama,2,0,Friendly,2
Ecuador,Panama,2,0,Friendly,2
Japan,Kazakhstan,4,0,Friendly,4
Japan,Syria,3,0,Friendly,3
Albania,Ukraine,0,2,FIFA World Cup qualification,2
Algeria,Burkina Faso,3,0,Friendly,3
Chile,Ecuador,3,0,Friendly,3
Egypt,Belgium,4,0,Friendly,4
Hong Kong,Brazil,1,7,Lunar New Year Cup,6
Italy,Russia,2,0,Friendly,2
South Korea,Kuwait,2,0,FIFA World Cup qualification,2
Malta,Norway,0,3,Friendly,3
Morocco,Kenya,5,1,FIFA World Cup qualification,4
Poland,Belarus,1,3,Friendly,2
Slovenia,Czech Republic,0,3,Friendly,3
Spain,San Marino,5,0,FIFA World Cup qualification,5
Venezuela,Estonia,3,0,Friendly,3
Wales,Hungary,2,0,Friendly,2
Guatemala,Belize,2,0,UNCAF Cup,2
Honduras,Nicaragua,5,1,UNCAF Cup,4
Barbados,Cuba,0,3,CFU Caribbean Cup,3
Belize,Honduras,0,4,UNCAF Cup,4
Guatemala,Nicaragua,4,0,UNCAF Cup,4
Congo,Angola,0,2,Friendly,2
Guatemala,Costa Rica,0,4,UNCAF Cup,4
Mauritius,Madagascar,2,0,COSAFA Cup,2
Seychelles,South Africa,0,3,COSAFA Cup,3
Guatemala,Panama,3,0,UNCAF Cup,3
Hong Kong,Mongolia,6,0,EAFF Championship,6
Guam,Hong Kong,0,15,EAFF Championship,15
North Korea,Mongolia,6,0,EAFF Championship,6
Mongolia,Guam,4,1,EAFF Championship,3
United States,Colombia,3,0,Friendly,3
Guam,North Korea,0,21,EAFF Championship,21
Sudan,Ethiopia,3,1,Friendly,2
Hong Kong,North Korea,0,2,EAFF Championship,2
Kuwait,Armenia,3,1,Friendly,2
Saudi Arabia,Finland,1,4,Friendly,3
Saudi Arabia,South Korea,2,0,FIFA World Cup qualification,2
Belgium,Bosnia and Herzegovina,4,1,FIFA World Cup qualification,3
Bulgaria,Sweden,0,3,FIFA World Cup qualification,3
Croatia,Iceland,4,0,FIFA World Cup qualification,4
Denmark,Kazakhstan,3,0,FIFA World Cup qualification,3
England,Northern Ireland,4,0,FIFA World Cup qualification,4
Georgia,Greece,1,3,FIFA World Cup qualification,2
Guatemala,Trinidad and Tobago,5,1,FIFA World Cup qualification,4
Italy,Scotland,2,0,FIFA World Cup qualification,2
Nigeria,Gabon,2,0,FIFA World Cup qualification,2
Poland,Azerbaijan,8,0,FIFA World Cup qualification,8
Portugal,Canada,4,1,Friendly,3
Romania,Netherlands,0,2,FIFA World Cup qualification,2
Senegal,Liberia,6,1,FIFA World Cup qualification,5
Spain,China PR,3,0,Friendly,3
Tunisia,Malawi,7,0,FIFA World Cup qualification,7
Turkey,Albania,2,0,FIFA World Cup qualification,2
Wales,Austria,0,2,FIFA World Cup qualification,2
Zambia,Congo,2,0,FIFA World Cup qualification,2
Ecuador,Paraguay,5,2,FIFA World Cup qualification,3
Egypt,Libya,4,1,FIFA World Cup qualification,3
Ivory Coast,Benin,3,0,FIFA World Cup qualification,3
Zimbabwe,Angola,2,0,FIFA World Cup qualification,2
Australia,Indonesia,3,0,Friendly,3
Bolivia,Venezuela,3,1,FIFA World Cup qualification,2
Andorra,Czech Republic,0,4,FIFA World Cup qualification,4
Croatia,Malta,3,0,FIFA World Cup qualification,3
England,Azerbaijan,2,0,FIFA World Cup qualification,2
Georgia,Turkey,2,5,FIFA World Cup qualification,3
Greece,Albania,2,0,FIFA World Cup qualification,2
North Korea,Iran,0,2,FIFA World Cup qualification,2
Latvia,Luxembourg,4,0,FIFA World Cup qualification,4
Netherlands,Armenia,2,0,FIFA World Cup qualification,2
United States,Guatemala,2,0,FIFA World Cup qualification,2
Mozambique,Zimbabwe,0,3,COSAFA Cup,3
Botswana,Zimbabwe,0,2,COSAFA Cup,2
Brazil,Guatemala,3,0,Friendly,3
Lithuania,Latvia,2,0,Baltic Cup,2
Sudan,Chad,4,1,Friendly,3
Trinidad and Tobago,Bermuda,4,0,Friendly,4
Gibraltar,Monaco,4,0,Friendly,4
Tunisia,Angola,4,1,Friendly,3
Hong Kong,Macau,8,1,Friendly,7
Saudi Arabia,Kuwait,3,0,FIFA World Cup qualification,3
Azerbaijan,Poland,0,3,FIFA World Cup qualification,3
Benin,Cameroon,1,4,FIFA World Cup qualification,3
Botswana,Tunisia,1,3,FIFA World Cup qualification,2
Bulgaria,Croatia,1,3,FIFA World Cup qualification,2
Chile,Bolivia,3,1,FIFA World Cup qualification,2
Colombia,Peru,5,0,FIFA World Cup qualification,5
Czech Republic,Andorra,8,1,FIFA World Cup qualification,7
Ecuador,Argentina,2,0,FIFA World Cup qualification,2
Estonia,Liechtenstein,2,0,FIFA World Cup qualification,2
Faroe Islands,Switzerland,1,3,FIFA World Cup qualification,2
Guatemala,Mexico,0,2,FIFA World Cup qualification,2
Morocco,Malawi,4,1,FIFA World Cup qualification,3
Netherlands,Romania,2,0,FIFA World Cup qualification,2
Northern Ireland,Germany,1,4,Friendly,3
Portugal,Slovakia,2,0,FIFA World Cup qualification,2
Russia,Latvia,2,0,FIFA World Cup qualification,2
San Marino,Bosnia and Herzegovina,1,3,FIFA World Cup qualification,2
Scotland,Moldova,2,0,FIFA World Cup qualification,2
Singapore,Malaysia,2,0,Friendly,2
Sweden,Malta,6,0,FIFA World Cup qualification,6
Trinidad and Tobago,Panama,2,0,FIFA World Cup qualification,2
Ukraine,Kazakhstan,2,0,FIFA World Cup qualification,2
United States,Costa Rica,3,0,FIFA World Cup qualification,3
Brazil,Paraguay,4,1,FIFA World Cup qualification,3
DR Congo,Uganda,4,0,FIFA World Cup qualification,4
Egypt,Sudan,6,1,FIFA World Cup qualification,5
Mali,Liberia,4,1,FIFA World Cup qualification,3
Togo,Zambia,4,1,FIFA World Cup qualification,3
Argentina,Brazil,3,1,FIFA World Cup qualification,2
Colombia,Ecuador,3,0,FIFA World Cup qualification,3
Czech Republic,North Macedonia,6,1,FIFA World Cup qualification,5
Denmark,Albania,3,1,FIFA World Cup qualification,2
Faroe Islands,Republic of Ireland,0,2,FIFA World Cup qualification,2
Finland,Netherlands,0,4,FIFA World Cup qualification,4
Iceland,Malta,4,1,FIFA World Cup qualification,3
Kazakhstan,Turkey,0,6,FIFA World Cup qualification,6
North Korea,Japan,0,2,FIFA World Cup qualification,2
Kuwait,South Korea,0,4,FIFA World Cup qualification,4
Luxembourg,Slovakia,0,4,FIFA World Cup qualification,4
Mexico,Trinidad and Tobago,2,0,FIFA World Cup qualification,2
Panama,United States,0,3,FIFA World Cup qualification,3
Paraguay,Bolivia,4,1,FIFA World Cup qualification,3
Romania,Armenia,3,0,FIFA World Cup qualification,3
Saudi Arabia,Uzbekistan,3,0,FIFA World Cup qualification,3
Sierra Leone,Liberia,2,0,Friendly,2
Tunisia,Guinea,2,0,FIFA World Cup qualification,2
Zambia,Eswatini,3,0,COSAFA Cup,3
Algeria,Mali,0,3,Friendly,3
Sierra Leone,Guinea,2,0,Friendly,2
Brazil,Greece,3,0,Confederations Cup,3
Australia,Argentina,2,4,Confederations Cup,2
Burkina Faso,DR Congo,2,0,FIFA World Cup qualification,2
Gabon,Rwanda,3,0,FIFA World Cup qualification,3
Germany,Tunisia,3,0,Confederations Cup,3
Malawi,Botswana,1,3,FIFA World Cup qualification,2
Pakistan,India,3,0,Friendly,3
South Africa,Ghana,0,2,FIFA World Cup qualification,2
Ivory Coast,Egypt,2,0,FIFA World Cup qualification,2
Liberia,Congo,0,2,FIFA World Cup qualification,2
Australia,Tunisia,0,2,Confederations Cup,2
China PR,Costa Rica,2,0,Friendly,2
Brazil,Argentina,4,1,Confederations Cup,3
United States,Cuba,4,1,Gold Cup,3
Costa Rica,Cuba,3,1,Gold Cup,2
United States,Canada,2,0,Gold Cup,2
Mexico,Guatemala,4,0,Gold Cup,4
Shetland,Falkland Islands,4,0,Island Games,4
Guernsey,Orkney,3,0,Island Games,3
Shetland,Åland Islands,3,1,Island Games,2
Colombia,Trinidad and Tobago,2,0,Gold Cup,2
Orkney,Ynys Môn,0,2,Island Games,2
Falkland Islands,Isle of Man,0,9,Island Games,9
Greenland,Guernsey,0,6,Island Games,6
Guernsey,Ynys Môn,3,0,Island Games,3
Orkney,Falkland Islands,2,0,Island Games,2
Western Isles,Isle of Man,4,0,Island Games,4
Shetland,Guernsey,2,0,Island Games,2
United States,Jamaica,3,1,Gold Cup,2
Bahrain,Turkmenistan,5,0,Friendly,5
China PR,North Korea,2,0,EAFF Championship,2
South Korea,North Korea,3,0,Friendly,3
DR Congo,Guinea,3,1,Friendly,2
Belgium,Greece,2,0,Friendly,2
Bulgaria,Turkey,3,1,Friendly,2
Denmark,England,4,1,Friendly,3
Ecuador,Venezuela,3,1,Friendly,2
Faroe Islands,Cyprus,0,3,FIFA World Cup qualification,3
France,Ivory Coast,3,0,Friendly,3
Iceland,South Africa,4,1,Friendly,3
North Macedonia,Finland,0,3,FIFA World Cup qualification,3
Mexico,Costa Rica,2,0,FIFA World Cup qualification,2
Norway,Switzerland,0,2,Friendly,2
Paraguay,El Salvador,3,0,Friendly,3
Peru,Chile,3,1,Friendly,2
Portugal,Egypt,2,0,Friendly,2
Romania,Andorra,2,0,FIFA World Cup qualification,2
Spain,Uruguay,2,0,Friendly,2
Iran,Libya,4,0,Friendly,4
Australia,Solomon Islands,7,0,FIFA World Cup qualification,7
Burkina Faso,South Africa,3,1,FIFA World Cup qualification,2
France,Faroe Islands,3,0,FIFA World Cup qualification,3
Hungary,Malta,4,0,FIFA World Cup qualification,4
Iceland,Croatia,1,3,FIFA World Cup qualification,2
Kenya,Tunisia,0,2,FIFA World Cup qualification,2
Mali,Congo,2,0,FIFA World Cup qualification,2
Moldova,Belarus,2,0,FIFA World Cup qualification,2
Northern Ireland,Azerbaijan,2,0,FIFA World Cup qualification,2
Panama,Costa Rica,1,3,FIFA World Cup qualification,2
Portugal,Luxembourg,6,0,FIFA World Cup qualification,6
Romania,Czech Republic,2,0,FIFA World Cup qualification,2
Russia,Liechtenstein,2,0,FIFA World Cup qualification,2
Serbia,Lithuania,2,0,FIFA World Cup qualification,2
Slovakia,Germany,2,0,Friendly,2
Sweden,Bulgaria,3,0,FIFA World Cup qualification,3
United States,Mexico,2,0,FIFA World Cup qualification,2
Venezuela,Peru,4,1,FIFA World Cup qualification,3
Algeria,Nigeria,2,5,FIFA World Cup qualification,3
Angola,Gabon,3,0,FIFA World Cup qualification,3
Brazil,Chile,5,0,FIFA World Cup qualification,5
Egypt,Benin,4,1,FIFA World Cup qualification,3
Ghana,Uganda,2,0,FIFA World Cup qualification,2
Guinea,Malawi,3,1,FIFA World Cup qualification,2
Togo,Liberia,3,0,FIFA World Cup qualification,3
Zimbabwe,Rwanda,3,1,FIFA World Cup qualification,2
Belarus,Italy,1,4,FIFA World Cup qualification,3
Belgium,San Marino,8,0,FIFA World Cup qualification,8
Costa Rica,Trinidad and Tobago,2,0,FIFA World Cup qualification,2
Cyprus,Switzerland,1,3,FIFA World Cup qualification,2
Czech Republic,Armenia,4,1,FIFA World Cup qualification,3
Denmark,Georgia,6,1,FIFA World Cup qualification,5
Faroe Islands,Israel,0,2,FIFA World Cup qualification,2
Finland,North Macedonia,5,1,FIFA World Cup qualification,4
Germany,South Africa,4,2,Friendly,2
Liechtenstein,Luxembourg,3,0,FIFA World Cup qualification,3
Mexico,Panama,5,0,FIFA World Cup qualification,5
Netherlands,Andorra,4,0,FIFA World Cup qualification,4
Malawi,Zimbabwe,2,0,Friendly,2
Guyana,Dominica,3,0,Friendly,3
Liberia,Zambia,0,5,FIFA World Cup qualification,5
Guyana,Dominica,3,0,Friendly,3
Belgium,Spain,0,2,FIFA World Cup qualification,2
Bosnia and Herzegovina,San Marino,3,0,FIFA World Cup qualification,3
Bulgaria,Hungary,2,0,FIFA World Cup qualification,2
Cape Verde,Ghana,0,4,FIFA World Cup qualification,4
Costa Rica,United States,3,0,FIFA World Cup qualification,3
Czech Republic,Netherlands,0,2,FIFA World Cup qualification,2
Lithuania,Serbia,0,2,FIFA World Cup qualification,2
Malawi,Kenya,3,0,FIFA World Cup qualification,3
Mexico,Guatemala,5,2,FIFA World Cup qualification,3
Nigeria,Zimbabwe,5,1,FIFA World Cup qualification,4
Russia,Luxembourg,5,1,FIFA World Cup qualification,4
Senegal,Mali,3,0,FIFA World Cup qualification,3
Sudan,Ivory Coast,1,3,FIFA World Cup qualification,2
Argentina,Peru,2,0,FIFA World Cup qualification,2
Australia,Jamaica,5,0,Friendly,5
Cambodia,Singapore,0,2,Friendly,2
Andorra,Armenia,0,3,FIFA World Cup qualification,3
Austria,Northern Ireland,2,0,FIFA World Cup qualification,2
Brazil,Venezuela,3,0,FIFA World Cup qualification,3
Finland,Czech Republic,0,3,FIFA World Cup qualification,3
France,Cyprus,4,0,FIFA World Cup qualification,4
Guatemala,Costa Rica,3,1,FIFA World Cup qualification,2
South Korea,Iran,2,0,Friendly,2
Luxembourg,Estonia,0,2,FIFA World Cup qualification,2
Peru,Bolivia,4,1,FIFA World Cup qualification,3
Portugal,Latvia,3,0,FIFA World Cup qualification,3
San Marino,Spain,0,6,FIFA World Cup qualification,6
Slovenia,Scotland,0,3,FIFA World Cup qualification,3
Sweden,Iceland,3,1,FIFA World Cup qualification,2
United States,Panama,2,0,FIFA World Cup qualification,2
Wales,Azerbaijan,2,0,FIFA World Cup qualification,2
Madagascar,Mauritius,2,0,Friendly,2
Mexico,Uruguay,3,1,Friendly,2
Bahrain,Panama,5,0,Friendly,5
Puerto Rico,Guadeloupe,1,3,Friendly,2
Tajikistan,Afghanistan,4,0,Friendly,4
Paraguay,Togo,4,2,Friendly,2
Belarus,Latvia,3,1,Friendly,2
Bulgaria,Georgia,6,2,Friendly,4
Netherlands,Italy,1,3,Friendly,2
Portugal,Croatia,2,0,Friendly,2
Spain,Slovakia,5,1,FIFA World Cup qualification,4
Switzerland,Turkey,2,0,FIFA World Cup qualification,2
United Arab Emirates,Brazil,0,8,Friendly,8
China PR,Serbia,0,2,Friendly,2
Ecuador,Poland,0,3,Friendly,3
Iran,Togo,2,0,Friendly,2
Saudi Arabia,Ghana,1,3,Friendly,2
South Korea,Serbia,2,0,Friendly,2
Mexico,Bulgaria,0,3,Friendly,3
Poland,Estonia,3,1,Friendly,2
Qatar,Argentina,0,3,Friendly,3
Romania,Nigeria,3,0,Friendly,3
Syria,United Arab Emirates,0,3,Friendly,3
Turkey,Switzerland,4,2,FIFA World Cup qualification,2
Sudan,Ethiopia,1,5,Friendly,4
Eritrea,Zanzibar,0,3,CECAFA Cup,3
Somalia,Sudan,1,4,CECAFA Cup,3
Djibouti,Uganda,1,6,CECAFA Cup,5
Ethiopia,Sudan,3,1,CECAFA Cup,2
Iraq,Palestine,4,0,Friendly,4
Somalia,Uganda,0,7,CECAFA Cup,7
Djibouti,Ethiopia,0,6,CECAFA Cup,6
Oman,Syria,1,3,Friendly,2
Saudi Arabia,Palestine,2,0,Friendly,2
Sudan,Uganda,0,3,CECAFA Cup,3
Rwanda,Burundi,2,0,CECAFA Cup,2
Djibouti,Sudan,0,4,CECAFA Cup,4
Ethiopia,Somalia,3,1,CECAFA Cup,2
Iraq,Saudi Arabia,5,1,Friendly,4
Rwanda,Tanzania,3,1,CECAFA Cup,2
Maldives,Afghanistan,9,1,SAFF Cup,8
Bangladesh,Bhutan,3,0,SAFF Cup,3
Iraq,Saudi Arabia,2,0,Friendly,2
Zanzibar,Ethiopia,0,4,CECAFA Cup,4
Maldives,Sri Lanka,2,0,SAFF Cup,2
Bangladesh,Nepal,2,0,SAFF Cup,2
India,Bhutan,3,0,SAFF Cup,3
Nepal,Bhutan,3,1,SAFF Cup,2
Mexico,Hungary,2,0,Friendly,2
Zambia,DR Congo,4,1,Friendly,3
Bangladesh,India,0,2,SAFF Cup,2
Antigua and Barbuda,Hungary,0,3,Friendly,3
Egypt,Uganda,2,0,Friendly,2
Thailand,North Korea,0,2,King's Cup,2
Andalusia,China PR,4,1,Friendly,3
Egypt,Senegal,4,2,Friendly,2
Qatar,Libya,2,0,Friendly,2
Egypt,Zimbabwe,2,0,Friendly,2
Morocco,DR Congo,3,0,Friendly,3
Tunisia,Ghana,2,0,Friendly,2
Ivory Coast,Jordan,2,0,Friendly,2
Egypt,Libya,3,0,African Cup of Nations,3
Cameroon,Angola,3,1,African Cup of Nations,2
Togo,DR Congo,0,2,African Cup of Nations,2
South Africa,Guinea,0,2,African Cup of Nations,2
Tunisia,Zambia,4,1,African Cup of Nations,3
Zimbabwe,Senegal,0,2,African Cup of Nations,2
Cameroon,Togo,2,0,African Cup of Nations,2
Tunisia,South Africa,2,0,African Cup of Nations,2
Nigeria,Zimbabwe,2,0,African Cup of Nations,2
Egypt,Ivory Coast,3,1,African Cup of Nations,2
Cameroon,DR Congo,2,0,African Cup of Nations,2
South Korea,Croatia,2,0,Lunar New Year Cup,2
United States,Norway,5,0,Friendly,5
Tunisia,Guinea,0,3,African Cup of Nations,3
Hong Kong,Croatia,0,4,Lunar New Year Cup,4
Egypt,DR Congo,4,1,African Cup of Nations,3
Syria,Palestine,3,0,Friendly,3
Jordan,Kazakhstan,2,0,Friendly,2
Qatar,Tajikistan,2,0,Friendly,2
Bahrain,Palestine,0,2,Friendly,2
Japan,Finland,2,0,Friendly,2
Pakistan,Palestine,0,3,Friendly,3
United States,Guatemala,4,0,Friendly,4
Bahrain,Australia,1,3,AFC Asian Cup qualification,2
China PR,Palestine,2,0,AFC Asian Cup qualification,2
Hong Kong,Qatar,0,3,AFC Asian Cup qualification,3
Iran,Taiwan,4,0,AFC Asian Cup qualification,4
Japan,India,6,0,AFC Asian Cup qualification,6
Jordan,Pakistan,3,0,AFC Asian Cup qualification,3
Singapore,Iraq,2,0,AFC Asian Cup qualification,2
Uzbekistan,Bangladesh,5,0,AFC Asian Cup qualification,5
Yemen,Saudi Arabia,0,4,AFC Asian Cup qualification,4
Saint Kitts and Nevis,Saint Martin,6,1,Friendly,5
Guyana,Antigua and Barbuda,4,1,Friendly,3
Iceland,Trinidad and Tobago,0,2,Friendly,2
Romania,Armenia,2,0,Cyprus International Tournament,2
Austria,Canada,0,2,Friendly,2
Cyprus,Armenia,2,0,Cyprus International Tournament,2
India,Yemen,0,3,AFC Asian Cup qualification,3
Republic of Ireland,Sweden,3,0,Friendly,3
Israel,Denmark,0,2,Friendly,2
Italy,Germany,4,1,Friendly,3
Kazakhstan,Greece,0,2,Cyprus International Tournament,2
Luxembourg,Belgium,0,2,Friendly,2
Malta,Georgia,0,2,Malta International Tournament,2
Oman,Jordan,3,0,AFC Asian Cup qualification,3
Pakistan,United Arab Emirates,1,4,AFC Asian Cup qualification,3
Saudi Arabia,Portugal,0,3,Friendly,3
Scotland,Switzerland,1,3,Friendly,2
Slovenia,Romania,0,2,Cyprus International Tournament,2
Germany,United States,4,1,Friendly,3
Thailand,Philippines,5,0,Friendly,5
Equatorial Guinea,Benin,2,0,Friendly,2
Palestine,Guam,11,0,AFC Challenge Cup,11
Nepal,Bhutan,2,0,AFC Challenge Cup,2
Tajikistan,Macau,4,0,AFC Challenge Cup,4
Bangladesh,Guam,3,0,AFC Challenge Cup,3
Cambodia,Palestine,0,4,AFC Challenge Cup,4
Pakistan,Tajikistan,0,2,AFC Challenge Cup,2
Cambodia,Guam,3,0,AFC Challenge Cup,3
Macau,Kyrgyzstan,0,2,AFC Challenge Cup,2
Sri Lanka,Taiwan,3,0,AFC Challenge Cup,3
Bangladesh,Tajikistan,1,6,AFC Challenge Cup,5
Tajikistan,Kyrgyzstan,2,0,AFC Challenge Cup,2
Lesotho,Eswatini,5,0,Friendly,5
Sri Lanka,Tajikistan,0,4,AFC Challenge Cup,4
Kosovo,Monaco,7,1,Friendly,6
Chile,New Zealand,4,1,Friendly,3
Angola,Mauritius,5,1,COSAFA Cup,4
Lesotho,Angola,1,3,COSAFA Cup,2
Bulgaria,Scotland,1,5,Kirin Cup,4
Poland,Faroe Islands,4,0,Friendly,4
Botswana,Madagascar,2,0,COSAFA Cup,2
Madagascar,Eswatini,0,2,COSAFA Cup,2
Austria,Croatia,1,4,Friendly,3
Romania,Uruguay,0,2,Friendly,2
Hungary,New Zealand,2,0,Friendly,2
Catalonia,Costa Rica,2,0,Friendly,2
Czech Republic,Saudi Arabia,2,0,Friendly,2
South Korea,Bosnia and Herzegovina,2,0,Friendly,2
Romania,Northern Ireland,2,0,Friendly,2
United States,Venezuela,2,0,Friendly,2
Georgia,New Zealand,1,3,Friendly,2
Germany,Luxembourg,7,0,Friendly,7
Portugal,Cape Verde,4,1,Friendly,3
Ukraine,Costa Rica,4,0,Friendly,4
Jamaica,Ghana,1,4,Friendly,3
Argentina,Angola,2,0,Friendly,2
England,Hungary,3,1,Friendly,2
Tunisia,Belarus,3,0,Friendly,3
Zanzibar,Northern Cyprus,1,3,FIFI Wild Cup,2
Republic of St. Pauli,Tibet,7,0,FIFI Wild Cup,7
France,Denmark,2,0,Friendly,2
Gibraltar,Tibet,5,0,FIFI Wild Cup,5
Greenland,Zanzibar,2,4,FIFI Wild Cup,2
Iran,Bosnia and Herzegovina,5,2,Friendly,3
Slovenia,Trinidad and Tobago,3,1,Friendly,2
Northern Cyprus,Gibraltar,2,0,FIFI Wild Cup,2
Germany,Colombia,3,0,Friendly,3
Czech Republic,Trinidad and Tobago,3,0,Friendly,3
England,Jamaica,6,0,Friendly,6
Luxembourg,Portugal,0,3,Friendly,3
Spain,Egypt,2,0,Friendly,2
Switzerland,China PR,4,1,Friendly,3
Brazil,New Zealand,4,0,Friendly,4
Colombia,Morocco,2,0,Friendly,2
Ghana,South Korea,3,1,Friendly,2
Slovenia,Ivory Coast,0,3,Friendly,3
Ukraine,Libya,3,0,Friendly,3
Australia,Liechtenstein,3,1,Friendly,2
France,China PR,3,1,Friendly,2
Luxembourg,Ukraine,0,3,Friendly,3
Germany,Costa Rica,4,2,FIFA World Cup,2
Poland,Ecuador,0,2,FIFA World Cup,2
Mexico,Iran,3,1,FIFA World Cup,2
Australia,Japan,3,1,FIFA World Cup,2
Italy,Ghana,2,0,FIFA World Cup,2
United States,Czech Republic,0,3,FIFA World Cup,3
Spain,Ukraine,4,0,FIFA World Cup,4
Ecuador,Costa Rica,3,0,FIFA World Cup,3
England,Trinidad and Tobago,2,0,FIFA World Cup,2
Argentina,Serbia,6,0,FIFA World Cup,6
Czech Republic,Ghana,0,2,FIFA World Cup,2
Portugal,Iran,2,0,FIFA World Cup,2
Brazil,Australia,2,0,FIFA World Cup,2
Saudi Arabia,Ukraine,0,4,FIFA World Cup,4
Spain,Tunisia,3,1,FIFA World Cup,2
Togo,Switzerland,0,2,FIFA World Cup,2
Germany,Ecuador,3,0,FIFA World Cup,3
Paraguay,Trinidad and Tobago,2,0,FIFA World Cup,2
Czech Republic,Italy,0,2,FIFA World Cup,2
Japan,Brazil,1,4,FIFA World Cup,3
Switzerland,South Korea,2,0,FIFA World Cup,2
Togo,France,0,2,FIFA World Cup,2
Germany,Sweden,2,0,FIFA World Cup,2
Mozambique,Eswatini,4,0,Friendly,4
Brazil,Ghana,3,0,FIFA World Cup,3
Spain,France,1,3,FIFA World Cup,2
Italy,Ukraine,3,0,FIFA World Cup,3
Kazakhstan,Tajikistan,4,1,Friendly,3
Germany,Italy,0,2,FIFA World Cup,2
Germany,Portugal,3,1,FIFA World Cup,2
Syria,Iraq,1,3,Friendly,2
Malawi,Zambia,1,3,COSAFA Cup,2
Seychelles,Zambia,0,2,COSAFA Cup,2
Guyana,Saint Lucia,2,0,Friendly,2
Jordan,Syria,3,0,Friendly,3
Japan,Trinidad and Tobago,2,0,Friendly,2
Algeria,Gabon,0,2,Friendly,2
Ghana,Togo,2,0,Friendly,2
Slovakia,Malta,3,0,Friendly,3
Ukraine,Azerbaijan,6,0,Friendly,6
Australia,Kuwait,2,0,AFC Asian Cup qualification,2
Bangladesh,Qatar,1,4,AFC Asian Cup qualification,3
Belarus,Andorra,3,0,Friendly,3
Czech Republic,Serbia,1,3,Friendly,2
Denmark,Poland,2,0,Friendly,2
Egypt,Uruguay,0,2,Friendly,2
England,Greece,4,0,Friendly,4
Faroe Islands,Georgia,0,6,UEFA Euro qualification,6
Germany,Sweden,3,0,Friendly,3
India,Saudi Arabia,0,3,AFC Asian Cup qualification,3
Republic of Ireland,Netherlands,0,4,Friendly,4
Italy,Croatia,0,2,Friendly,2
Japan,Yemen,2,0,AFC Asian Cup qualification,2
Liechtenstein,Switzerland,0,3,Friendly,3
Pakistan,Oman,1,4,AFC Asian Cup qualification,3
Peru,Panama,0,2,Friendly,2
Romania,Cyprus,2,0,Friendly,2
San Marino,Albania,0,3,Friendly,3
Palestine,Iraq,0,3,AFC Asian Cup qualification,3
Eswatini,Lesotho,3,1,Friendly,2
Denmark,Portugal,4,2,Friendly,2
Oman,Syria,3,0,Friendly,3
Bahamas,Cayman Islands,3,1,CFU Caribbean Cup qualification,2
Bahrain,Jordan,0,2,Friendly,2
Cuba,Turks and Caicos Islands,6,0,CFU Caribbean Cup qualification,6
Egypt,Burundi,4,1,African Cup of Nations qualification,3
England,Andorra,5,0,UEFA Euro qualification,5
Gabon,Madagascar,4,0,African Cup of Nations qualification,4
Georgia,France,0,3,UEFA Euro qualification,3
Hungary,Norway,1,4,UEFA Euro qualification,3
Malta,Bosnia and Herzegovina,2,5,UEFA Euro qualification,3
Nigeria,Niger,2,0,African Cup of Nations qualification,2
Northern Ireland,Iceland,0,3,UEFA Euro qualification,3
Poland,Finland,1,3,UEFA Euro qualification,2
Scotland,Faroe Islands,6,0,UEFA Euro qualification,6
Senegal,Mozambique,2,0,African Cup of Nations qualification,2
Slovakia,Cyprus,6,1,UEFA Euro qualification,5
Spain,Liechtenstein,4,0,UEFA Euro qualification,4
Uganda,Lesotho,3,0,African Cup of Nations qualification,3
Argentina,Brazil,0,3,Friendly,3
Chad,Zambia,0,2,African Cup of Nations qualification,2
Gambia,Cape Verde,2,0,African Cup of Nations qualification,2
Rwanda,Cameroon,0,3,African Cup of Nations qualification,3
Sudan,Seychelles,3,0,African Cup of Nations qualification,3
Eswatini,Angola,0,2,African Cup of Nations qualification,2
Cayman Islands,Turks and Caicos Islands,0,2,CFU Caribbean Cup qualification,2
Cuba,Bahamas,6,0,CFU Caribbean Cup qualification,6
Wales,Brazil,0,2,Friendly,2
Albania,Romania,0,2,UEFA Euro qualification,2
Bosnia and Herzegovina,Hungary,1,3,UEFA Euro qualification,2
Bulgaria,Slovenia,3,0,UEFA Euro qualification,3
Cuba,Cayman Islands,7,0,CFU Caribbean Cup qualification,7
France,Italy,3,1,UEFA Euro qualification,2
Honduras,El Salvador,2,0,Friendly,2
Iceland,Denmark,0,2,UEFA Euro qualification,2
Israel,Andorra,4,1,UEFA Euro qualification,3
South Korea,Taiwan,8,0,AFC Asian Cup qualification,8
Kuwait,Australia,2,0,AFC Asian Cup qualification,2
Netherlands,Belarus,3,0,UEFA Euro qualification,3
Norway,Moldova,2,0,UEFA Euro qualification,2
Oman,Pakistan,5,0,AFC Asian Cup qualification,5
Qatar,Bangladesh,3,0,AFC Asian Cup qualification,3
San Marino,Germany,0,13,UEFA Euro qualification,13
Saudi Arabia,India,7,1,AFC Asian Cup qualification,6
Slovakia,Czech Republic,0,3,UEFA Euro qualification,3
Suriname,Guyana,0,5,CFU Caribbean Cup qualification,5
Sweden,Liechtenstein,3,1,UEFA Euro qualification,2
Switzerland,Costa Rica,2,0,Friendly,2
Turkey,Malta,2,0,UEFA Euro qualification,2
Curaçao,Guyana,0,5,CFU Caribbean Cup qualification,5
Haiti,Dominican Republic,3,1,Friendly,2
Dominica,Barbados,0,5,Friendly,5
Antigua and Barbuda,Anguilla,5,3,CFU Caribbean Cup qualification,2
Dominica,Martinique,0,4,CFU Caribbean Cup qualification,4
Anguilla,Saint Kitts and Nevis,1,6,CFU Caribbean Cup qualification,5
Antigua and Barbuda,Barbados,1,3,CFU Caribbean Cup qualification,2
Barbados,Anguilla,7,1,CFU Caribbean Cup qualification,6
Guadeloupe,Martinique,4,0,CFU Caribbean Cup qualification,4
Jamaica,Saint Lucia,4,0,CFU Caribbean Cup qualification,4
United States Virgin Islands,Bermuda,0,6,CFU Caribbean Cup qualification,6
Bermuda,Dominican Republic,3,1,CFU Caribbean Cup qualification,2
Saint Lucia,Haiti,1,7,CFU Caribbean Cup qualification,6
Jamaica,Haiti,2,0,CFU Caribbean Cup qualification,2
Saint Vincent and the Grenadines,Saint Lucia,8,0,CFU Caribbean Cup qualification,8
United States Virgin Islands,Dominican Republic,1,6,CFU Caribbean Cup qualification,5
Ethiopia,Eswatini,2,0,Friendly,2
Iran,Iraq,2,0,Friendly,2
Cameroon,Equatorial Guinea,3,0,African Cup of Nations qualification,3
Croatia,Andorra,7,0,UEFA Euro qualification,7
Cyprus,Republic of Ireland,5,2,UEFA Euro qualification,3
Czech Republic,San Marino,7,0,UEFA Euro qualification,7
Germany,Georgia,2,0,Friendly,2
Italy,Ukraine,2,0,UEFA Euro qualification,2
Latvia,Iceland,4,0,UEFA Euro qualification,4
Portugal,Azerbaijan,3,0,UEFA Euro qualification,3
Romania,Belarus,3,1,UEFA Euro qualification,2
Slovenia,Luxembourg,2,0,UEFA Euro qualification,2
Sweden,Spain,2,0,UEFA Euro qualification,2
Wales,Slovakia,1,5,UEFA Euro qualification,4
Angola,Kenya,3,1,African Cup of Nations qualification,2
Benin,Sierra Leone,2,0,African Cup of Nations qualification,2
Burundi,Mauritania,3,1,African Cup of Nations qualification,2
Congo,Chad,3,1,African Cup of Nations qualification,2
Ivory Coast,Gabon,5,0,African Cup of Nations qualification,5
South Korea,Ghana,1,3,Friendly,2
Andorra,North Macedonia,0,3,UEFA Euro qualification,3
Australia,Bahrain,2,0,AFC Asian Cup qualification,2
Bangladesh,Uzbekistan,0,4,AFC Asian Cup qualification,4
Belarus,Slovenia,4,2,UEFA Euro qualification,2
Belgium,Azerbaijan,3,0,UEFA Euro qualification,3
Bosnia and Herzegovina,Greece,0,4,UEFA Euro qualification,4
Croatia,England,2,0,UEFA Euro qualification,2
France,Faroe Islands,5,0,UEFA Euro qualification,5
Georgia,Italy,1,3,UEFA Euro qualification,2
India,Japan,0,3,AFC Asian Cup qualification,3
Iraq,Singapore,4,2,AFC Asian Cup qualification,2
Kazakhstan,Finland,0,2,UEFA Euro qualification,2
Liechtenstein,Denmark,0,4,UEFA Euro qualification,4
Pakistan,Jordan,0,3,AFC Asian Cup qualification,3
Palestine,China PR,0,2,AFC Asian Cup qualification,2
Qatar,Hong Kong,2,0,AFC Asian Cup qualification,2
Russia,Estonia,2,0,UEFA Euro qualification,2
Saudi Arabia,Yemen,5,0,AFC Asian Cup qualification,5
Serbia,Armenia,3,0,UEFA Euro qualification,3
Slovakia,Germany,1,4,UEFA Euro qualification,3
Turkey,Moldova,5,0,UEFA Euro qualification,5
Ukraine,Scotland,2,0,UEFA Euro qualification,2
Wales,Cyprus,3,1,UEFA Euro qualification,2
Uruguay,Venezuela,4,0,Friendly,4
Zambia,Angola,2,0,COSAFA Cup,2
Kuwait,Taiwan,10,0,Friendly,10
Cuba,Suriname,3,1,CFU Caribbean Cup qualification,2
Philippines,Timor-Leste,7,0,AFF Championship,7
Wales,Liechtenstein,4,0,Friendly,4
Austria,Trinidad and Tobago,4,1,Friendly,3
Bolivia,El Salvador,4,1,Friendly,3
Georgia,Uruguay,2,0,Friendly,2
Hong Kong,Bangladesh,2,0,AFC Asian Cup qualification,2
Iran,South Korea,2,0,AFC Asian Cup qualification,2
Republic of Ireland,San Marino,5,0,UEFA Euro qualification,5
Japan,Saudi Arabia,3,1,AFC Asian Cup qualification,2
Jordan,Oman,3,0,AFC Asian Cup qualification,3
North Macedonia,Russia,0,2,UEFA Euro qualification,2
Malta,Lithuania,1,4,Friendly,3
Morocco,Gabon,6,0,Friendly,6
Portugal,Kazakhstan,3,0,UEFA Euro qualification,3
Slovakia,Bulgaria,3,1,Friendly,2
Syria,Taiwan,3,0,AFC Asian Cup qualification,3
Tunisia,Libya,2,0,Friendly,2
Uzbekistan,Qatar,2,0,AFC Asian Cup qualification,2
Găgăuzia,Greenland,0,2,ELF Cup,2
Tibet,Tajikistan,0,3,ELF Cup,3
Northern Cyprus,Crimea,5,0,ELF Cup,5
Cambodia,Timor-Leste,4,1,AFF Championship,3
Occitania,Sápmi,0,7,Viva World Cup,7
Găgăuzia,Kyrgyzstan,1,6,ELF Cup,5
Northern Cyprus,Tajikistan,5,1,ELF Cup,4
Bahamas,Bermuda,0,4,CFU Caribbean Cup qualification,4
Northern Cyprus,Tibet,10,0,ELF Cup,10
Sápmi,Monaco,14,0,Viva World Cup,14
Northern Cyprus,Zanzibar,5,0,ELF Cup,5
Dominican Republic,Guadeloupe,0,3,CFU Caribbean Cup qualification,3
Guyana,Antigua and Barbuda,6,0,CFU Caribbean Cup qualification,6
Sápmi,Monaco,21,1,Viva World Cup,20
Northern Cyprus,Crimea,3,1,ELF Cup,2
Djibouti,Malawi,0,3,CECAFA Cup,3
Dominican Republic,Antigua and Barbuda,2,0,CFU Caribbean Cup qualification,2
Somalia,Rwanda,0,3,CECAFA Cup,3
Antigua and Barbuda,Guadeloupe,1,3,CFU Caribbean Cup qualification,2
Ethiopia,Djibouti,4,0,CECAFA Cup,4
Guyana,Dominican Republic,4,0,CFU Caribbean Cup qualification,4
Somalia,Sudan,0,3,CECAFA Cup,3
Tanzania,Djibouti,3,0,CECAFA Cup,3
Zambia,Zanzibar,4,0,CECAFA Cup,4
Uganda,Somalia,2,0,CECAFA Cup,2
United Arab Emirates,Poland,2,5,Friendly,3
Tanzania,DR Congo,2,0,Friendly,2
Yemen,Comoros,2,0,Arab Cup qualification,2
Réunion,Mayotte,3,1,Friendly,2
Djibouti,Comoros,2,4,Arab Cup qualification,2
Yemen,Djibouti,4,1,Arab Cup qualification,3
Sudan,Somalia,6,1,Arab Cup qualification,5
Lebanon,Somalia,4,0,Arab Cup qualification,4
Sudan,Mauritania,2,0,Arab Cup qualification,2
Thailand,Singapore,2,0,King's Cup,2
Somalia,Mauritania,2,8,Arab Cup qualification,6
Basque Country,Serbia,4,0,Friendly,4
Thailand,Vietnam,3,1,King's Cup,2
Martinique,Guadeloupe,3,0,Friendly,3
Haiti,Bermuda,2,0,CFU Caribbean Cup qualification,2
Singapore,Philippines,4,1,Friendly,3
Yemen,Eritrea,4,1,Friendly,3
Saudi Arabia,Gambia,3,0,Friendly,3
Bermuda,Haiti,0,3,CFU Caribbean Cup qualification,3
Costa Rica,Nicaragua,2,0,Friendly,2
Malaysia,Philippines,4,0,AFF Championship,4
Indonesia,Laos,3,1,AFF Championship,2
Thailand,Philippines,4,0,AFF Championship,4
Venezuela,Sweden,2,0,Friendly,2
Haiti,Barbados,2,0,CFU Caribbean Cup,2
Singapore,Laos,11,0,AFF Championship,11
Trinidad and Tobago,Martinique,5,1,CFU Caribbean Cup,4
Trinidad and Tobago,Haiti,3,1,CFU Caribbean Cup,2
Vietnam,Laos,9,0,AFF Championship,9
Guadeloupe,Haiti,1,3,CFU Caribbean Cup,2
Trinidad and Tobago,Cuba,3,1,CFU Caribbean Cup,2
Vietnam,Thailand,0,2,AFF Championship,2
Poland,Estonia,4,0,Friendly,4
Costa Rica,Trinidad and Tobago,4,0,Friendly,4
Australia,Denmark,1,3,Friendly,2
Latvia,Bulgaria,0,2,Cyprus International Tournament,2
Lithuania,Mali,1,3,Friendly,2
Nigeria,Ghana,1,4,Friendly,3
Portugal,Brazil,2,0,Friendly,2
Belgium,Czech Republic,0,2,Friendly,2
Colombia,Uruguay,1,3,Friendly,2
Cyprus,Bulgaria,0,3,Cyprus International Tournament,3
Egypt,Sweden,2,0,Friendly,2
Germany,Switzerland,3,1,Friendly,2
Latvia,Hungary,0,2,Cyprus International Tournament,2
Netherlands,Russia,4,1,Friendly,3
Romania,Moldova,2,0,Friendly,2
United States,Mexico,2,0,Friendly,2
Costa Rica,Honduras,3,1,UNCAF Cup,2
Nicaragua,Belize,4,2,UNCAF Cup,2
Nicaragua,Honduras,1,9,UNCAF Cup,8
El Salvador,Costa Rica,0,2,UNCAF Cup,2
Panama,Guatemala,2,0,UNCAF Cup,2
Mexico,Venezuela,3,1,Friendly,2
Kazakhstan,Kyrgyzstan,2,0,Friendly,2
Kyrgyzstan,Uzbekistan,0,6,Friendly,6
Mauritius,Ivory Coast,0,3,Friendly,3
Jamaica,Switzerland,0,2,Friendly,2
Algeria,Cape Verde,2,0,African Cup of Nations qualification,2
Brazil,Chile,4,0,Friendly,4
Cameroon,Liberia,3,1,African Cup of Nations qualification,2
Chad,South Africa,0,3,African Cup of Nations qualification,3
China PR,Australia,0,2,Friendly,2
Costa Rica,New Zealand,4,0,Friendly,4
Cyprus,Slovakia,1,3,UEFA Euro qualification,2
El Salvador,Honduras,0,2,Friendly,2
Estonia,Russia,0,2,UEFA Euro qualification,2
Faroe Islands,Ukraine,0,2,UEFA Euro qualification,2
Gambia,Guinea,0,2,African Cup of Nations qualification,2
Greece,Turkey,1,4,UEFA Euro qualification,3
Haiti,Panama,3,0,Friendly,3
Japan,Peru,2,0,Friendly,2
South Korea,Uruguay,0,2,Friendly,2
Liechtenstein,Northern Ireland,1,4,UEFA Euro qualification,3
Poland,Azerbaijan,5,0,UEFA Euro qualification,5
Portugal,Belgium,4,0,UEFA Euro qualification,4
Senegal,Tanzania,4,0,African Cup of Nations qualification,4
Seychelles,Tunisia,0,3,African Cup of Nations qualification,3
Togo,Sierra Leone,3,1,African Cup of Nations qualification,2
Venezuela,Cuba,3,1,Friendly,2
Angola,Eritrea,6,1,African Cup of Nations qualification,5
Bermuda,Canada,0,3,Friendly,3
Colombia,Switzerland,3,1,Friendly,2
Egypt,Mauritania,3,0,African Cup of Nations qualification,3
Equatorial Guinea,Rwanda,3,1,African Cup of Nations qualification,2
Kenya,Eswatini,2,0,African Cup of Nations qualification,2
Lesotho,Niger,3,1,African Cup of Nations qualification,2
Madagascar,Ivory Coast,0,3,African Cup of Nations qualification,3
United States,Ecuador,3,1,Friendly,2
China PR,Uzbekistan,3,1,Friendly,2
El Salvador,Honduras,0,2,Friendly,2
Andorra,England,0,3,UEFA Euro qualification,3
Colombia,Paraguay,2,0,Friendly,2
Georgia,Faroe Islands,3,1,UEFA Euro qualification,2
Hungary,Moldova,2,0,UEFA Euro qualification,2
Israel,Estonia,4,0,UEFA Euro qualification,4
Italy,Scotland,2,0,UEFA Euro qualification,2
Mexico,Ecuador,4,2,Friendly,2
Romania,Luxembourg,3,0,UEFA Euro qualification,3
Venezuela,New Zealand,5,0,Friendly,5
Wales,San Marino,3,0,UEFA Euro qualification,3
Guam,Northern Mariana Islands,9,0,EAFF Championship,9
Honduras,Haiti,1,3,Friendly,2
Seychelles,Réunion,2,0,Friendly,2
Mozambique,Seychelles,2,0,COSAFA Cup,2
DR Congo,Ethiopia,2,0,African Cup of Nations qualification,2
Madagascar,Seychelles,5,0,COSAFA Cup,5
Chile,Cuba,3,0,Friendly,3
Panama,Colombia,0,4,Friendly,4
Chile,Cuba,2,0,Friendly,2
Guadeloupe,Dominica,2,0,Friendly,2
Mauritius,South Africa,0,2,COSAFA Cup,2
Saint Vincent and the Grenadines,Haiti,0,3,Friendly,3
Indonesia,Hong Kong,3,0,Friendly,3
Japan,Montenegro,2,0,Kirin Cup,2
Albania,Luxembourg,2,0,UEFA Euro qualification,2
Azerbaijan,Poland,1,3,UEFA Euro qualification,2
Belarus,Bulgaria,0,2,UEFA Euro qualification,2
Costa Rica,Chile,2,0,Friendly,2
Denmark,Sweden,0,3,UEFA Euro qualification,3
Finland,Serbia,0,2,UEFA Euro qualification,2
France,Ukraine,2,0,UEFA Euro qualification,2
Germany,San Marino,6,0,UEFA Euro qualification,6
Greece,Hungary,2,0,UEFA Euro qualification,2
Honduras,Trinidad and Tobago,3,1,Friendly,2
South Korea,Netherlands,0,2,Friendly,2
Latvia,Spain,0,2,UEFA Euro qualification,2
Mexico,Iran,4,0,Friendly,4
Morocco,Zimbabwe,2,0,African Cup of Nations qualification,2
Norway,Malta,4,0,UEFA Euro qualification,4
Russia,Andorra,4,0,UEFA Euro qualification,4
Rwanda,Equatorial Guinea,2,0,African Cup of Nations qualification,2
South Africa,Chad,4,0,African Cup of Nations qualification,4
Sudan,Mauritius,3,0,African Cup of Nations qualification,3
Tunisia,Seychelles,4,0,African Cup of Nations qualification,4
United States,China PR,4,1,Friendly,3
Zambia,Congo,3,0,African Cup of Nations qualification,3
Ivory Coast,Madagascar,5,0,African Cup of Nations qualification,5
Mozambique,Burkina Faso,3,0,African Cup of Nations qualification,3
Niger,Lesotho,2,0,African Cup of Nations qualification,2
Andorra,Israel,0,2,UEFA Euro qualification,2
Ecuador,Peru,2,0,Friendly,2
Estonia,England,0,3,UEFA Euro qualification,3
Faroe Islands,Scotland,0,2,UEFA Euro qualification,2
Finland,Belgium,2,0,UEFA Euro qualification,2
Latvia,Denmark,0,2,UEFA Euro qualification,2
Liechtenstein,Spain,0,2,UEFA Euro qualification,2
Lithuania,Italy,0,2,UEFA Euro qualification,2
Luxembourg,Albania,0,3,UEFA Euro qualification,3
Norway,Hungary,4,0,UEFA Euro qualification,4
Romania,Slovenia,2,0,UEFA Euro qualification,2
Sweden,Iceland,5,0,UEFA Euro qualification,5
Thailand,Netherlands,1,3,Friendly,2
United States,Trinidad and Tobago,2,0,Gold Cup,2
Kenya,Rwanda,2,0,Friendly,2
Haiti,Canada,0,2,Gold Cup,2
Réunion,Gabon,0,3,Friendly,3
United States,El Salvador,4,0,Gold Cup,4
Cuba,Honduras,0,5,Gold Cup,5
Algeria,Guinea,0,2,African Cup of Nations qualification,2
Canada,Guatemala,3,0,Gold Cup,3
Seychelles,Sudan,0,2,African Cup of Nations qualification,2
Tunisia,Mauritius,2,0,African Cup of Nations qualification,2
Angola,Eswatini,3,0,African Cup of Nations qualification,3
Benin,Togo,4,1,African Cup of Nations qualification,3
Guam,Taiwan,0,10,EAFF Championship,10
Libya,Ethiopia,3,1,African Cup of Nations qualification,2
Madagascar,Gabon,0,2,African Cup of Nations qualification,2
Mali,Sierra Leone,6,0,African Cup of Nations qualification,6
Niger,Nigeria,1,3,African Cup of Nations qualification,2
Malaysia,Cambodia,6,0,Friendly,6
North Korea,Mongolia,7,0,EAFF Championship,7
Iran,Palestine,2,0,WAFF Championship,2
Jordan,Lebanon,3,0,WAFF Championship,3
Hong Kong,Guam,15,1,EAFF Championship,14
Macau,North Korea,1,7,EAFF Championship,6
Malaysia,United Arab Emirates,1,3,Friendly,2
Syria,Iraq,0,3,WAFF Championship,3
Colombia,Ecuador,3,1,Friendly,2
Mongolia,Guam,5,2,EAFF Championship,3
United Arab Emirates,Saudi Arabia,0,2,Friendly,2
Vietnam,Jamaica,3,0,Friendly,3
Uruguay,Peru,0,3,Copa América,3
Brazil,Mexico,0,2,Copa América,2
Argentina,United States,4,1,Copa América,3
Malaysia,Jamaica,0,2,Friendly,2
Paraguay,Colombia,5,0,Copa América,5
South Korea,Iraq,3,0,Friendly,3
Singapore,Australia,0,3,Friendly,3
Venezuela,Peru,2,0,Copa América,2
Vietnam,Bahrain,5,3,Friendly,2
Rhodes,Saare County,2,0,Island Games,2
Brazil,Chile,3,0,Copa América,3
Åland Islands,Bermuda,0,2,Island Games,2
Rhodes,Frøya,3,1,Island Games,2
Argentina,Colombia,4,2,Copa América,2
Iran,Jamaica,8,1,Friendly,7
Iraq,Uzbekistan,0,2,Friendly,2
Thailand,Qatar,2,0,Friendly,2
United States,Paraguay,1,3,Copa América,2
Ynys Môn,Åland Islands,0,2,Island Games,2
Gotland,Western Isles,1,3,Island Games,2
Menorca,Ynys Môn,6,1,Island Games,5
Frøya,Gotland,0,3,Island Games,3
Gibraltar,Bermuda,2,0,Island Games,2
Menorca,Saare County,4,1,Island Games,3
Åland Islands,Frøya,3,1,Island Games,2
Rhodes,Gibraltar,0,4,Island Games,4
Chile,Brazil,1,6,Copa América,5
Venezuela,Uruguay,1,4,Copa América,3
Argentina,Peru,4,0,Copa América,4
Mexico,Paraguay,6,0,Copa América,6
Vietnam,United Arab Emirates,2,0,AFC Asian Cup,2
Malaysia,China PR,1,5,AFC Asian Cup,4
Mexico,Argentina,0,3,Copa América,3
Thailand,Oman,2,0,AFC Asian Cup,2
Iraq,Australia,3,1,AFC Asian Cup,2
United Arab Emirates,Japan,1,3,AFC Asian Cup,2
Malaysia,Uzbekistan,0,5,AFC Asian Cup,5
Mexico,Uruguay,3,1,Copa América,2
Brazil,Argentina,3,0,Copa América,3
Thailand,Australia,0,4,AFC Asian Cup,4
Vietnam,Japan,1,4,AFC Asian Cup,3
New Caledonia,Vanuatu,5,3,Friendly,2
Malaysia,Iran,0,2,AFC Asian Cup,2
Saudi Arabia,Bahrain,4,0,AFC Asian Cup,4
Uzbekistan,China PR,3,0,AFC Asian Cup,3
New Caledonia,Vanuatu,0,2,Friendly,2
Iraq,Vietnam,2,0,AFC Asian Cup,2
Angola,Lesotho,2,0,COSAFA Cup,2
India,Cambodia,6,0,Nehru Cup,6
Bangladesh,Syria,0,2,Nehru Cup,2
Singapore,Zimbabwe,4,2,Merdeka Tournament,2
Syria,Kyrgyzstan,4,1,Nehru Cup,3
Albania,Malta,3,0,Friendly,3
Algeria,Brazil,0,2,Friendly,2
Bosnia and Herzegovina,Croatia,3,5,Friendly,2
DR Congo,Angola,3,1,Friendly,2
Denmark,Republic of Ireland,0,4,Friendly,4
El Salvador,Honduras,2,0,Friendly,2
Hungary,Italy,3,1,Friendly,2
Japan,Cameroon,2,0,Friendly,2
Lesotho,Laos,3,1,Merdeka Tournament,2
Northern Ireland,Liechtenstein,3,1,UEFA Euro qualification,2
Romania,Turkey,2,0,Friendly,2
Togo,Zambia,3,1,Friendly,2
Singapore,Bangladesh,4,2,Merdeka Tournament,2
Bangladesh,Kyrgyzstan,0,3,Nehru Cup,3
Cambodia,Syria,1,5,Nehru Cup,4
Fiji,Tuvalu,16,0,South Pacific Games,16
Samoa,Vanuatu,0,4,South Pacific Games,4
Solomon Islands,American Samoa,12,1,South Pacific Games,11
India,Kyrgyzstan,3,0,Nehru Cup,3
Zimbabwe,Myanmar,1,3,Merdeka Tournament,2
Fiji,Cook Islands,4,0,South Pacific Games,4
Samoa,American Samoa,7,0,South Pacific Games,7
Solomon Islands,Tonga,4,0,South Pacific Games,4
American Samoa,Vanuatu,0,15,South Pacific Games,15
New Caledonia,Cook Islands,3,0,South Pacific Games,3
Cook Islands,Tuvalu,4,1,South Pacific Games,3
Tahiti,Fiji,0,4,South Pacific Games,4
Tonga,American Samoa,4,0,South Pacific Games,4
Vanuatu,Solomon Islands,0,2,South Pacific Games,2
Samoa,Solomon Islands,0,3,South Pacific Games,3
Tonga,Vanuatu,1,4,South Pacific Games,3
Fiji,Vanuatu,3,0,South Pacific Games,3
Bahrain,Jordan,1,3,Friendly,2
Solomon Islands,Vanuatu,0,2,South Pacific Games,2
Belarus,Romania,1,3,UEFA Euro qualification,2
Croatia,Estonia,2,0,UEFA Euro qualification,2
Cyprus,Armenia,3,1,Friendly,2
Ecuador,El Salvador,5,1,Friendly,4
England,Israel,3,0,UEFA Euro qualification,3
Luxembourg,Slovenia,0,3,UEFA Euro qualification,3
Morocco,Ghana,0,2,Friendly,2
Netherlands,Bulgaria,2,0,UEFA Euro qualification,2
Nigeria,Lesotho,2,0,African Cup of Nations qualification,2
Russia,North Macedonia,3,0,UEFA Euro qualification,3
Rwanda,Liberia,4,0,African Cup of Nations qualification,4
San Marino,Czech Republic,0,3,UEFA Euro qualification,3
Scotland,Lithuania,3,1,UEFA Euro qualification,2
Senegal,Burkina Faso,5,1,African Cup of Nations qualification,4
Uganda,Niger,3,1,African Cup of Nations qualification,2
Wales,Germany,0,2,UEFA Euro qualification,2
Guinea,Cape Verde,4,0,African Cup of Nations qualification,4
South Africa,Zambia,1,3,African Cup of Nations qualification,2
United States,Brazil,2,4,Friendly,2
Zimbabwe,Malawi,3,1,African Cup of Nations qualification,2
Austria,Chile,0,2,Friendly,2
Saudi Arabia,Ghana,5,0,Friendly,5
Andorra,Croatia,0,6,UEFA Euro qualification,6
Bulgaria,Luxembourg,3,0,UEFA Euro qualification,3
Cyprus,San Marino,3,0,UEFA Euro qualification,3
Denmark,Liechtenstein,4,0,UEFA Euro qualification,4
England,Russia,3,0,UEFA Euro qualification,3
Germany,Romania,3,1,Friendly,2
Mexico,Brazil,1,3,Friendly,2
Peru,Bolivia,2,0,Friendly,2
Slovakia,Wales,2,5,UEFA Euro qualification,3
Spain,Latvia,2,0,UEFA Euro qualification,2
Turkey,Hungary,3,0,UEFA Euro qualification,3
Mozambique,Zambia,0,3,COSAFA Cup,3
Bahrain,Singapore,3,1,Friendly,2
Lebanon,India,4,1,FIFA World Cup qualification,3
Oman,Nepal,2,0,FIFA World Cup qualification,2
Palestine,Singapore,0,4,FIFA World Cup qualification,4
Syria,Afghanistan,3,0,FIFA World Cup qualification,3
Thailand,Macau,6,1,FIFA World Cup qualification,5
Yemen,Maldives,3,0,FIFA World Cup qualification,3
Sierra Leone,Benin,0,2,African Cup of Nations qualification,2
Togo,Mali,0,2,African Cup of Nations qualification,2
Argentina,Chile,2,0,FIFA World Cup qualification,2
Azerbaijan,Portugal,0,2,UEFA Euro qualification,2
Cyprus,Wales,3,1,UEFA Euro qualification,2
Denmark,Spain,1,3,UEFA Euro qualification,2
England,Estonia,3,0,UEFA Euro qualification,3
Faroe Islands,France,0,6,UEFA Euro qualification,6
Hungary,Malta,2,0,UEFA Euro qualification,2
Iceland,Latvia,2,4,UEFA Euro qualification,2
Italy,Georgia,2,0,UEFA Euro qualification,2
Liechtenstein,Sweden,0,3,UEFA Euro qualification,3
Poland,Kazakhstan,3,1,UEFA Euro qualification,2
Scotland,Ukraine,3,1,UEFA Euro qualification,2
Slovakia,San Marino,7,0,UEFA Euro qualification,7
Switzerland,Austria,3,1,Friendly,2
Uruguay,Bolivia,5,0,FIFA World Cup qualification,5
Uzbekistan,Taiwan,9,0,FIFA World Cup qualification,9
Madagascar,Comoros,6,2,FIFA World Cup qualification,4
Senegal,Guinea,3,1,Friendly,2
Macau,Thailand,1,7,FIFA World Cup qualification,6
Bahrain,Libya,2,0,Friendly,2
Croatia,Slovakia,3,0,Friendly,3
Venezuela,Argentina,0,2,FIFA World Cup qualification,2
Azerbaijan,Serbia,1,6,UEFA Euro qualification,5
Belgium,Armenia,3,0,UEFA Euro qualification,3
Bosnia and Herzegovina,Norway,0,2,UEFA Euro qualification,2
Brazil,Ecuador,5,0,FIFA World Cup qualification,5
Chile,Peru,2,0,FIFA World Cup qualification,2
Denmark,Latvia,3,1,UEFA Euro qualification,2
Fiji,New Zealand,0,2,Oceania Nations Cup,2
France,Lithuania,2,0,UEFA Euro qualification,2
Georgia,Scotland,2,0,UEFA Euro qualification,2
Germany,Czech Republic,0,3,UEFA Euro qualification,3
Italy,South Africa,2,0,Friendly,2
Japan,Egypt,4,1,Friendly,3
Liechtenstein,Iceland,3,0,UEFA Euro qualification,3
Luxembourg,Romania,0,2,UEFA Euro qualification,2
North Macedonia,Andorra,3,0,UEFA Euro qualification,3
Morocco,Namibia,2,0,Friendly,2
Netherlands,Slovenia,2,0,UEFA Euro qualification,2
Ukraine,Faroe Islands,5,0,UEFA Euro qualification,5
Kyrgyzstan,Jordan,2,0,FIFA World Cup qualification,2
Bahrain,Malaysia,4,1,FIFA World Cup qualification,3
China PR,Myanmar,7,0,FIFA World Cup qualification,7
Mongolia,North Korea,1,4,FIFA World Cup qualification,3
Pakistan,Iraq,0,7,FIFA World Cup qualification,7
Myanmar,China PR,0,4,FIFA World Cup qualification,4
Hong Kong,Timor-Leste,8,1,FIFA World Cup qualification,7
Jordan,Kyrgyzstan,2,0,FIFA World Cup qualification,2
North Korea,Mongolia,5,1,FIFA World Cup qualification,4
Maldives,Yemen,2,0,FIFA World Cup qualification,2
Nepal,Oman,0,2,FIFA World Cup qualification,2
Qatar,Sri Lanka,5,0,FIFA World Cup qualification,5
Tajikistan,Bangladesh,5,0,FIFA World Cup qualification,5
Turkmenistan,Cambodia,4,1,FIFA World Cup qualification,3
United Arab Emirates,Vietnam,5,0,FIFA World Cup qualification,5
Taiwan,Uzbekistan,0,2,FIFA World Cup qualification,2
Bhutan,Tibet,3,0,Friendly,3
Indonesia,Syria,1,4,FIFA World Cup qualification,3
Saudi Arabia,Estonia,2,0,Friendly,2
Singapore,Tajikistan,2,0,FIFA World Cup qualification,2
Albania,Belarus,2,4,UEFA Euro qualification,2
Andorra,Estonia,0,2,UEFA Euro qualification,2
Argentina,Bolivia,3,0,FIFA World Cup qualification,3
Comoros,Madagascar,0,4,FIFA World Cup qualification,4
Czech Republic,Slovakia,3,1,UEFA Euro qualification,2
Germany,Cyprus,4,0,UEFA Euro qualification,4
Greece,Malta,5,0,UEFA Euro qualification,5
Latvia,Liechtenstein,4,1,UEFA Euro qualification,3
Lithuania,Ukraine,2,0,UEFA Euro qualification,2
North Macedonia,Croatia,2,0,UEFA Euro qualification,2
Moldova,Hungary,3,0,UEFA Euro qualification,3
Paraguay,Ecuador,5,1,FIFA World Cup qualification,4
Poland,Belgium,2,0,UEFA Euro qualification,2
Spain,Sweden,3,0,UEFA Euro qualification,3
Tunisia,Namibia,2,0,Friendly,2
Ghana,Togo,2,0,Friendly,2
Jamaica,El Salvador,3,0,Friendly,3
Saint Kitts and Nevis,Antigua and Barbuda,3,0,Friendly,3
Eswatini,Malawi,0,3,Friendly,3
Syria,Indonesia,7,0,FIFA World Cup qualification,7
Turkmenistan,Hong Kong,3,0,FIFA World Cup qualification,3
Angola,Guinea,0,3,Friendly,3
South Africa,Canada,2,0,Friendly,2
Venezuela,Bolivia,5,3,FIFA World Cup qualification,2
Chile,Paraguay,0,3,FIFA World Cup qualification,3
Cyprus,Czech Republic,0,2,UEFA Euro qualification,2
Denmark,Iceland,3,0,UEFA Euro qualification,3
Ecuador,Peru,5,1,FIFA World Cup qualification,4
Georgia,Lithuania,0,2,UEFA Euro qualification,2
Ghana,Benin,4,2,Friendly,2
Italy,Faroe Islands,3,1,UEFA Euro qualification,2
Jamaica,Guatemala,2,0,Friendly,2
Malta,Norway,1,4,UEFA Euro qualification,3
Morocco,Senegal,3,0,Friendly,3
New Caledonia,Fiji,4,0,Oceania Nations Cup,4
New Zealand,Vanuatu,4,1,Oceania Nations Cup,3
Qatar,Ivory Coast,1,6,Friendly,5
Romania,Albania,6,1,UEFA Euro qualification,5
San Marino,Slovakia,0,5,UEFA Euro qualification,5
Slovenia,Bulgaria,0,2,UEFA Euro qualification,2
United Arab Emirates,Togo,0,5,Friendly,5
Antigua and Barbuda,Saint Kitts and Nevis,2,0,Friendly,2
Guinea-Bissau,Sierra Leone,2,0,Amílcar Cabral Cup,2
Uganda,Djibouti,7,0,CECAFA Cup,7
Somalia,Burundi,0,3,CECAFA Cup,3
Oman,Jordan,0,3,Friendly,3
Rwanda,Uganda,0,2,CECAFA Cup,2
Djibouti,Rwanda,0,9,CECAFA Cup,9
Zanzibar,Ethiopia,3,1,CECAFA Cup,2
Kenya,Somalia,2,0,CECAFA Cup,2
Bermuda,Saint Kitts and Nevis,4,2,Friendly,2
Oman,Tajikistan,4,2,Friendly,2
Burundi,Uganda,0,2,CECAFA Cup,2
Andalusia,Zambia,4,1,Friendly,3
Canary Islands,Angola,2,0,Friendly,2
Egypt,Namibia,3,0,Friendly,3
Nigeria,Sudan,2,0,Friendly,2
Guinea,Sudan,6,0,Friendly,6
Kuwait,Ivory Coast,0,2,Friendly,2
Morocco,Zambia,2,0,Friendly,2
Senegal,Namibia,3,1,Friendly,2
South Africa,Mozambique,2,0,Friendly,2
Bermuda,Puerto Rico,0,2,Friendly,2
Dominica,Guadeloupe,0,3,Friendly,3
United States,Sweden,2,0,Friendly,2
Namibia,Morocco,1,5,African Cup of Nations,4
Egypt,Cameroon,4,2,African Cup of Nations,2
Sudan,Zambia,0,3,African Cup of Nations,3
Kuwait,Singapore,0,2,Friendly,2
Ivory Coast,Benin,4,1,African Cup of Nations,3
Cameroon,Zambia,5,1,African Cup of Nations,4
Egypt,Sudan,3,0,African Cup of Nations,3
Oman,Singapore,2,0,Friendly,2
Senegal,Angola,1,3,African Cup of Nations,2
Tunisia,South Africa,3,1,African Cup of Nations,2
Ghana,Morocco,2,0,African Cup of Nations,2
Jordan,Lebanon,4,1,Friendly,3
Ivory Coast,Mali,3,0,African Cup of Nations,3
Nigeria,Benin,2,0,African Cup of Nations,2
Cameroon,Sudan,3,0,African Cup of Nations,3
Japan,Bosnia and Herzegovina,3,0,Friendly,3
Belarus,Iceland,2,0,Malta International Tournament,2
Ivory Coast,Guinea,5,0,African Cup of Nations,5
Armenia,Iceland,0,2,Malta International Tournament,2
Aruba,Antigua and Barbuda,0,3,FIFA World Cup qualification,3
Australia,Qatar,3,0,FIFA World Cup qualification,3
Austria,Germany,0,3,Friendly,3
Belize,Saint Kitts and Nevis,3,1,FIFA World Cup qualification,2
Croatia,Netherlands,0,3,Friendly,3
Czech Republic,Poland,0,2,Friendly,2
El Salvador,Anguilla,12,0,FIFA World Cup qualification,12
Georgia,Latvia,1,3,Friendly,2
Honduras,Paraguay,2,0,Friendly,2
Italy,Portugal,3,1,Friendly,2
Japan,Thailand,4,1,FIFA World Cup qualification,3
South Korea,Turkmenistan,4,0,FIFA World Cup qualification,4
Saudi Arabia,Singapore,2,0,FIFA World Cup qualification,2
United Arab Emirates,Kuwait,2,0,FIFA World Cup qualification,2
Wales,Norway,3,0,Friendly,3
Ivory Coast,Egypt,1,4,African Cup of Nations,3
Ghana,Ivory Coast,4,2,African Cup of Nations,2
Eswatini,Botswana,1,4,Friendly,3
China PR,North Korea,3,1,EAFF Championship,2
Poland,Estonia,2,0,Friendly,2
Dominican Republic,Haiti,0,2,Friendly,2
Iceland,Faroe Islands,3,0,Friendly,3
Uzbekistan,Jordan,4,1,Friendly,3
Togo,Guinea,0,2,Friendly,2
Andorra,Latvia,0,3,Friendly,3
Anguilla,El Salvador,0,4,FIFA World Cup qualification,4
Belgium,Morocco,1,4,Friendly,3
Curaçao,Nicaragua,2,0,FIFA World Cup qualification,2
Ecuador,Haiti,3,1,Friendly,2
Egypt,Argentina,0,2,Friendly,2
Estonia,Canada,2,0,Friendly,2
Grenada,United States Virgin Islands,10,0,FIFA World Cup qualification,10
Ivory Coast,Tunisia,0,2,Friendly,2
Luxembourg,Wales,0,2,Friendly,2
Malta,Liechtenstein,7,1,Friendly,6
Montenegro,Norway,3,1,Friendly,2
Montserrat,Suriname,1,7,FIFA World Cup qualification,6
Namibia,Malawi,1,3,Friendly,2
Northern Ireland,Georgia,4,1,Friendly,3
Peru,Costa Rica,3,1,Friendly,2
Poland,United States,0,3,Friendly,3
Qatar,Iraq,2,0,FIFA World Cup qualification,2
Romania,Russia,3,0,Friendly,3
Singapore,Lebanon,2,0,FIFA World Cup qualification,2
South Africa,Paraguay,3,0,Friendly,3
Saint Lucia,Turks and Caicos Islands,2,0,FIFA World Cup qualification,2
Sudan,Liberia,0,2,Friendly,2
Switzerland,Germany,0,4,Friendly,4
Turkmenistan,Jordan,0,2,FIFA World Cup qualification,2
Ukraine,Serbia,2,0,Friendly,2
Uzbekistan,Saudi Arabia,3,0,FIFA World Cup qualification,3
Nepal,Pakistan,0,2,Friendly,2
Cayman Islands,Bermuda,1,3,FIFA World Cup qualification,2
Sri Lanka,Guam,5,1,AFC Challenge Cup qualification,4
Pakistan,Sri Lanka,1,7,AFC Challenge Cup qualification,6
Taiwan,Guam,4,1,AFC Challenge Cup qualification,3
Pakistan,Guam,9,2,AFC Challenge Cup qualification,7
Lebanon,Maldives,4,0,AFC Asian Cup qualification,4
Oman,Kyrgyzstan,2,0,Friendly,2
Trinidad and Tobago,Grenada,2,0,Friendly,2
Colombia,Venezuela,5,2,Friendly,3
Liberia,Sierra Leone,3,1,Friendly,2
Trinidad and Tobago,Barbados,3,0,Friendly,3
Tajikistan,Bhutan,3,1,AFC Challenge Cup qualification,2
Philippines,Bhutan,3,0,AFC Challenge Cup qualification,3
Tajikistan,Brunei,4,0,AFC Challenge Cup qualification,4
Antigua and Barbuda,Saint Lucia,6,1,Friendly,5
Greece,Cyprus,2,0,Friendly,2
Thailand,Nepal,7,0,Friendly,7
Brittany,Congo,3,1,Friendly,2
Honduras,Belize,2,0,Friendly,2
Russia,Kazakhstan,6,0,Friendly,6
India,Taiwan,3,0,Friendly,3
Netherlands,Ukraine,3,0,Friendly,3
Switzerland,Slovakia,2,0,Friendly,2
China PR,Jordan,2,0,Friendly,2
Czech Republic,Lithuania,2,0,Friendly,2
France,Ecuador,2,0,Friendly,2
Libya,Liberia,4,2,Friendly,2
Montenegro,Kazakhstan,3,0,Friendly,3
Cambodia,Macau,3,1,AFC Challenge Cup qualification,2
England,United States,2,0,Friendly,2
Finland,Turkey,0,2,Friendly,2
Austria,Malta,5,1,Friendly,4
Czech Republic,Scotland,3,1,Friendly,2
Italy,Belgium,3,1,Friendly,2
Switzerland,Liechtenstein,3,0,Friendly,3
Cameroon,Cape Verde,2,0,FIFA World Cup qualification,2
Malawi,Djibouti,8,1,FIFA World Cup qualification,7
Morocco,Ethiopia,3,0,FIFA World Cup qualification,3
Portugal,Georgia,2,0,Friendly,2
Romania,Montenegro,4,0,Friendly,4
Rwanda,Mauritania,3,0,FIFA World Cup qualification,3
Angola,Benin,3,0,FIFA World Cup qualification,3
Equatorial Guinea,Sierra Leone,2,0,FIFA World Cup qualification,2
Ghana,Libya,3,0,FIFA World Cup qualification,3
Mali,Congo,4,2,FIFA World Cup qualification,2
Netherlands,Wales,2,0,Friendly,2
Nigeria,South Africa,2,0,FIFA World Cup qualification,2
Trinidad and Tobago,England,0,3,Friendly,3
Japan,Oman,3,0,FIFA World Cup qualification,3
Saudi Arabia,Lebanon,4,1,FIFA World Cup qualification,3
Singapore,Uzbekistan,3,7,FIFA World Cup qualification,4
India,Nepal,4,0,SAFF Cup,4
Maldives,Pakistan,3,0,SAFF Cup,3
Chile,Guatemala,2,0,Friendly,2
Honduras,Puerto Rico,4,0,FIFA World Cup qualification,4
Lithuania,Russia,1,4,Friendly,3
Mexico,Argentina,1,4,Friendly,3
Maldives,Nepal,4,1,SAFF Cup,3
Algeria,Liberia,3,0,FIFA World Cup qualification,3
Brazil,Venezuela,0,2,Friendly,2
Sri Lanka,Bhutan,2,0,SAFF Cup,2
Djibouti,Egypt,0,4,FIFA World Cup qualification,4
Burkina Faso,Burundi,2,0,FIFA World Cup qualification,2
Honduras,Haiti,3,1,Friendly,2
Kenya,Guinea,2,0,FIFA World Cup qualification,2
Mauritania,Morocco,1,4,FIFA World Cup qualification,3
Pakistan,Nepal,1,4,SAFF Cup,3
Portugal,Turkey,2,0,UEFA Euro,2
Seychelles,Tunisia,0,2,FIFA World Cup qualification,2
Uzbekistan,Singapore,3,0,FIFA World Cup qualification,3
South Africa,Equatorial Guinea,4,1,FIFA World Cup qualification,3
Afghanistan,Bhutan,1,3,SAFF Cup,2
Antigua and Barbuda,Saint Kitts and Nevis,2,0,Friendly,2
Benin,Uganda,4,1,FIFA World Cup qualification,3
Germany,Poland,2,0,UEFA Euro,2
Kuwait,Syria,4,2,FIFA World Cup qualification,2
Mauritius,Cameroon,0,3,FIFA World Cup qualification,3
Mexico,Peru,4,0,Friendly,4
Zimbabwe,Namibia,2,0,FIFA World Cup qualification,2
Bermuda,Barbados,3,0,Friendly,3
Netherlands,Italy,3,0,UEFA Euro,3
Greece,Sweden,0,2,UEFA Euro,2
Spain,Russia,4,1,UEFA Euro,3
Czech Republic,Portugal,1,3,UEFA Euro,2
Djibouti,DR Congo,0,6,FIFA World Cup qualification,6
Netherlands,France,4,1,UEFA Euro,3
Gabon,Ghana,2,0,FIFA World Cup qualification,2
Guatemala,Saint Lucia,6,0,FIFA World Cup qualification,6
Kenya,Zimbabwe,2,0,FIFA World Cup qualification,2
North Korea,Jordan,2,0,FIFA World Cup qualification,2
Niger,Benin,0,2,FIFA World Cup qualification,2
Qatar,Australia,1,3,FIFA World Cup qualification,2
Rwanda,Morocco,3,1,FIFA World Cup qualification,2
Singapore,Saudi Arabia,0,3,FIFA World Cup qualification,3
Syria,Iran,0,2,FIFA World Cup qualification,2
Thailand,Japan,0,3,FIFA World Cup qualification,3
Turkmenistan,South Korea,1,3,FIFA World Cup qualification,2
Uganda,Angola,3,1,FIFA World Cup qualification,2
Uzbekistan,Lebanon,3,0,FIFA World Cup qualification,3
Belize,Mexico,0,2,FIFA World Cup qualification,2
Bolivia,Chile,0,2,FIFA World Cup qualification,2
Jamaica,Bahamas,7,0,FIFA World Cup qualification,7
Paraguay,Brazil,2,0,FIFA World Cup qualification,2
Switzerland,Portugal,2,0,UEFA Euro,2
United States,Barbados,8,0,FIFA World Cup qualification,8
Saint Vincent and the Grenadines,Canada,0,3,FIFA World Cup qualification,3
France,Italy,0,2,UEFA Euro,2
Netherlands,Romania,2,0,UEFA Euro,2
Uruguay,Peru,6,0,FIFA World Cup qualification,6
Bolivia,Paraguay,4,2,FIFA World Cup qualification,2
Jamaica,Bahamas,6,0,FIFA World Cup qualification,6
Russia,Sweden,2,0,UEFA Euro,2
Canada,Saint Vincent and the Grenadines,4,1,FIFA World Cup qualification,3
Libya,Lesotho,4,0,FIFA World Cup qualification,4
Burkina Faso,Seychelles,4,1,FIFA World Cup qualification,3
Costa Rica,Grenada,3,0,FIFA World Cup qualification,3
Mexico,Belize,7,0,FIFA World Cup qualification,7
Morocco,Rwanda,2,0,FIFA World Cup qualification,2
Netherlands,Russia,1,3,UEFA Euro,2
New Caledonia,Vanuatu,3,0,Oceania Nations Cup,3
Nigeria,Equatorial Guinea,2,0,FIFA World Cup qualification,2
Senegal,Liberia,3,1,FIFA World Cup qualification,2
Saint Lucia,Guatemala,1,3,FIFA World Cup qualification,2
Benin,Niger,2,0,FIFA World Cup qualification,2
Bermuda,Trinidad and Tobago,0,2,FIFA World Cup qualification,2
Cape Verde,Mauritius,3,1,FIFA World Cup qualification,2
Congo,Chad,2,0,FIFA World Cup qualification,2
DR Congo,Djibouti,5,1,FIFA World Cup qualification,4
Cuba,Antigua and Barbuda,4,0,FIFA World Cup qualification,4
Egypt,Malawi,2,0,FIFA World Cup qualification,2
El Salvador,Panama,3,1,FIFA World Cup qualification,2
Ethiopia,Mauritania,6,1,FIFA World Cup qualification,5
Ghana,Gabon,2,0,FIFA World Cup qualification,2
Guinea,Namibia,4,0,FIFA World Cup qualification,4
Iran,Kuwait,2,0,FIFA World Cup qualification,2
Ivory Coast,Botswana,4,0,FIFA World Cup qualification,4
Jordan,Turkmenistan,2,0,FIFA World Cup qualification,2
Mali,Sudan,3,0,FIFA World Cup qualification,3
Mozambique,Madagascar,3,0,FIFA World Cup qualification,3
Saudi Arabia,Uzbekistan,4,0,FIFA World Cup qualification,4
United Arab Emirates,Syria,1,3,FIFA World Cup qualification,2
Russia,Spain,0,3,UEFA Euro,3
Gabon,Lesotho,2,0,FIFA World Cup qualification,2
Trinidad and Tobago,Guyana,2,0,Friendly,2
Provence,Padania,1,6,Viva World Cup,5
Provence,Iraqi Kurdistan,0,3,Viva World Cup,3
Arameans Suryoye,Provence,5,0,Viva World Cup,5
Sápmi,Padania,0,2,Viva World Cup,2
Padania,Arameans Suryoye,4,1,Viva World Cup,3
Sápmi,Provence,4,2,Viva World Cup,2
Sápmi,Iraqi Kurdistan,3,1,Viva World Cup,2
Padania,Arameans Suryoye,2,0,Viva World Cup,2
Trinidad and Tobago,Curaçao,2,0,Friendly,2
Mauritius,Seychelles,0,7,COSAFA Cup qualification,7
Comoros,Namibia,0,3,COSAFA Cup qualification,3
Botswana,Mozambique,0,2,COSAFA Cup,2
Grenada,Aruba,3,1,CFU Caribbean Cup qualification,2
Trinidad and Tobago,Haiti,2,0,Friendly,2
Myanmar,Nepal,3,0,AFC Challenge Cup,3
Curaçao,Grenada,2,0,CFU Caribbean Cup qualification,2
North Korea,Sri Lanka,3,0,AFC Challenge Cup,3
Afghanistan,Turkmenistan,0,5,AFC Challenge Cup,5
Sri Lanka,Myanmar,1,3,AFC Challenge Cup,2
Afghanistan,Tajikistan,0,4,AFC Challenge Cup,4
Madagascar,Zambia,0,2,COSAFA Cup,2
Nepal,Sri Lanka,3,0,AFC Challenge Cup,3
Guatemala,Bolivia,3,0,Friendly,3
Iran,Palestine,3,0,WAFF Championship,3
Guyana,Dominica,3,0,CFU Caribbean Cup qualification,3
Dominica,Suriname,1,3,CFU Caribbean Cup qualification,2
Iran,Qatar,6,1,WAFF Championship,5
Myanmar,North Korea,0,4,AFC Challenge Cup,4
India,Tajikistan,4,1,AFC Challenge Cup,3
Iran,Syria,2,0,WAFF Championship,2
Jordan,Qatar,3,0,WAFF Championship,3
El Salvador,Trinidad and Tobago,1,3,Friendly,2
Albania,Liechtenstein,2,0,Friendly,2
Bahrain,Burkina Faso,3,1,Friendly,2
Cuba,Trinidad and Tobago,1,3,FIFA World Cup qualification,2
Denmark,Spain,0,3,Friendly,3
Finland,Israel,2,0,Friendly,2
Germany,Belgium,2,0,Friendly,2
Japan,Uruguay,1,3,Friendly,2
Kazakhstan,Andorra,3,0,FIFA World Cup qualification,3
Lithuania,Moldova,3,0,Friendly,3
Luxembourg,North Macedonia,1,4,Friendly,3
Morocco,Benin,3,1,Friendly,2
Mozambique,Eswatini,3,0,Friendly,3
Oman,Uzbekistan,2,0,Friendly,2
Portugal,Faroe Islands,5,0,Friendly,5
Qatar,Tajikistan,5,0,Friendly,5
Slovakia,Greece,0,2,Friendly,2
Sudan,Egypt,4,0,Friendly,4
Switzerland,Cyprus,4,1,Friendly,3
Venezuela,Syria,4,1,Friendly,3
Indonesia,Cambodia,7,0,Friendly,7
Cambodia,Myanmar,1,7,Friendly,6
Libya,Chad,3,0,Friendly,3
Indonesia,Myanmar,4,0,Friendly,4
Bermuda,Antigua and Barbuda,0,4,CFU Caribbean Cup qualification,4
Cayman Islands,Saint Martin,3,0,CFU Caribbean Cup qualification,3
Libya,Niger,6,2,Friendly,4
Saint Martin,Bermuda,0,7,CFU Caribbean Cup qualification,7
Trinidad and Tobago,Guyana,3,0,Friendly,3
Djibouti,Malawi,0,3,FIFA World Cup qualification,3
Andorra,England,0,2,FIFA World Cup qualification,2
Armenia,Turkey,0,2,FIFA World Cup qualification,2
Austria,France,3,1,FIFA World Cup qualification,2
Croatia,Kazakhstan,3,0,FIFA World Cup qualification,3
Ecuador,Bolivia,3,1,FIFA World Cup qualification,2
Fiji,Vanuatu,2,0,Oceania Nations Cup,2
Gambia,Liberia,3,0,FIFA World Cup qualification,3
Liechtenstein,Germany,0,6,FIFA World Cup qualification,6
Luxembourg,Greece,0,3,FIFA World Cup qualification,3
Malta,Portugal,0,4,FIFA World Cup qualification,4
Mauritius,Tanzania,1,4,FIFA World Cup qualification,3
New Caledonia,New Zealand,1,3,Oceania Nations Cup,2
Qatar,Uzbekistan,3,0,FIFA World Cup qualification,3
Romania,Lithuania,0,3,FIFA World Cup qualification,3
Serbia,Faroe Islands,2,0,FIFA World Cup qualification,2
Costa Rica,Suriname,7,0,FIFA World Cup qualification,7
El Salvador,Haiti,5,0,FIFA World Cup qualification,5
Mexico,Jamaica,3,0,FIFA World Cup qualification,3
Chile,Brazil,0,3,FIFA World Cup qualification,3
Lesotho,Gabon,0,3,FIFA World Cup qualification,3
Niger,Uganda,3,1,FIFA World Cup qualification,2
Paraguay,Venezuela,2,0,FIFA World Cup qualification,2
Albania,Malta,3,0,FIFA World Cup qualification,3
Andorra,Belarus,1,3,FIFA World Cup qualification,2
Bosnia and Herzegovina,Estonia,7,0,FIFA World Cup qualification,7
Chad,Sudan,1,3,FIFA World Cup qualification,2
Chile,Colombia,4,0,FIFA World Cup qualification,4
Croatia,England,1,4,FIFA World Cup qualification,3
Guatemala,Cuba,4,1,FIFA World Cup qualification,3
Haiti,Costa Rica,1,3,FIFA World Cup qualification,2
Honduras,Jamaica,2,0,FIFA World Cup qualification,2
Italy,Georgia,2,0,FIFA World Cup qualification,2
Kazakhstan,Ukraine,1,3,FIFA World Cup qualification,2
Latvia,Greece,0,2,FIFA World Cup qualification,2
Lithuania,Austria,2,0,FIFA World Cup qualification,2
New Zealand,New Caledonia,3,0,Oceania Nations Cup,3
San Marino,Poland,0,2,FIFA World Cup qualification,2
Spain,Armenia,4,0,FIFA World Cup qualification,4
Suriname,El Salvador,0,2,FIFA World Cup qualification,2
United States,Trinidad and Tobago,3,0,FIFA World Cup qualification,3
Martinique,Anguilla,3,1,CFU Caribbean Cup qualification,2
Antigua and Barbuda,Guyana,3,0,Friendly,3
Saint Kitts and Nevis,British Virgin Islands,4,0,CFU Caribbean Cup qualification,4
Mayotte,Réunion,1,6,African Nations Championship,5
New Caledonia,Guadeloupe,0,4,African Nations Championship,4
French Guiana,Mayotte,4,2,African Nations Championship,2
Saint Kitts and Nevis,Barbados,1,3,CFU Caribbean Cup qualification,2
South Africa,Malawi,3,0,Friendly,3
French Guiana,Réunion,0,2,African Nations Championship,2
Guadeloupe,French Guiana,4,0,African Nations Championship,4
Trinidad and Tobago,Dominican Republic,9,0,Friendly,9
Malaysia,Pakistan,4,1,Friendly,3
Belgium,Armenia,2,0,FIFA World Cup qualification,2
Bolivia,Peru,3,0,FIFA World Cup qualification,3
Cameroon,Mauritius,5,0,FIFA World Cup qualification,5
Denmark,Malta,3,0,FIFA World Cup qualification,3
England,Kazakhstan,5,1,FIFA World Cup qualification,4
Estonia,Spain,0,3,FIFA World Cup qualification,3
Ghana,Lesotho,3,0,FIFA World Cup qualification,3
Greece,Moldova,3,0,FIFA World Cup qualification,3
Guadeloupe,Cayman Islands,7,1,CFU Caribbean Cup qualification,6
Honduras,Canada,3,1,FIFA World Cup qualification,2
Hungary,Albania,2,0,FIFA World Cup qualification,2
Ivory Coast,Madagascar,3,0,FIFA World Cup qualification,3
South Korea,Uzbekistan,3,0,Friendly,3
Luxembourg,Israel,1,3,FIFA World Cup qualification,2
Morocco,Mauritania,4,1,FIFA World Cup qualification,3
Namibia,Zimbabwe,4,2,FIFA World Cup qualification,2
Netherlands,Iceland,2,0,FIFA World Cup qualification,2
Nigeria,Sierra Leone,4,1,FIFA World Cup qualification,3
San Marino,Slovakia,1,3,FIFA World Cup qualification,2
Serbia,Lithuania,3,0,FIFA World Cup qualification,3
Slovenia,Northern Ireland,2,0,FIFA World Cup qualification,2
Sudan,Congo,2,0,FIFA World Cup qualification,2
Suriname,Costa Rica,1,4,FIFA World Cup qualification,3
Tanzania,Cape Verde,3,1,FIFA World Cup qualification,2
Togo,Eswatini,6,0,FIFA World Cup qualification,6
Tunisia,Seychelles,5,0,FIFA World Cup qualification,5
United States,Cuba,6,1,FIFA World Cup qualification,5
Wales,Liechtenstein,2,0,FIFA World Cup qualification,2
Angola,Niger,3,1,FIFA World Cup qualification,2
Burundi,Burkina Faso,1,3,FIFA World Cup qualification,2
Egypt,Djibouti,4,0,FIFA World Cup qualification,4
Venezuela,Brazil,0,4,FIFA World Cup qualification,4
France,Tunisia,3,1,Friendly,2
Australia,Qatar,4,0,FIFA World Cup qualification,4
Austria,Serbia,1,3,FIFA World Cup qualification,2
Belarus,England,1,3,FIFA World Cup qualification,2
Bosnia and Herzegovina,Armenia,4,1,FIFA World Cup qualification,3
Costa Rica,Haiti,2,0,FIFA World Cup qualification,2
Croatia,Andorra,4,0,FIFA World Cup qualification,4
El Salvador,Suriname,3,0,FIFA World Cup qualification,3
Grenada,Cayman Islands,4,2,CFU Caribbean Cup qualification,2
Guadeloupe,Martinique,3,1,CFU Caribbean Cup qualification,2
South Korea,United Arab Emirates,4,1,FIFA World Cup qualification,3
Malaysia,Nepal,4,0,Merdeka Tournament,4
Northern Ireland,San Marino,4,0,FIFA World Cup qualification,4
Russia,Finland,3,0,FIFA World Cup qualification,3
Venezuela,Ecuador,3,1,FIFA World Cup qualification,2
Malaysia,Afghanistan,6,0,Merdeka Tournament,6
Timor-Leste,Brunei,1,4,AFF Championship,3
Bolivia,El Salvador,0,2,Friendly,2
Cuba,Curaçao,7,1,CFU Caribbean Cup qualification,6
Malaysia,Myanmar,4,0,Merdeka Tournament,4
Cuba,Suriname,6,0,CFU Caribbean Cup qualification,6
Trinidad and Tobago,Saint Kitts and Nevis,3,1,CFU Caribbean Cup qualification,2
Cayman Islands,Jamaica,0,2,Friendly,2
Saudi Arabia,Bahrain,4,0,Friendly,4
Bangladesh,Indonesia,0,2,Friendly,2
Japan,Syria,3,1,Friendly,2
Myanmar,Malaysia,4,1,Friendly,3
Austria,Turkey,2,4,Friendly,2
Brazil,Portugal,6,2,Friendly,4
Egypt,Benin,5,1,Friendly,4
El Salvador,Costa Rica,1,3,FIFA World Cup qualification,2
Fiji,New Zealand,2,0,Oceania Nations Cup,2
Jamaica,Canada,3,0,FIFA World Cup qualification,3
Macau,Hong Kong,1,9,Friendly,8
Morocco,Zambia,3,0,Friendly,3
Netherlands,Sweden,3,1,Friendly,2
Northern Ireland,Hungary,0,2,Friendly,2
Qatar,Japan,0,3,FIFA World Cup qualification,3
San Marino,Czech Republic,0,3,FIFA World Cup qualification,3
Saudi Arabia,South Korea,0,2,FIFA World Cup qualification,2
Serbia,Bulgaria,6,1,Friendly,5
Slovakia,Liechtenstein,4,0,Friendly,4
Spain,Chile,3,0,Friendly,3
Trinidad and Tobago,Cuba,3,0,FIFA World Cup qualification,3
United States,Guatemala,2,0,FIFA World Cup qualification,2
Indonesia,Myanmar,3,0,AFF Championship,3
Jamaica,Grenada,4,0,CFU Caribbean Cup,4
Singapore,Cambodia,5,0,AFF Championship,5
Cuba,Antigua and Barbuda,3,0,CFU Caribbean Cup,3
Malaysia,Laos,3,0,AFF Championship,3
Thailand,Vietnam,2,0,AFF Championship,2
Grenada,Barbados,4,2,CFU Caribbean Cup,2
Indonesia,Cambodia,4,0,AFF Championship,4
Singapore,Myanmar,3,1,AFF Championship,2
Thailand,Laos,6,0,AFF Championship,6
Indonesia,Singapore,0,2,AFF Championship,2
Thailand,Malaysia,3,0,AFF Championship,3
Vietnam,Laos,4,0,AFF Championship,4
Jamaica,Guadeloupe,2,0,CFU Caribbean Cup,2
Jamaica,Grenada,2,0,CFU Caribbean Cup,2
Oman,China PR,3,1,Friendly,2
Iran,China PR,2,0,Friendly,2
Oman,Ecuador,2,0,Friendly,2
Zambia,Djibouti,3,0,CECAFA Cup,3
Uganda,Rwanda,4,0,CECAFA Cup,4
Zanzibar,Somalia,2,0,CECAFA Cup,2
Djibouti,Burundi,0,4,CECAFA Cup,4
Bahrain,Iraq,3,1,Gulf Cup,2
Rwanda,Somalia,3,0,CECAFA Cup,3
United Arab Emirates,Yemen,3,1,Gulf Cup,2
Kenya,Djibouti,5,1,CECAFA Cup,4
Oman,Iraq,4,0,Gulf Cup,4
Rwanda,Tanzania,0,2,CECAFA Cup,2
Uganda,Somalia,4,0,CECAFA Cup,4
Saudi Arabia,Yemen,6,0,Gulf Cup,6
Sudan,Zambia,2,0,CECAFA Cup,2
Iran,China PR,3,1,Friendly,2
Zanzibar,Rwanda,0,3,CECAFA Cup,3
Oman,Bahrain,2,0,Gulf Cup,2
Uganda,Burundi,5,0,CECAFA Cup,5
United Arab Emirates,Saudi Arabia,0,3,Gulf Cup,3
Iran,Singapore,6,0,AFC Asian Cup qualification,6
Vietnam,Lebanon,3,1,AFC Asian Cup qualification,2
Honduras,Chile,2,0,Friendly,2
Syria,Turkmenistan,5,1,Friendly,4
Kuwait,Turkmenistan,2,0,Friendly,2
China PR,Vietnam,6,1,AFC Asian Cup qualification,5
Hong Kong,Bahrain,1,3,AFC Asian Cup qualification,2
Malaysia,United Arab Emirates,0,5,AFC Asian Cup qualification,5
Costa Rica,Panama,3,0,UNCAF Cup,3
Belize,El Salvador,1,4,UNCAF Cup,3
Honduras,Nicaragua,4,1,UNCAF Cup,3
Guatemala,Costa Rica,1,3,UNCAF Cup,2
Honduras,El Salvador,2,0,UNCAF Cup,2
Lebanon,Syria,0,2,AFC Asian Cup qualification,2
Nicaragua,Guatemala,2,0,UNCAF Cup,2
Costa Rica,El Salvador,3,0,UNCAF Cup,3
Japan,Finland,5,1,Friendly,4
Barbados,Grenada,5,0,Friendly,5
Brazil,Italy,2,0,Friendly,2
Cyprus,Serbia,0,2,Cyprus International Tournament,2
Andorra,Lithuania,1,3,Friendly,2
Angola,Mali,0,4,Friendly,4
Austria,Sweden,0,2,Friendly,2
Belgium,Slovenia,2,0,Friendly,2
Cameroon,Guinea,3,1,Friendly,2
Colombia,Haiti,2,0,Friendly,2
Costa Rica,Honduras,2,0,FIFA World Cup qualification,2
Estonia,Kazakhstan,0,2,Friendly,2
France,Argentina,0,2,Friendly,2
Liechtenstein,Iceland,0,2,Friendly,2
Mozambique,Malawi,2,0,Friendly,2
San Marino,Northern Ireland,0,3,FIFA World Cup qualification,3
South Africa,Chile,0,2,Friendly,2
Spain,England,2,0,Friendly,2
United States,Mexico,2,0,FIFA World Cup qualification,2
Sudan,Uganda,0,2,Friendly,2
Macau,Northern Mariana Islands,6,1,EAFF Championship,5
Mexico,Bolivia,5,1,Friendly,4
Nepal,Sri Lanka,4,2,Friendly,2
Northern Mariana Islands,Mongolia,1,4,EAFF Championship,3
Bahrain,Zimbabwe,5,2,Friendly,3
Argentina,Venezuela,4,0,FIFA World Cup qualification,4
Belgium,Bosnia and Herzegovina,2,4,FIFA World Cup qualification,2
Burkina Faso,Guinea,4,2,FIFA World Cup qualification,2
Cape Verde,Equatorial Guinea,5,0,Friendly,5
Colombia,Bolivia,2,0,FIFA World Cup qualification,2
England,Slovakia,4,0,Friendly,4
Germany,Liechtenstein,4,0,FIFA World Cup qualification,4
North Korea,United Arab Emirates,2,0,FIFA World Cup qualification,2
Luxembourg,Latvia,0,4,FIFA World Cup qualification,4
Malta,Denmark,0,3,FIFA World Cup qualification,3
Mexico,Costa Rica,2,0,FIFA World Cup qualification,2
Moldova,Switzerland,0,2,FIFA World Cup qualification,2
Montenegro,Italy,0,2,FIFA World Cup qualification,2
Netherlands,Scotland,3,0,FIFA World Cup qualification,3
Oman,Senegal,2,0,Friendly,2
Russia,Azerbaijan,2,0,FIFA World Cup qualification,2
Thailand,New Zealand,3,1,Friendly,2
Uruguay,Paraguay,2,0,FIFA World Cup qualification,2
Uzbekistan,Qatar,4,0,FIFA World Cup qualification,4
Wales,Finland,0,2,FIFA World Cup qualification,2
Ivory Coast,Malawi,5,0,FIFA World Cup qualification,5
Peru,Chile,1,3,FIFA World Cup qualification,2
Angola,Morocco,0,2,Friendly,2
Panama,Haiti,4,0,Friendly,4
Portugal,South Africa,2,0,Friendly,2
Venezuela,Colombia,2,0,FIFA World Cup qualification,2
Andorra,Croatia,0,2,FIFA World Cup qualification,2
Australia,Uzbekistan,2,0,FIFA World Cup qualification,2
Bulgaria,Cyprus,2,0,FIFA World Cup qualification,2
Denmark,Albania,3,0,FIFA World Cup qualification,3
Honduras,Mexico,3,1,FIFA World Cup qualification,2
Hungary,Malta,3,0,FIFA World Cup qualification,3
Kazakhstan,Belarus,1,5,FIFA World Cup qualification,4
Latvia,Luxembourg,2,0,FIFA World Cup qualification,2
Netherlands,North Macedonia,4,0,FIFA World Cup qualification,4
Poland,San Marino,10,0,FIFA World Cup qualification,10
Serbia,Sweden,2,0,Friendly,2
Switzerland,Moldova,2,0,FIFA World Cup qualification,2
United States,Trinidad and Tobago,3,0,FIFA World Cup qualification,3
Wales,Germany,0,2,FIFA World Cup qualification,2
Bolivia,Argentina,6,1,FIFA World Cup qualification,5
Brazil,Peru,3,0,FIFA World Cup qualification,3
Sri Lanka,Brunei,5,1,AFC Challenge Cup qualification,4
Brunei,Pakistan,0,6,AFC Challenge Cup qualification,6
Macau,Mongolia,2,0,AFC Challenge Cup qualification,2
Maldives,Turkmenistan,1,3,AFC Challenge Cup qualification,2
Mongolia,Macau,3,1,AFC Challenge Cup qualification,2
Bhutan,Turkmenistan,0,7,AFC Challenge Cup qualification,7
Maldives,Bhutan,5,0,AFC Challenge Cup qualification,5
Turkmenistan,Philippines,5,0,AFC Challenge Cup qualification,5
Myanmar,Macau,4,0,AFC Challenge Cup qualification,4
Bangladesh,Macau,3,0,AFC Challenge Cup qualification,3
Tanzania,DR Congo,0,2,Friendly,2
Jordan,Zimbabwe,2,0,Friendly,2
Argentina,Panama,3,1,Friendly,2
El Salvador,Ecuador,3,1,Friendly,2
Japan,Chile,4,0,Kirin Cup,4
Tunisia,Sudan,4,0,Friendly,4
Bahrain,Congo,3,1,Friendly,2
Japan,Belgium,4,0,Kirin Cup,4
Malawi,Rwanda,2,0,Friendly,2
Turkey,Azerbaijan,2,0,Friendly,2
United Arab Emirates,Germany,2,7,Friendly,5
Bahrain,Jordan,4,0,Friendly,4
Costa Rica,United States,3,1,FIFA World Cup qualification,2
China PR,Saudi Arabia,1,4,Friendly,3
Belarus,Andorra,5,1,FIFA World Cup qualification,4
Estonia,Equatorial Guinea,3,0,Friendly,3
Gabon,Togo,3,0,FIFA World Cup qualification,3
Italy,Northern Ireland,3,0,Friendly,3
Kazakhstan,England,0,4,FIFA World Cup qualification,4
Namibia,DR Congo,4,0,Friendly,4
Paraguay,Chile,0,2,FIFA World Cup qualification,2
Slovakia,San Marino,7,0,FIFA World Cup qualification,7
Tunisia,Mozambique,2,0,FIFA World Cup qualification,2
United Arab Emirates,South Korea,0,2,FIFA World Cup qualification,2
Uruguay,Brazil,0,4,FIFA World Cup qualification,4
Algeria,Egypt,3,1,FIFA World Cup qualification,2
Mali,Ghana,0,2,FIFA World Cup qualification,2
Nigeria,Kenya,3,0,FIFA World Cup qualification,3
Azerbaijan,Spain,0,6,Friendly,6
Australia,Bahrain,2,0,FIFA World Cup qualification,2
Chile,Bolivia,4,0,FIFA World Cup qualification,4
Ecuador,Argentina,2,0,FIFA World Cup qualification,2
England,Andorra,6,0,FIFA World Cup qualification,6
Faroe Islands,Serbia,0,2,FIFA World Cup qualification,2
Finland,Russia,0,3,FIFA World Cup qualification,3
North Macedonia,Iceland,2,0,FIFA World Cup qualification,2
Netherlands,Norway,2,0,FIFA World Cup qualification,2
Sweden,Malta,4,0,FIFA World Cup qualification,4
Madagascar,Mayotte,2,0,Friendly,2
New Zealand,Spain,0,5,Confederations Cup,5
United States,Italy,1,3,Confederations Cup,2
South Africa,New Zealand,2,0,Confederations Cup,2
United States,Brazil,0,3,Confederations Cup,3
South Africa,Spain,0,2,Confederations Cup,2
Sudan,Ghana,0,2,FIFA World Cup qualification,2
Zambia,Algeria,0,2,FIFA World Cup qualification,2
Egypt,United States,0,3,Confederations Cup,3
Italy,Brazil,0,3,Confederations Cup,3
Mali,Benin,3,1,FIFA World Cup qualification,2
Provence,Gozo,3,1,Viva World Cup,2
Occitania,Iraqi Kurdistan,0,4,Viva World Cup,4
Mexico,Venezuela,4,0,Friendly,4
Spain,United States,0,2,Confederations Cup,2
Sápmi,Gozo,7,2,Viva World Cup,5
Provence,Iraqi Kurdistan,0,6,Viva World Cup,6
Padania,Sápmi,4,0,Viva World Cup,4
Padania,Iraqi Kurdistan,2,0,Viva World Cup,2
Cayman Islands,Jamaica,1,4,Friendly,3
Panama,Honduras,0,2,Friendly,2
Åland Islands,Greenland,4,2,Island Games,2
Ynys Môn,Frøya,3,0,Island Games,3
Rhodes,Isle of Wight,2,0,Island Games,2
Menorca,Greenland,6,0,Island Games,6
Ynys Môn,Guernsey,0,2,Island Games,2
Frøya,Gibraltar,0,8,Island Games,8
Isle of Wight,Saare County,5,1,Island Games,4
Isle of Man,Western Isles,5,0,Island Games,5
Gotland,Falkland Islands,2,0,Island Games,2
Guatemala,Canada,0,3,Friendly,3
Greenland,Shetland,3,1,Island Games,2
Gibraltar,Ynys Môn,1,3,Island Games,2
Guernsey,Frøya,8,0,Island Games,8
Rhodes,Saare County,3,0,Island Games,3
Jersey,Isle of Wight,4,1,Island Games,3
Western Isles,Falkland Islands,7,1,Island Games,6
Isle of Man,Gotland,4,2,Island Games,2
Falkland Islands,Frøya,1,3,Island Games,2
Gotland,Greenland,4,2,Island Games,2
Guernsey,Jersey,0,2,Island Games,2
Gibraltar,Isle of Wight,3,0,Island Games,3
Menorca,Western Isles,4,1,Island Games,3
Rhodes,Ynys Môn,4,0,Island Games,4
Isle of Man,Guernsey,0,5,Island Games,5
United States,Grenada,4,0,Gold Cup,4
Egypt,Rwanda,3,0,FIFA World Cup qualification,3
Nicaragua,Mexico,0,2,Gold Cup,2
Malawi,Eswatini,3,1,Friendly,2
Haiti,Grenada,2,0,Gold Cup,2
United States,Honduras,2,0,Gold Cup,2
Guadeloupe,Nicaragua,2,0,Gold Cup,2
Iraq,Palestine,3,0,Friendly,3
Honduras,Grenada,4,0,Gold Cup,4
Mexico,Guadeloupe,2,0,Gold Cup,2
Panama,Nicaragua,4,0,Gold Cup,4
Iraq,Palestine,4,0,Friendly,4
China PR,Palestine,3,1,Friendly,2
Guadeloupe,Costa Rica,1,5,Gold Cup,4
Mexico,Haiti,4,0,Gold Cup,4
United States,Honduras,2,0,Gold Cup,2
China PR,Kyrgyzstan,3,0,Friendly,3
United States,Mexico,0,5,Gold Cup,5
Albania,Cyprus,6,1,Friendly,5
Armenia,Moldova,1,4,Friendly,3
Austria,Cameroon,0,2,Friendly,2
Azerbaijan,Germany,0,2,FIFA World Cup qualification,2
Belarus,Croatia,1,3,FIFA World Cup qualification,2
Czech Republic,Belgium,3,1,Friendly,2
Ghana,Zambia,4,1,Friendly,3
Honduras,Costa Rica,4,0,FIFA World Cup qualification,4
Republic of Ireland,Australia,0,3,Friendly,3
Liechtenstein,Portugal,0,3,Friendly,3
Mali,Burkina Faso,3,0,Friendly,3
Malta,Georgia,2,0,Friendly,2
Norway,Scotland,4,0,FIFA World Cup qualification,4
Poland,Greece,2,0,Friendly,2
Slovenia,San Marino,5,0,FIFA World Cup qualification,5
South Africa,Serbia,1,3,Friendly,2
Togo,Angola,0,2,Friendly,2
Ukraine,Turkey,0,3,Friendly,3
Syria,Kyrgyzstan,2,0,Nehru Cup,2
North Korea,Guam,9,2,EAFF Championship,7
Syria,Sri Lanka,4,0,Nehru Cup,4
India,Sri Lanka,3,1,Nehru Cup,2
Hong Kong,Guam,12,0,EAFF Championship,12
Sri Lanka,Kyrgyzstan,1,4,Nehru Cup,3
Bahrain,Iran,4,2,Friendly,2
Malta,Cape Verde,0,2,Friendly,2
Argentina,Brazil,1,3,FIFA World Cup qualification,2
Armenia,Bosnia and Herzegovina,0,2,FIFA World Cup qualification,2
Austria,Faroe Islands,3,1,FIFA World Cup qualification,2
Bulgaria,Montenegro,4,1,FIFA World Cup qualification,3
Colombia,Ecuador,2,0,FIFA World Cup qualification,2
Costa Rica,Mexico,0,3,FIFA World Cup qualification,3
Gabon,Cameroon,0,2,FIFA World Cup qualification,2
Georgia,Italy,0,2,FIFA World Cup qualification,2
Germany,South Africa,2,0,Friendly,2
Honduras,Trinidad and Tobago,4,1,FIFA World Cup qualification,3
Ivory Coast,Burkina Faso,5,0,FIFA World Cup qualification,5
South Korea,Australia,3,1,Friendly,2
Netherlands,Japan,3,0,Friendly,3
Russia,Liechtenstein,3,0,FIFA World Cup qualification,3
Scotland,North Macedonia,2,0,FIFA World Cup qualification,2
Spain,Belgium,5,0,FIFA World Cup qualification,5
Saint Vincent and the Grenadines,Saint Kitts and Nevis,0,3,Friendly,3
Switzerland,Greece,2,0,FIFA World Cup qualification,2
Turkey,Estonia,4,2,FIFA World Cup qualification,2
Ukraine,Andorra,5,0,FIFA World Cup qualification,5
Ghana,Sudan,2,0,FIFA World Cup qualification,2
Andorra,Kazakhstan,1,3,FIFA World Cup qualification,2
Bolivia,Ecuador,1,3,FIFA World Cup qualification,2
Czech Republic,San Marino,7,0,FIFA World Cup qualification,7
England,Croatia,5,1,FIFA World Cup qualification,4
Germany,Azerbaijan,4,0,FIFA World Cup qualification,4
Iceland,Georgia,3,1,Friendly,2
Israel,Luxembourg,7,0,FIFA World Cup qualification,7
Italy,Bulgaria,2,0,FIFA World Cup qualification,2
Jordan,New Zealand,1,3,Friendly,2
Northern Ireland,Slovakia,0,2,FIFA World Cup qualification,2
Slovenia,Poland,3,0,FIFA World Cup qualification,3
Spain,Estonia,3,0,FIFA World Cup qualification,3
Wales,Russia,1,3,FIFA World Cup qualification,2
Uruguay,Colombia,3,1,FIFA World Cup qualification,2
Brazil,Chile,4,2,FIFA World Cup qualification,2
Venezuela,Peru,3,1,FIFA World Cup qualification,2
Malaysia,Lesotho,5,0,Friendly,5
Argentina,Ghana,2,0,Friendly,2
China PR,Botswana,4,1,Friendly,3
Egypt,Mauritius,4,0,Friendly,4
Japan,Hong Kong,6,0,AFC Asian Cup qualification,6
Belarus,Kazakhstan,4,0,FIFA World Cup qualification,4
Belgium,Turkey,2,0,FIFA World Cup qualification,2
Cameroon,Togo,3,0,FIFA World Cup qualification,3
Colombia,Chile,2,4,FIFA World Cup qualification,2
Costa Rica,Trinidad and Tobago,4,0,FIFA World Cup qualification,4
Cyprus,Bulgaria,4,1,FIFA World Cup qualification,3
Czech Republic,Poland,2,0,FIFA World Cup qualification,2
Estonia,Bosnia and Herzegovina,0,2,FIFA World Cup qualification,2
France,Faroe Islands,5,0,FIFA World Cup qualification,5
Gabon,Morocco,3,1,FIFA World Cup qualification,2
Greece,Latvia,5,2,FIFA World Cup qualification,3
Israel,Moldova,3,1,FIFA World Cup qualification,2
Japan,Scotland,2,0,Friendly,2
Liechtenstein,Azerbaijan,0,2,FIFA World Cup qualification,2
Luxembourg,Switzerland,0,3,FIFA World Cup qualification,3
Mexico,El Salvador,4,1,FIFA World Cup qualification,3
Portugal,Hungary,3,0,FIFA World Cup qualification,3
Serbia,Romania,5,0,FIFA World Cup qualification,5
Slovakia,Slovenia,0,2,FIFA World Cup qualification,2
Algeria,Rwanda,3,1,FIFA World Cup qualification,2
Andorra,Ukraine,0,6,FIFA World Cup qualification,6
Bosnia and Herzegovina,Spain,2,5,FIFA World Cup qualification,3
Bulgaria,Georgia,6,2,FIFA World Cup qualification,4
England,Belarus,3,0,FIFA World Cup qualification,3
Estonia,Belgium,2,0,FIFA World Cup qualification,2
France,Austria,3,1,FIFA World Cup qualification,2
Japan,Togo,5,0,Friendly,5
South Korea,Senegal,2,0,Friendly,2
Liechtenstein,Wales,0,2,FIFA World Cup qualification,2
Paraguay,Colombia,0,2,FIFA World Cup qualification,2
Portugal,Malta,4,0,FIFA World Cup qualification,4
Romania,Faroe Islands,3,1,FIFA World Cup qualification,2
San Marino,Slovenia,0,3,FIFA World Cup qualification,3
Sweden,Albania,4,1,FIFA World Cup qualification,3
Turkey,Armenia,2,0,FIFA World Cup qualification,2
United Arab Emirates,Jordan,3,1,Friendly,2
Zimbabwe,Mauritius,3,0,COSAFA Cup,3
Seychelles,Botswana,0,2,COSAFA Cup,2
Singapore,Turkmenistan,4,2,Friendly,2
Eswatini,Comoros,3,0,COSAFA Cup,3
South Africa,Angola,2,0,COSAFA Cup,2
Curaçao,French Guiana,1,4,Friendly,3
Mozambique,Zambia,0,2,COSAFA Cup,2
Suriname,French Guiana,4,0,Friendly,4
Zimbabwe,Zambia,3,1,COSAFA Cup,2
Kenya,Kuwait,0,5,Friendly,5
Singapore,Indonesia,3,1,Friendly,2
Egypt,Tanzania,5,1,Friendly,4
Bahrain,Togo,5,1,Friendly,4
Paraguay,Qatar,0,2,Friendly,2
Belgium,Hungary,3,0,Friendly,3
Croatia,Liechtenstein,5,0,Friendly,5
Egypt,Algeria,2,0,FIFA World Cup qualification,2
Ivory Coast,Guinea,3,0,FIFA World Cup qualification,3
Lebanon,China PR,0,2,AFC Asian Cup qualification,2
North Macedonia,Canada,3,0,Friendly,3
Morocco,Cameroon,0,2,FIFA World Cup qualification,2
Singapore,Thailand,1,3,AFC Asian Cup qualification,2
Uzbekistan,Malaysia,3,1,AFC Asian Cup qualification,2
Wales,Scotland,3,0,Friendly,3
Belgium,Qatar,2,0,Friendly,2
Oman,Brazil,0,2,Friendly,2
Austria,Spain,1,5,Friendly,4
Azerbaijan,Czech Republic,2,0,Friendly,2
Bahrain,Yemen,4,0,AFC Asian Cup qualification,4
Denmark,United States,3,1,Friendly,2
Hong Kong,Japan,0,4,AFC Asian Cup qualification,4
Malaysia,Uzbekistan,1,3,AFC Asian Cup qualification,2
Malta,Bulgaria,1,4,Friendly,3
Zambia,North Korea,4,1,Friendly,3
Kenya,Zambia,0,2,CECAFA Cup,2
Burundi,Zanzibar,0,4,CECAFA Cup,4
Uganda,Tanzania,2,0,CECAFA Cup,2
Ethiopia,Djibouti,5,0,CECAFA Cup,5
Burundi,Uganda,0,2,CECAFA Cup,2
Kenya,Djibouti,2,0,CECAFA Cup,2
Bangladesh,Bhutan,4,1,SAFF Cup,3
Djibouti,Zambia,0,6,CECAFA Cup,6
Dominica,British Virgin Islands,4,0,Friendly,4
Kenya,Ethiopia,2,0,CECAFA Cup,2
Somalia,Eritrea,1,3,CECAFA Cup,2
Sri Lanka,Bhutan,6,0,SAFF Cup,6
Maldives,Afghanistan,3,1,SAFF Cup,2
Pakistan,Bhutan,7,0,SAFF Cup,7
Tanzania,Eritrea,4,0,CECAFA Cup,4
Afghanistan,Nepal,0,3,SAFF Cup,3
Maldives,Sri Lanka,5,1,SAFF Cup,4
Uganda,Rwanda,2,0,CECAFA Cup,2
Catalonia,Argentina,4,2,Friendly,2
Thailand,Zimbabwe,3,0,Friendly,3
Malaysia,Syria,4,1,Friendly,3
Singapore,Oman,1,4,Friendly,3
Syria,Zimbabwe,6,0,Friendly,6
Bahrain,Hong Kong,4,0,AFC Asian Cup qualification,4
Gabon,Mozambique,2,0,Friendly,2
Singapore,Iran,1,3,AFC Asian Cup qualification,2
Rwanda,Ivory Coast,0,2,Friendly,2
Kenya,Cameroon,1,3,Friendly,2
Zambia,South Korea,4,2,Friendly,2
Malawi,Algeria,3,0,African Cup of Nations,3
Egypt,Nigeria,3,1,African Cup of Nations,2
Angola,Malawi,2,0,African Cup of Nations,2
Ivory Coast,Ghana,3,1,African Cup of Nations,2
Yemen,Kenya,3,1,Friendly,2
Egypt,Mozambique,2,0,African Cup of Nations,2
Finland,South Korea,0,2,Friendly,2
Mali,Malawi,3,1,African Cup of Nations,2
Egypt,Benin,2,0,African Cup of Nations,2
Nigeria,Mozambique,3,0,African Cup of Nations,3
Thailand,Poland,1,3,King's Cup,2
Yemen,Bahrain,3,0,AFC Asian Cup qualification,3
Poland,Singapore,6,1,King's Cup,5
United States,Honduras,1,3,Friendly,2
Egypt,Cameroon,3,1,African Cup of Nations,2
South Africa,Zimbabwe,3,0,Friendly,3
Algeria,Egypt,0,4,African Cup of Nations,4
South Korea,Hong Kong,5,0,EAFF Championship,5
China PR,South Korea,3,0,EAFF Championship,3
Japan,Hong Kong,3,0,EAFF Championship,3
Hong Kong,China PR,0,2,EAFF Championship,2
Japan,South Korea,1,3,EAFF Championship,2
Sri Lanka,Myanmar,0,4,AFC Challenge Cup,4
Sri Lanka,Tajikistan,1,3,AFC Challenge Cup,2
Kyrgyzstan,North Korea,0,4,AFC Challenge Cup,4
Sri Lanka,Bangladesh,3,0,AFC Challenge Cup,3
Tajikistan,Myanmar,3,0,AFC Challenge Cup,3
North Korea,Myanmar,5,0,AFC Challenge Cup,5
Mexico,Bolivia,5,0,Friendly,5
Tajikistan,Turkmenistan,0,2,AFC Challenge Cup,2
Jordan,Azerbaijan,0,2,Friendly,2
Kuwait,Bahrain,4,1,Friendly,3
Republic of Ireland,Brazil,0,2,Friendly,2
Algeria,Serbia,0,3,Friendly,3
Armenia,Belarus,1,3,Friendly,2
England,Egypt,3,1,Friendly,2
France,Spain,0,2,Friendly,2
Greece,Senegal,0,2,Friendly,2
Ivory Coast,South Korea,0,2,Friendly,2
Japan,Bahrain,2,0,AFC Asian Cup qualification,2
Mexico,New Zealand,2,0,Friendly,2
Nigeria,DR Congo,5,2,Friendly,3
Poland,Bulgaria,2,0,Friendly,2
Portugal,China PR,2,0,Friendly,2
Romania,Israel,0,2,Friendly,2
Slovenia,Qatar,4,1,Friendly,3
Switzerland,Uruguay,1,3,Friendly,2
Syria,Lebanon,4,0,AFC Asian Cup qualification,4
Turkey,Honduras,2,0,Friendly,2
Niger,Benin,2,0,Friendly,2
Iceland,Faroe Islands,2,0,Friendly,2
Saint Kitts and Nevis,Guadeloupe,3,0,Friendly,3
Japan,Serbia,0,3,Friendly,3
South Africa,Jamaica,2,0,Friendly,2
Argentina,Haiti,4,0,Friendly,4
Chile,Trinidad and Tobago,2,0,Friendly,2
Germany,Malta,3,0,Friendly,3
South Korea,Ecuador,2,0,Friendly,2
South Africa,Thailand,4,0,Friendly,4
Gabon,Togo,3,0,Friendly,3
Corsica,Brittany,2,0,Friendly,2
Aruba,Venezuela,0,3,Friendly,3
DR Congo,Saudi Arabia,0,2,Friendly,2
Estonia,Finland,2,0,Friendly,2
Croatia,Wales,2,0,Friendly,2
Argentina,Canada,5,0,Friendly,5
England,Mexico,3,1,Friendly,2
Japan,South Korea,0,2,Friendly,2
Armenia,Uzbekistan,3,1,Friendly,2
Ukraine,Lithuania,4,0,Friendly,4
United States,Czech Republic,2,4,Friendly,2
Chile,Zambia,3,0,Friendly,3
Northern Ireland,Turkey,0,2,Friendly,2
Uruguay,Israel,4,1,Friendly,3
Denmark,Senegal,2,0,Friendly,2
Republic of Ireland,Algeria,3,0,Friendly,3
Azerbaijan,North Macedonia,1,3,Friendly,2
Hungary,Germany,0,3,Friendly,3
Iceland,Andorra,4,0,Friendly,4
Sweden,Bosnia and Herzegovina,4,2,Friendly,2
Chile,Israel,3,0,Friendly,3
Mexico,Gambia,5,1,Friendly,4
South Africa,Guatemala,5,0,Friendly,5
Iraqi Kurdistan,Two Sicilies,4,1,Viva World Cup,3
Netherlands,Ghana,4,1,Friendly,3
Portugal,Cameroon,3,1,Friendly,2
Greece,Paraguay,0,2,Friendly,2
Zimbabwe,Brazil,0,3,Friendly,3
Gozo,Occitania,0,5,Viva World Cup,5
Germany,Bosnia and Herzegovina,3,1,Friendly,2
Japan,Ivory Coast,0,2,Friendly,2
Slovenia,New Zealand,3,1,Friendly,2
Padania,Two Sicilies,2,0,Viva World Cup,2
Australia,United States,1,3,Friendly,2
Netherlands,Hungary,6,1,Friendly,5
Romania,Honduras,3,0,Friendly,3
Slovakia,Costa Rica,3,0,Friendly,3
Occitania,Two Sicilies,2,0,Viva World Cup,2
Nigeria,North Korea,3,1,Friendly,2
Tanzania,Brazil,1,5,Friendly,4
Mozambique,Portugal,0,3,Friendly,3
Spain,Poland,6,0,Friendly,6
South Korea,Greece,2,0,FIFA World Cup,2
Germany,Australia,4,0,FIFA World Cup,4
Netherlands,Denmark,2,0,FIFA World Cup,2
South Africa,Uruguay,0,3,FIFA World Cup,3
Argentina,South Korea,4,1,FIFA World Cup,3
France,Mexico,0,2,FIFA World Cup,2
Brazil,Ivory Coast,3,1,FIFA World Cup,2
Lithuania,Estonia,2,0,Baltic Cup,2
Slovakia,Paraguay,0,2,FIFA World Cup,2
Sudan,Tunisia,2,6,Friendly,4
Portugal,North Korea,7,0,FIFA World Cup,7
Spain,Honduras,2,0,FIFA World Cup,2
Greece,Argentina,0,2,FIFA World Cup,2
Denmark,Japan,1,3,FIFA World Cup,2
North Korea,Ivory Coast,0,3,FIFA World Cup,3
China PR,Tajikistan,4,0,Friendly,4
Argentina,Mexico,3,1,FIFA World Cup,2
Germany,England,4,1,FIFA World Cup,3
Brazil,Chile,3,0,FIFA World Cup,3
Argentina,Germany,0,4,FIFA World Cup,4
Botswana,Zimbabwe,2,0,Friendly,2
Anguilla,Saint Martin,1,3,Friendly,2
United States,Brazil,0,2,Friendly,2
Angola,Uruguay,0,2,Friendly,2
Armenia,Iran,1,3,Friendly,2
Burkina Faso,Congo,3,0,Friendly,3
Chad,Tunisia,1,3,African Cup of Nations qualification,2
Czech Republic,Latvia,4,1,Friendly,3
Egypt,DR Congo,6,3,Friendly,3
Kazakhstan,Oman,3,1,Friendly,2
Lithuania,Belarus,0,2,Friendly,2
Mali,Guinea,0,2,Friendly,2
Montenegro,Northern Ireland,2,0,Friendly,2
Panama,Venezuela,3,1,Friendly,2
Paraguay,Costa Rica,2,0,Friendly,2
Poland,Cameroon,0,3,Friendly,3
Slovenia,Australia,2,0,Friendly,2
Sweden,Scotland,3,0,Friendly,3
Trinidad and Tobago,Jamaica,1,3,Friendly,2
Turkey,Romania,2,0,Friendly,2
Wales,Luxembourg,5,1,Friendly,4
Ethiopia,Kenya,0,3,Friendly,3
Saint Lucia,Martinique,1,3,Friendly,2
Israel,Malta,3,1,UEFA Euro qualification,2
Andorra,Russia,0,2,UEFA Euro qualification,2
China PR,Iran,0,2,Friendly,2
England,Bulgaria,4,0,UEFA Euro qualification,4
Faroe Islands,Serbia,0,3,UEFA Euro qualification,3
Kazakhstan,Turkey,0,3,UEFA Euro qualification,3
Kuwait,Syria,3,0,Friendly,3
Latvia,Croatia,0,3,UEFA Euro qualification,3
Liechtenstein,Spain,0,4,UEFA Euro qualification,4
Luxembourg,Bosnia and Herzegovina,0,3,UEFA Euro qualification,3
Moldova,Finland,2,0,UEFA Euro qualification,2
Oman,Malaysia,3,0,Friendly,3
San Marino,Netherlands,0,5,UEFA Euro qualification,5
Sweden,Hungary,2,0,UEFA Euro qualification,2
Venezuela,Colombia,0,2,Friendly,2
Canada,Peru,0,2,Friendly,2
Guatemala,Nicaragua,5,0,Friendly,5
Ivory Coast,Rwanda,3,0,African Cup of Nations qualification,3
Mauritius,Cameroon,1,3,African Cup of Nations qualification,2
South Africa,Niger,2,0,African Cup of Nations qualification,2
Sudan,Congo,2,0,African Cup of Nations qualification,2
Uganda,Angola,3,0,African Cup of Nations qualification,3
DR Congo,Senegal,2,4,African Cup of Nations qualification,2
Ethiopia,Guinea,1,4,African Cup of Nations qualification,3
Nigeria,Madagascar,2,0,African Cup of Nations qualification,2
Eswatini,Ghana,0,3,African Cup of Nations qualification,3
Argentina,Spain,4,1,Friendly,3
Austria,Kazakhstan,2,0,UEFA Euro qualification,2
Bahrain,Togo,3,0,Friendly,3
Bosnia and Herzegovina,France,0,2,UEFA Euro qualification,2
El Salvador,Guatemala,0,2,Friendly,2
Germany,Azerbaijan,6,1,UEFA Euro qualification,5
Republic of Ireland,Andorra,3,1,UEFA Euro qualification,2
Italy,Faroe Islands,5,0,UEFA Euro qualification,5
Malta,Latvia,0,2,UEFA Euro qualification,2
Panama,Trinidad and Tobago,3,0,Friendly,3
Sweden,San Marino,6,0,UEFA Euro qualification,6
Switzerland,England,1,3,UEFA Euro qualification,2
United Arab Emirates,Kuwait,3,0,Friendly,3
Saint Lucia,Saint Vincent and the Grenadines,1,5,Friendly,4
India,Namibia,2,0,Friendly,2
Jordan,Iraq,4,1,Friendly,3
Jordan,Bahrain,2,0,Friendly,2
Saint Martin,British Virgin Islands,3,1,Friendly,2
Saint Lucia,Trinidad and Tobago,0,3,Friendly,3
Réunion,Saint Pierre and Miquelon,11,0,African Nations Championship,11
Antigua and Barbuda,Saint Lucia,5,0,Friendly,5
Martinique,Tahiti,4,1,African Nations Championship,3
Iran,Bahrain,3,0,WAFF Championship,3
French Guiana,Saint Pierre and Miquelon,7,0,African Nations Championship,7
Bahrain,Oman,2,0,WAFF Championship,2
Barbados,Dominica,1,3,Friendly,2
New Caledonia,Martinique,0,4,African Nations Championship,4
Yemen,Palestine,3,1,WAFF Championship,2
Mayotte,Saint Pierre and Miquelon,10,0,African Nations Championship,10
Guadeloupe,Martinique,2,0,African Nations Championship,2
Palestine,Iraq,0,3,WAFF Championship,3
Mayotte,Guadeloupe,0,4,African Nations Championship,4
Puerto Rico,Anguilla,3,1,CFU Caribbean Cup qualification,2
Cayman Islands,Anguilla,4,1,CFU Caribbean Cup qualification,3
Puerto Rico,Saint Martin,2,0,CFU Caribbean Cup qualification,2
Puerto Rico,Cayman Islands,2,0,CFU Caribbean Cup qualification,2
Iran,Brazil,0,3,Friendly,3
Andorra,North Macedonia,0,2,UEFA Euro qualification,2
Armenia,Slovakia,3,1,UEFA Euro qualification,2
Austria,Azerbaijan,3,0,UEFA Euro qualification,3
Germany,Turkey,3,0,UEFA Euro qualification,3
Hungary,San Marino,8,0,UEFA Euro qualification,8
India,Vietnam,3,1,Friendly,2
Indonesia,Uruguay,1,7,Friendly,6
Kazakhstan,Belgium,0,2,UEFA Euro qualification,2
Kuwait,Bahrain,1,3,Friendly,2
Montserrat,Barbados,0,5,CFU Caribbean Cup qualification,5
Peru,Costa Rica,2,0,Friendly,2
Portugal,Denmark,3,1,UEFA Euro qualification,2
Serbia,Estonia,1,3,UEFA Euro qualification,2
Slovenia,Faroe Islands,5,1,UEFA Euro qualification,4
Spain,Lithuania,3,1,UEFA Euro qualification,2
Burkina Faso,Gambia,3,1,African Cup of Nations qualification,2
France,Romania,2,0,UEFA Euro qualification,2
Guatemala,Belize,4,2,Friendly,2
Malawi,Chad,6,2,African Cup of Nations qualification,4
Rwanda,Benin,0,3,African Cup of Nations qualification,3
Saudi Arabia,Uzbekistan,4,0,Friendly,4
Senegal,Mauritius,7,0,African Cup of Nations qualification,7
United Arab Emirates,Chile,0,2,Friendly,2
Central African Republic,Algeria,2,0,African Cup of Nations qualification,2
Congo,Eswatini,3,1,African Cup of Nations qualification,2
Saint Kitts and Nevis,Montserrat,4,0,CFU Caribbean Cup qualification,4
Brazil,Ukraine,2,0,Friendly,2
Armenia,Andorra,4,0,UEFA Euro qualification,4
Bahrain,Uzbekistan,2,4,Friendly,2
Belarus,Albania,2,0,UEFA Euro qualification,2
Bulgaria,Saudi Arabia,2,0,Friendly,2
China PR,Uruguay,0,4,Friendly,4
Denmark,Cyprus,2,0,UEFA Euro qualification,2
France,Luxembourg,2,0,UEFA Euro qualification,2
Guatemala,Honduras,0,2,Friendly,2
Iceland,Portugal,1,3,UEFA Euro qualification,2
Indonesia,Maldives,3,0,Friendly,3
Italy,Serbia,3,0,UEFA Euro qualification,3
Kazakhstan,Germany,0,3,UEFA Euro qualification,3
Kuwait,Vietnam,3,1,Friendly,2
Liechtenstein,Czech Republic,0,2,UEFA Euro qualification,2
Netherlands,Sweden,4,1,UEFA Euro qualification,3
New Zealand,Paraguay,0,2,Friendly,2
Philippines,Macau,5,0,Dragon Cup,5
San Marino,Moldova,0,2,UEFA Euro qualification,2
Switzerland,Wales,4,1,UEFA Euro qualification,3
United Arab Emirates,Angola,0,2,Friendly,2
India,Yemen,3,6,Friendly,3
Dominican Republic,British Virgin Islands,17,0,CFU Caribbean Cup qualification,17
British Virgin Islands,Dominica,0,10,CFU Caribbean Cup qualification,10
Suriname,Guyana,0,2,CFU Caribbean Cup qualification,2
Timor-Leste,Philippines,0,5,AFF Championship,5
Grenada,Puerto Rico,3,1,CFU Caribbean Cup qualification,2
Cambodia,Timor-Leste,4,2,AFF Championship,2
Grenada,Saint Kitts and Nevis,2,0,CFU Caribbean Cup qualification,2
Grenada,Guadeloupe,0,3,CFU Caribbean Cup qualification,3
Laos,Timor-Leste,6,1,AFF Championship,5
Panama,Cuba,0,3,Friendly,3
Botswana,Eswatini,2,0,Friendly,2
Curaçao,Aruba,3,0,ABCS Tournament,3
Suriname,Bonaire,4,2,ABCS Tournament,2
Trinidad and Tobago,Haiti,4,0,CFU Caribbean Cup qualification,4
Vietnam,North Korea,0,2,VFF Cup,2
Cuba,Dominica,4,2,CFU Caribbean Cup qualification,2
Iraq,India,2,0,Friendly,2
Bahrain,Syria,0,2,Friendly,2
Dominica,Suriname,0,5,CFU Caribbean Cup qualification,5
India,Kuwait,1,9,Friendly,8
Scotland,Faroe Islands,3,0,Friendly,3
Chile,Uruguay,2,0,Friendly,2
Croatia,Malta,3,0,UEFA Euro qualification,3
Ecuador,Venezuela,4,1,Friendly,3
Egypt,Australia,3,0,Friendly,3
Finland,San Marino,8,0,UEFA Euro qualification,8
Guatemala,Guyana,3,0,Friendly,3
Hong Kong,Paraguay,0,7,Friendly,7
Hungary,Lithuania,2,0,Friendly,2
Mali,DR Congo,3,1,Friendly,2
Montenegro,Azerbaijan,2,0,Friendly,2
Mozambique,Zimbabwe,1,3,Friendly,2
Oman,Belarus,0,4,Friendly,4
Panama,Honduras,2,0,Friendly,2
Poland,Ivory Coast,3,1,Friendly,2
Portugal,Spain,4,0,Friendly,4
Russia,Belgium,0,2,Friendly,2
United Arab Emirates,India,5,0,Friendly,5
Indonesia,Timor-Leste,6,0,Friendly,6
Yemen,Saudi Arabia,0,4,Gulf Cup,4
Indonesia,Taiwan,2,0,Friendly,2
Singapore,Laos,4,0,Friendly,4
Trinidad and Tobago,Cuba,0,2,CFU Caribbean Cup,2
Jamaica,Antigua and Barbuda,3,1,CFU Caribbean Cup,2
Burundi,Somalia,2,0,CECAFA Cup,2
Yemen,Kuwait,0,3,Gulf Cup,3
Zanzibar,Sudan,2,0,CECAFA Cup,2
Guadeloupe,Jamaica,0,2,CFU Caribbean Cup,2
United Arab Emirates,Bahrain,3,1,Gulf Cup,2
Tanzania,Somalia,3,0,CECAFA Cup,3
Guyana,Jamaica,0,4,CFU Caribbean Cup,4
Indonesia,Malaysia,5,1,AFF Championship,4
Vietnam,Myanmar,7,1,AFF Championship,6
Zambia,Somalia,6,0,CECAFA Cup,6
Indonesia,Laos,6,0,AFF Championship,6
Uganda,Kenya,2,0,CECAFA Cup,2
Vietnam,Philippines,0,2,AFF Championship,2
Malaysia,Laos,5,1,AFF Championship,4
Malaysia,Vietnam,2,0,AFF Championship,2
China PR,Estonia,3,0,Friendly,3
Qatar,Estonia,2,0,Friendly,2
Malaysia,Indonesia,3,0,AFF Championship,3
Catalonia,Honduras,4,0,Friendly,4
Basque Country,Venezuela,3,1,Friendly,2
Kuwait,Zambia,4,0,Friendly,4
United Arab Emirates,Syria,2,0,Friendly,2
Egypt,Tanzania,5,1,Nile Basin Tournament,4
Uganda,Burundi,3,1,Nile Basin Tournament,2
Qatar,Uzbekistan,0,2,AFC Asian Cup,2
Kuwait,China PR,0,2,AFC Asian Cup,2
India,Australia,0,4,AFC Asian Cup,4
Egypt,Burundi,3,0,Nile Basin Tournament,3
Qatar,China PR,2,0,AFC Asian Cup,2
Bahrain,India,5,2,AFC Asian Cup,3
Egypt,Kenya,5,1,Nile Basin Tournament,4
El Salvador,Nicaragua,2,0,UNCAF Cup,2
Panama,Belize,2,0,UNCAF Cup,2
Belize,El Salvador,2,5,UNCAF Cup,3
Guatemala,Costa Rica,0,2,UNCAF Cup,2
Panama,Nicaragua,2,0,UNCAF Cup,2
Qatar,Kuwait,3,0,AFC Asian Cup,3
Tanzania,Sudan,0,2,Nile Basin Tournament,2
Egypt,Uganda,3,1,Nile Basin Tournament,2
Saudi Arabia,Japan,0,5,AFC Asian Cup,5
Honduras,Guatemala,3,1,UNCAF Cup,2
South Korea,India,4,1,AFC Asian Cup,3
Panama,El Salvador,2,0,UNCAF Cup,2
United Arab Emirates,Iran,0,3,AFC Asian Cup,3
Honduras,El Salvador,2,0,UNCAF Cup,2
Uzbekistan,Australia,0,6,AFC Asian Cup,6
Cyprus,Sweden,0,2,Cyprus International Tournament,2
Ghana,Togo,4,1,Friendly,3
Republic of Ireland,Wales,3,0,Nations Cup,3
Azerbaijan,Hungary,0,2,Friendly,2
Cambodia,Macau,3,1,AFC Challenge Cup qualification,2
DR Congo,Gabon,0,2,Friendly,2
Croatia,Czech Republic,4,2,Friendly,2
Guinea-Bissau,Gambia,3,1,Friendly,2
Israel,Serbia,0,2,Friendly,2
Malaysia,Hong Kong,2,0,Friendly,2
Mexico,Bosnia and Herzegovina,2,0,Friendly,2
Morocco,Niger,3,0,Friendly,3
Netherlands,Austria,3,1,Friendly,2
Philippines,Mongolia,2,0,AFC Challenge Cup qualification,2
Scotland,Northern Ireland,3,0,Nations Cup,3
Senegal,Guinea,4,0,Friendly,4
South Africa,Kenya,2,0,Friendly,2
Eswatini,Zambia,0,4,Friendly,4
Gibraltar,Faroe Islands,3,0,Friendly,3
Argentina,Venezuela,4,1,Friendly,3
India,Taiwan,3,0,AFC Challenge Cup qualification,3
Maldives,Cambodia,4,0,AFC Challenge Cup qualification,4
Palestine,Bangladesh,2,0,AFC Challenge Cup qualification,2
Turkmenistan,Pakistan,3,0,AFC Challenge Cup qualification,3
Bhutan,Afghanistan,0,3,AFC Challenge Cup qualification,3
Myanmar,Bangladesh,0,2,AFC Challenge Cup qualification,2
Cambodia,Tajikistan,0,3,AFC Challenge Cup qualification,3
Pakistan,India,1,3,AFC Challenge Cup qualification,2
Afghanistan,Bhutan,2,0,AFC Challenge Cup qualification,2
Austria,Belgium,0,2,UEFA Euro qualification,2
Bangladesh,Philippines,0,3,AFC Challenge Cup qualification,3
Myanmar,Palestine,1,3,AFC Challenge Cup qualification,2
Estonia,Uruguay,2,0,Friendly,2
Hungary,Netherlands,0,4,UEFA Euro qualification,4
Jamaica,Venezuela,0,2,Friendly,2
South Korea,Honduras,4,0,Friendly,4
Lithuania,Poland,2,0,Friendly,2
Luxembourg,France,0,2,UEFA Euro qualification,2
Panama,Bolivia,2,0,Friendly,2
Burkina Faso,Namibia,4,0,African Cup of Nations qualification,4
Colombia,Ecuador,2,0,Friendly,2
Germany,Kazakhstan,4,0,UEFA Euro qualification,4
North Korea,Iraq,2,0,Friendly,2
Mexico,Paraguay,3,1,Friendly,2
Rwanda,Burundi,3,1,African Cup of Nations qualification,2
Wales,England,0,2,UEFA Euro qualification,2
Brazil,Scotland,2,0,Friendly,2
Congo,Ghana,0,3,African Cup of Nations qualification,3
DR Congo,Mauritius,3,0,African Cup of Nations qualification,3
Mozambique,Zambia,0,2,African Cup of Nations qualification,2
Niger,Sierra Leone,3,1,African Cup of Nations qualification,2
Nigeria,Ethiopia,4,0,African Cup of Nations qualification,4
Sudan,Eswatini,3,0,African Cup of Nations qualification,3
Belgium,Azerbaijan,4,1,UEFA Euro qualification,3
China PR,Honduras,3,0,Friendly,3
Colombia,Chile,0,2,Friendly,2
Cuba,Panama,0,2,Friendly,2
Czech Republic,Liechtenstein,2,0,UEFA Euro qualification,2
Lithuania,Spain,1,3,UEFA Euro qualification,2
Netherlands,Hungary,5,3,UEFA Euro qualification,2
Nigeria,Kenya,3,0,Friendly,3
Portugal,Finland,2,0,Friendly,2
Romania,Luxembourg,3,1,UEFA Euro qualification,2
Sri Lanka,Tajikistan,0,2,Friendly,2
Turkey,Austria,2,0,UEFA Euro qualification,2
Ukraine,Italy,0,2,Friendly,2
Tahiti,New Caledonia,1,3,Friendly,2
North Korea,Sri Lanka,4,0,AFC Challenge Cup qualification,4
North Korea,Afghanistan,2,0,AFC Challenge Cup qualification,2
Mozambique,Tanzania,2,0,Friendly,2
New Caledonia,Réunion,2,4,Friendly,2
New Caledonia,Réunion,1,3,Friendly,2
Republic of Ireland,Northern Ireland,5,0,Nations Cup,5
Argentina,Paraguay,4,2,Friendly,2
Wales,Scotland,1,3,Nations Cup,2
Wales,Northern Ireland,2,0,Nations Cup,2
Panama,Grenada,2,0,Friendly,2
Tunisia,Central African Republic,3,0,Friendly,3
Guatemala,Venezuela,0,2,Friendly,2
Mexico,New Zealand,3,0,Friendly,3
Nigeria,Argentina,4,1,Friendly,3
Ukraine,Uzbekistan,2,0,Friendly,2
Faroe Islands,Slovenia,0,2,UEFA Euro qualification,2
Italy,Estonia,3,0,UEFA Euro qualification,3
Liechtenstein,Lithuania,2,0,UEFA Euro qualification,2
Moldova,Sweden,1,4,UEFA Euro qualification,3
Romania,Bosnia and Herzegovina,3,0,UEFA Euro qualification,3
Bolivia,Paraguay,0,2,Copa Paz del Chaco,2
Greece,Malta,3,1,UEFA Euro qualification,2
Iceland,Denmark,0,2,UEFA Euro qualification,2
North Macedonia,Republic of Ireland,0,2,UEFA Euro qualification,2
Morocco,Algeria,4,0,African Cup of Nations qualification,4
Russia,Armenia,3,1,UEFA Euro qualification,2
Uganda,Guinea-Bissau,2,0,African Cup of Nations qualification,2
United States,Spain,0,4,Friendly,4
Zambia,Mozambique,3,0,African Cup of Nations qualification,3
Australia,New Zealand,3,0,Friendly,3
Benin,Ivory Coast,2,6,African Cup of Nations qualification,4
Burundi,Rwanda,3,1,African Cup of Nations qualification,2
Costa Rica,Cuba,5,0,Gold Cup,5
Guinea,Madagascar,4,1,African Cup of Nations qualification,3
Mexico,El Salvador,5,0,Gold Cup,5
Tunisia,Chad,5,0,African Cup of Nations qualification,5
Jamaica,Grenada,4,0,Gold Cup,4
Ukraine,France,1,4,Friendly,3
Austria,Latvia,3,1,Friendly,2
Azerbaijan,Germany,1,3,UEFA Euro qualification,2
Belarus,Luxembourg,2,0,UEFA Euro qualification,2
Bosnia and Herzegovina,Albania,2,0,UEFA Euro qualification,2
Faroe Islands,Estonia,2,0,UEFA Euro qualification,2
Italy,Republic of Ireland,0,2,Friendly,2
San Marino,Hungary,0,3,UEFA Euro qualification,3
Sweden,Finland,5,0,UEFA Euro qualification,5
United States,Canada,2,0,Gold Cup,2
Venezuela,Spain,0,3,Friendly,3
China PR,North Korea,2,0,Friendly,2
Cuba,Mexico,0,5,Gold Cup,5
Grenada,Honduras,1,7,Gold Cup,6
Jamaica,Guatemala,2,0,Gold Cup,2
Mexico,Venezuela,0,3,Friendly,3
Paraguay,Romania,2,0,Friendly,2
El Salvador,Cuba,6,1,Gold Cup,5
Mexico,Costa Rica,4,1,Gold Cup,3
Palestine,Vatican City,9,1,Friendly,8
Guatemala,Grenada,4,0,Gold Cup,4
Montserrat,Belize,2,5,FIFA World Cup qualification,3
Malaysia,Myanmar,2,0,Friendly,2
Chile,Estonia,4,0,Friendly,4
United States,Jamaica,2,0,Gold Cup,2
Argentina,Albania,4,0,Friendly,4
Honduras,Mexico,0,2,Gold Cup,2
Uruguay,Estonia,3,0,Friendly,3
Colombia,Senegal,2,0,Friendly,2
United States,Mexico,2,4,Gold Cup,2
Jersey,Menorca,2,0,Island Games,2
Alderney,Gibraltar,1,6,Island Games,5
Isle of Wight,Ynys Môn,4,0,Island Games,4
Gotland,Isle of Man,2,4,Island Games,2
Guernsey,Falkland Islands,5,0,Island Games,5
Jersey,Rhodes,2,0,Island Games,2
Isle of Wight,Alderney,4,0,Island Games,4
Gibraltar,Ynys Môn,6,3,Island Games,3
Isle of Man,Falkland Islands,6,0,Island Games,6
Gotland,Guernsey,2,5,Island Games,3
Western Isles,Åland Islands,0,2,Island Games,2
Alderney,Ynys Môn,0,5,Island Games,5
Falkland Islands,Gotland,1,6,Island Games,5
Saare County,Western Isles,2,0,Island Games,2
Afghanistan,Palestine,0,2,FIFA World Cup qualification,2
Bangladesh,Pakistan,3,0,FIFA World Cup qualification,3
Cambodia,Laos,4,2,FIFA World Cup qualification,2
Vietnam,Macau,6,0,FIFA World Cup qualification,6
Alderney,Falkland Islands,0,3,Island Games,3
Saare County,Gibraltar,0,4,Island Games,4
Jersey,Åland Islands,5,1,Island Games,4
Isle of Wight,Guernsey,4,2,Island Games,2
Lebanon,Kuwait,0,6,Friendly,6
Nepal,Timor-Leste,5,0,FIFA World Cup qualification,5
Turks and Caicos Islands,Bahamas,0,4,FIFA World Cup qualification,4
Myanmar,Mongolia,2,0,FIFA World Cup qualification,2
Laos,Cambodia,6,2,FIFA World Cup qualification,4
Macau,Vietnam,1,7,FIFA World Cup qualification,6
Philippines,Sri Lanka,4,0,FIFA World Cup qualification,4
United States Virgin Islands,British Virgin Islands,2,0,FIFA World Cup qualification,2
Jordan,Syria,1,3,Friendly,2
Bolivia,Costa Rica,0,2,Copa América,2
Aruba,Saint Lucia,4,2,FIFA World Cup qualification,2
Dominican Republic,Anguilla,2,0,FIFA World Cup qualification,2
Jordan,Yemen,4,0,Friendly,4
Bahamas,Turks and Caicos Islands,6,0,FIFA World Cup qualification,6
Colombia,Bolivia,2,0,Copa América,2
Dominican Republic,Anguilla,4,0,FIFA World Cup qualification,4
Argentina,Costa Rica,3,0,Copa América,3
Saint Lucia,Aruba,4,2,FIFA World Cup qualification,2
Brazil,Ecuador,4,2,Copa América,2
Iraq,Kuwait,0,2,Friendly,2
Colombia,Peru,0,2,Copa América,2
Belize,Montserrat,3,1,FIFA World Cup qualification,2
United Arab Emirates,Lebanon,6,2,Friendly,4
Peru,Uruguay,0,2,Copa América,2
China PR,Laos,7,2,FIFA World Cup qualification,5
Iran,Maldives,4,0,FIFA World Cup qualification,4
Iraq,Yemen,2,0,FIFA World Cup qualification,2
Jordan,Nepal,9,0,FIFA World Cup qualification,9
Kuwait,Philippines,3,0,FIFA World Cup qualification,3
Lebanon,Bangladesh,4,0,FIFA World Cup qualification,4
Oman,Myanmar,2,0,FIFA World Cup qualification,2
Peru,Venezuela,4,1,Copa América,3
Qatar,Vietnam,3,0,FIFA World Cup qualification,3
Saudi Arabia,Hong Kong,3,0,FIFA World Cup qualification,3
Singapore,Malaysia,5,3,FIFA World Cup qualification,2
Syria,Tajikistan,0,3,FIFA World Cup qualification,3
United Arab Emirates,India,3,0,FIFA World Cup qualification,3
Uzbekistan,Kyrgyzstan,4,0,FIFA World Cup qualification,4
Uruguay,Paraguay,3,0,Copa América,3
Bangladesh,Lebanon,2,0,FIFA World Cup qualification,2
Myanmar,Oman,0,2,FIFA World Cup qualification,2
Hong Kong,Saudi Arabia,0,5,FIFA World Cup qualification,5
Kyrgyzstan,Uzbekistan,0,3,FIFA World Cup qualification,3
Laos,China PR,1,6,FIFA World Cup qualification,5
Tajikistan,Syria,3,0,FIFA World Cup qualification,3
Vanuatu,Solomon Islands,2,0,Friendly,2
Eswatini,Botswana,0,2,Friendly,2
Bolivia,Panama,1,3,Friendly,2
Costa Rica,Ecuador,0,2,Friendly,2
Equatorial Guinea,Guinea-Bissau,1,4,Friendly,3
Gambia,DR Congo,3,0,Friendly,3
Honduras,Venezuela,2,0,Friendly,2
Hungary,Iceland,4,0,Friendly,4
Japan,South Korea,3,0,Friendly,3
Latvia,Finland,0,2,Friendly,2
Lithuania,Armenia,3,0,Friendly,3
Northern Ireland,Faroe Islands,4,0,UEFA Euro qualification,4
Norway,Czech Republic,3,0,Friendly,3
Portugal,Luxembourg,5,0,Friendly,5
Senegal,Morocco,0,2,Friendly,2
South Africa,Burkina Faso,3,0,Friendly,3
Tunisia,Mali,4,2,Friendly,2
Turkey,Estonia,3,0,Friendly,3
Zimbabwe,Zambia,2,0,Friendly,2
Fiji,Samoa,3,0,Friendly,3
Fiji,Samoa,5,1,Friendly,4
Eritrea,Sudan,0,3,Friendly,3
Barbados,Saint Lucia,4,0,Friendly,4
Trinidad and Tobago,India,3,0,Friendly,3
Indonesia,Palestine,4,1,Friendly,3
Tuvalu,Samoa,3,0,Friendly,3
United Arab Emirates,Qatar,3,1,Friendly,2
Fiji,Tahiti,3,0,Pacific Games,3
New Caledonia,Vanuatu,5,0,Pacific Games,5
Papua New Guinea,Cook Islands,4,0,Pacific Games,4
Solomon Islands,Guam,7,0,Pacific Games,7
Tuvalu,American Samoa,4,0,Pacific Games,4
American Samoa,Solomon Islands,0,4,Pacific Games,4
Fiji,Kiribati,9,0,Pacific Games,9
New Caledonia,Guam,9,0,Pacific Games,9
Tahiti,Cook Islands,7,0,Pacific Games,7
Vanuatu,Tuvalu,5,1,Pacific Games,4
American Samoa,Guam,0,2,Pacific Games,2
Cook Islands,Kiribati,3,0,Pacific Games,3
New Caledonia,Tuvalu,8,0,Pacific Games,8
Andorra,Armenia,0,3,UEFA Euro qualification,3
Antigua and Barbuda,Curaçao,5,2,FIFA World Cup qualification,3
Belarus,Bosnia and Herzegovina,0,2,UEFA Euro qualification,2
Bulgaria,England,0,3,UEFA Euro qualification,3
Canada,Saint Lucia,4,1,FIFA World Cup qualification,3
Cyprus,Portugal,0,4,UEFA Euro qualification,4
Dominica,Nicaragua,0,2,FIFA World Cup qualification,2
Ecuador,Jamaica,5,2,Friendly,3
Finland,Moldova,4,1,UEFA Euro qualification,3
Germany,Austria,6,2,UEFA Euro qualification,4
Ghana,Eswatini,2,0,African Cup of Nations qualification,2
Grenada,Belize,0,3,FIFA World Cup qualification,3
Guyana,Barbados,2,0,FIFA World Cup qualification,2
Haiti,United States Virgin Islands,6,0,FIFA World Cup qualification,6
Iran,Indonesia,3,0,FIFA World Cup qualification,3
Iraq,Jordan,0,2,FIFA World Cup qualification,2
South Korea,Lebanon,6,0,FIFA World Cup qualification,6
Luxembourg,Romania,0,2,UEFA Euro qualification,2
Malta,Croatia,1,3,UEFA Euro qualification,2
Netherlands,San Marino,11,0,UEFA Euro qualification,11
Panama,Paraguay,0,2,Friendly,2
Guatemala,Saint Vincent and the Grenadines,4,0,FIFA World Cup qualification,4
Cameroon,Mauritius,6,0,African Cup of Nations qualification,6
Cook Islands,Fiji,1,4,Pacific Games,3
Guam,Vanuatu,1,4,Pacific Games,3
Honduras,Colombia,0,2,Friendly,2
Kiribati,Papua New Guinea,1,17,Pacific Games,16
New Caledonia,American Samoa,8,0,Pacific Games,8
Rwanda,Ivory Coast,0,5,African Cup of Nations qualification,5
Senegal,DR Congo,2,0,African Cup of Nations qualification,2
Solomon Islands,Tuvalu,6,1,Pacific Games,5
Angola,Uganda,2,0,African Cup of Nations qualification,2
Madagascar,Nigeria,0,2,African Cup of Nations qualification,2
Zimbabwe,Liberia,3,0,African Cup of Nations qualification,3
American Samoa,Vanuatu,0,8,Pacific Games,8
Kiribati,Tahiti,1,17,Pacific Games,16
Papua New Guinea,Fiji,0,2,Pacific Games,2
Argentina,Nigeria,3,1,Friendly,2
Barbados,Trinidad and Tobago,0,2,FIFA World Cup qualification,2
Cayman Islands,El Salvador,1,4,FIFA World Cup qualification,3
Croatia,Israel,3,1,UEFA Euro qualification,2
Curaçao,Haiti,2,4,FIFA World Cup qualification,2
Czech Republic,Ukraine,4,0,Friendly,4
Denmark,Norway,2,0,UEFA Euro qualification,2
Ecuador,Costa Rica,4,0,Friendly,4
Estonia,Northern Ireland,4,1,UEFA Euro qualification,3
Finland,Netherlands,0,2,UEFA Euro qualification,2
Honduras,Paraguay,0,3,Friendly,3
Indonesia,Bahrain,0,2,FIFA World Cup qualification,2
Jamaica,Colombia,0,2,Friendly,2
Lebanon,United Arab Emirates,3,1,FIFA World Cup qualification,2
Moldova,Hungary,0,2,UEFA Euro qualification,2
Puerto Rico,Canada,0,3,FIFA World Cup qualification,3
San Marino,Sweden,0,5,UEFA Euro qualification,5
Saudi Arabia,Australia,1,3,FIFA World Cup qualification,2
Serbia,Faroe Islands,3,1,UEFA Euro qualification,2
Singapore,Iraq,0,2,FIFA World Cup qualification,2
Slovakia,Armenia,0,4,UEFA Euro qualification,4
Spain,Liechtenstein,6,0,UEFA Euro qualification,6
Saint Lucia,Saint Kitts and Nevis,2,4,FIFA World Cup qualification,2
Switzerland,Bulgaria,3,1,UEFA Euro qualification,2
Thailand,Oman,3,0,FIFA World Cup qualification,3
United States Virgin Islands,Antigua and Barbuda,1,8,FIFA World Cup qualification,7
Equatorial Guinea,Central African Republic,3,0,Friendly,3
New Caledonia,Tahiti,3,1,Pacific Games,2
New Caledonia,Solomon Islands,2,0,Pacific Games,2
Suriname,Curaçao,2,0,Friendly,2
Brazil,Argentina,2,0,Superclásico de las Américas,2
Hong Kong,Macau,5,1,Dragon Cup,4
Philippines,Macau,2,0,Dragon Cup,2
Iran,Palestine,7,0,Friendly,7
Andorra,Republic of Ireland,0,2,UEFA Euro qualification,2
Argentina,Chile,4,1,FIFA World Cup qualification,3
Armenia,North Macedonia,4,1,UEFA Euro qualification,3
Australia,Malaysia,5,0,Friendly,5
Azerbaijan,Austria,1,4,UEFA Euro qualification,3
Barbados,Guyana,0,2,FIFA World Cup qualification,2
Belgium,Kazakhstan,4,1,UEFA Euro qualification,3
Belize,Grenada,1,4,FIFA World Cup qualification,3
Bosnia and Herzegovina,Luxembourg,5,0,UEFA Euro qualification,5
Cyprus,Denmark,1,4,UEFA Euro qualification,3
Czech Republic,Spain,0,2,UEFA Euro qualification,2
Dominica,Panama,0,5,FIFA World Cup qualification,5
Ecuador,Venezuela,2,0,FIFA World Cup qualification,2
France,Albania,3,0,UEFA Euro qualification,3
Gabon,Equatorial Guinea,2,0,Friendly,2
Greece,Croatia,2,0,UEFA Euro qualification,2
Latvia,Malta,2,0,UEFA Euro qualification,2
Peru,Paraguay,2,0,FIFA World Cup qualification,2
Portugal,Iceland,5,3,UEFA Euro qualification,2
Singapore,Philippines,2,0,Friendly,2
Saint Lucia,Canada,0,7,FIFA World Cup qualification,7
Turkey,Germany,1,3,UEFA Euro qualification,2
Ukraine,Bulgaria,3,0,Friendly,3
Uruguay,Bolivia,4,2,FIFA World Cup qualification,2
United States Virgin Islands,Haiti,0,7,FIFA World Cup qualification,7
Wales,Switzerland,2,0,UEFA Euro qualification,2
Saint Vincent and the Grenadines,Guatemala,0,3,FIFA World Cup qualification,3
Egypt,Niger,3,0,African Cup of Nations qualification,3
Ethiopia,Madagascar,4,2,African Cup of Nations qualification,2
Guinea-Bissau,Angola,0,2,African Cup of Nations qualification,2
Mozambique,Comoros,3,0,African Cup of Nations qualification,3
Sudan,Ghana,0,2,African Cup of Nations qualification,2
Tunisia,Togo,2,0,African Cup of Nations qualification,2
Algeria,Central African Republic,2,0,African Cup of Nations qualification,2
Mauritius,Senegal,0,2,African Cup of Nations qualification,2
Morocco,Tanzania,3,1,African Cup of Nations qualification,2
Antigua and Barbuda,United States Virgin Islands,10,0,FIFA World Cup qualification,10
Australia,Oman,3,0,FIFA World Cup qualification,3
Belarus,Poland,0,2,Friendly,2
Chile,Peru,4,2,FIFA World Cup qualification,2
Croatia,Latvia,2,0,UEFA Euro qualification,2
El Salvador,Cayman Islands,4,0,FIFA World Cup qualification,4
Estonia,Ukraine,0,2,Friendly,2
Germany,Belgium,3,1,UEFA Euro qualification,2
Guatemala,Belize,3,1,FIFA World Cup qualification,2
Iran,Bahrain,6,0,FIFA World Cup qualification,6
Italy,Northern Ireland,3,0,UEFA Euro qualification,3
Japan,Tajikistan,8,0,FIFA World Cup qualification,8
Lithuania,Czech Republic,1,4,UEFA Euro qualification,3
Malta,Israel,0,2,UEFA Euro qualification,2
Moldova,San Marino,4,0,UEFA Euro qualification,4
Norway,Cyprus,3,1,UEFA Euro qualification,2
Panama,Nicaragua,5,1,FIFA World Cup qualification,4
Philippines,Nepal,4,0,Friendly,4
Russia,Andorra,6,0,UEFA Euro qualification,6
Singapore,Jordan,0,3,FIFA World Cup qualification,3
Spain,Scotland,3,1,UEFA Euro qualification,2
Suriname,Dominican Republic,1,3,FIFA World Cup qualification,2
Switzerland,Montenegro,2,0,UEFA Euro qualification,2
Trinidad and Tobago,Barbados,4,0,FIFA World Cup qualification,4
Lesotho,DR Congo,0,3,Friendly,3
Gabon,Brazil,0,2,Friendly,2
Cameroon,Sudan,3,1,Friendly,2
Czech Republic,Montenegro,2,0,UEFA Euro qualification,2
Denmark,Sweden,2,0,Friendly,2
Djibouti,Namibia,0,4,FIFA World Cup qualification,4
Dominican Republic,Cayman Islands,4,0,FIFA World Cup qualification,4
Equatorial Guinea,Madagascar,2,0,FIFA World Cup qualification,2
Estonia,Republic of Ireland,0,4,UEFA Euro qualification,4
Georgia,Moldova,2,0,Friendly,2
Guatemala,Grenada,3,0,FIFA World Cup qualification,3
Hungary,Liechtenstein,5,0,Friendly,5
Jordan,Singapore,2,0,FIFA World Cup qualification,2
Mexico,Serbia,2,0,Friendly,2
Panama,Costa Rica,2,0,Friendly,2
Poland,Italy,0,2,Friendly,2
Puerto Rico,Saint Lucia,4,0,FIFA World Cup qualification,4
Qatar,Indonesia,4,0,FIFA World Cup qualification,4
São Tomé and Príncipe,Congo,0,5,FIFA World Cup qualification,5
Saudi Arabia,Thailand,3,0,FIFA World Cup qualification,3
Seychelles,Kenya,0,3,FIFA World Cup qualification,3
Suriname,El Salvador,1,3,FIFA World Cup qualification,2
Eswatini,DR Congo,1,3,FIFA World Cup qualification,2
Tajikistan,Japan,0,4,FIFA World Cup qualification,4
Turkey,Croatia,0,3,UEFA Euro qualification,3
United Arab Emirates,South Korea,0,2,FIFA World Cup qualification,2
Uruguay,Chile,4,0,FIFA World Cup qualification,4
United States Virgin Islands,Curaçao,0,3,FIFA World Cup qualification,3
Wales,Norway,4,1,Friendly,3
Brazil,Egypt,2,0,Friendly,2
Honduras,Serbia,2,0,Friendly,2
Puerto Rico,Saint Lucia,3,0,FIFA World Cup qualification,3
Canada,Saint Kitts and Nevis,4,0,FIFA World Cup qualification,4
Chile,Paraguay,2,0,FIFA World Cup qualification,2
DR Congo,Eswatini,5,1,FIFA World Cup qualification,4
Curaçao,United States Virgin Islands,6,1,FIFA World Cup qualification,5
Ecuador,Peru,2,0,FIFA World Cup qualification,2
El Salvador,Suriname,4,0,FIFA World Cup qualification,4
Germany,Netherlands,3,0,Friendly,3
Greece,Romania,1,3,Friendly,2
Grenada,Guatemala,1,4,FIFA World Cup qualification,3
Indonesia,Iran,1,4,FIFA World Cup qualification,3
Jordan,Iraq,1,3,FIFA World Cup qualification,2
Kenya,Seychelles,4,0,FIFA World Cup qualification,4
Mozambique,Comoros,4,1,FIFA World Cup qualification,3
Namibia,Djibouti,4,0,FIFA World Cup qualification,4
Nigeria,Zambia,2,0,Friendly,2
Panama,Dominica,3,0,FIFA World Cup qualification,3
Portugal,Bosnia and Herzegovina,6,2,UEFA Euro qualification,4
Rwanda,Eritrea,3,1,FIFA World Cup qualification,2
Singapore,China PR,0,4,FIFA World Cup qualification,4
Trinidad and Tobago,Guyana,2,0,FIFA World Cup qualification,2
Uzbekistan,Tajikistan,3,0,FIFA World Cup qualification,3
Saint Vincent and the Grenadines,Belize,0,2,FIFA World Cup qualification,2
Ethiopia,Somalia,5,0,FIFA World Cup qualification,5
Maldives,Seychelles,3,0,Friendly,3
Burundi,Somalia,4,1,CECAFA Cup,3
Zimbabwe,Djibouti,2,0,CECAFA Cup,2
Kenya,Malawi,0,2,CECAFA Cup,2
Somalia,Uganda,0,4,CECAFA Cup,4
India,Zambia,0,5,Friendly,5
Rwanda,Zimbabwe,2,0,CECAFA Cup,2
Tanzania,Djibouti,3,0,CECAFA Cup,3
Ethiopia,Kenya,0,2,CECAFA Cup,2
Somalia,Zanzibar,0,3,CECAFA Cup,3
Curaçao,Bonaire,1,3,ABCS Tournament,2
Rwanda,Djibouti,5,2,CECAFA Cup,3
Sri Lanka,Bhutan,3,0,SAFF Cup,3
Suriname,Curaçao,2,0,ABCS Tournament,2
Burundi,Sudan,0,2,CECAFA Cup,2
India,Bhutan,5,0,SAFF Cup,5
Sri Lanka,Afghanistan,1,3,SAFF Cup,2
Maldives,Bangladesh,3,1,SAFF Cup,2
Bhutan,Afghanistan,1,8,SAFF Cup,7
India,Sri Lanka,3,0,SAFF Cup,3
Tanzania,Uganda,1,3,CECAFA Cup,2
India,Maldives,3,1,SAFF Cup,2
India,Afghanistan,4,0,SAFF Cup,4
Venezuela,Costa Rica,0,2,Friendly,2
Basque Country,Tunisia,0,2,Friendly,2
Tunisia,Sudan,3,0,Friendly,3
Tunisia,Ivory Coast,0,2,Friendly,2
Angola,Sierra Leone,3,1,Friendly,2
Bahrain,Sweden,0,2,Friendly,2
Gabon,Niger,2,0,African Cup of Nations,2
Mexico,Venezuela,3,1,Friendly,2
Ivory Coast,Burkina Faso,2,0,African Cup of Nations,2
Romania,Turkmenistan,4,0,Friendly,4
Botswana,Guinea,1,6,African Cup of Nations,5
Ghana,Mali,2,0,African Cup of Nations,2
Ivory Coast,Angola,2,0,African Cup of Nations,2
Equatorial Guinea,Ivory Coast,0,3,African Cup of Nations,3
Zambia,Sudan,3,0,African Cup of Nations,3
Ghana,Mali,0,2,African Cup of Nations,2
Liberia,Nigeria,0,2,Friendly,2
Paraguay,Chile,2,0,Friendly,2
China PR,Kuwait,2,0,Friendly,2
Oman,India,5,1,Friendly,4
Jamaica,Cuba,3,0,Friendly,3
Japan,Iceland,3,1,Friendly,2
Thailand,Maldives,3,0,Friendly,3
United Arab Emirates,Palestine,3,0,Friendly,3
South Korea,Uzbekistan,4,2,Friendly,2
Nicaragua,Puerto Rico,4,1,Friendly,3
Egypt,Kenya,5,0,Friendly,5
India,Azerbaijan,0,3,Friendly,3
Armenia,Serbia,0,2,Friendly,2
Antigua and Barbuda,Trinidad and Tobago,0,4,Friendly,4
Armenia,Canada,3,1,Friendly,2
Australia,Saudi Arabia,4,2,FIFA World Cup qualification,2
Austria,Finland,3,1,Friendly,2
Bahrain,Indonesia,10,0,FIFA World Cup qualification,10
China PR,Jordan,3,1,FIFA World Cup qualification,2
Congo,Uganda,3,1,African Cup of Nations qualification,2
Croatia,Sweden,1,3,Friendly,2
Denmark,Russia,0,2,Friendly,2
Ecuador,Honduras,2,0,Friendly,2
El Salvador,Estonia,0,2,Friendly,2
Guyana,Guatemala,0,2,Friendly,2
Hong Kong,Taiwan,5,1,Friendly,4
Iraq,Singapore,7,1,FIFA World Cup qualification,6
South Korea,Kuwait,2,0,FIFA World Cup qualification,2
Madagascar,Cape Verde,0,4,African Cup of Nations qualification,4
Mexico,Colombia,0,2,Friendly,2
Morocco,Burkina Faso,2,0,Friendly,2
Northern Ireland,Norway,0,3,Friendly,3
Oman,Thailand,2,0,FIFA World Cup qualification,2
Palestine,Azerbaijan,2,0,Friendly,2
Seychelles,DR Congo,0,4,African Cup of Nations qualification,4
Spain,Venezuela,5,0,Friendly,5
Switzerland,Argentina,1,3,Friendly,2
United Arab Emirates,Lebanon,4,2,FIFA World Cup qualification,2
Nepal,Palestine,0,2,AFC Challenge Cup,2
Turkmenistan,Maldives,3,1,AFC Challenge Cup,2
India,Tajikistan,0,2,AFC Challenge Cup,2
North Korea,Philippines,2,0,AFC Challenge Cup,2
Philippines,India,2,0,AFC Challenge Cup,2
Tajikistan,North Korea,0,2,AFC Challenge Cup,2
Maldives,Palestine,0,2,AFC Challenge Cup,2
Nepal,Turkmenistan,0,3,AFC Challenge Cup,3
North Korea,India,4,0,AFC Challenge Cup,4
North Korea,Palestine,2,0,AFC Challenge Cup,2
Chile,Peru,3,1,Copa del Pacífico,2
French Guiana,Guyana,0,2,Friendly,2
Egypt,Chad,4,0,Friendly,4
Peru,Chile,0,3,Copa del Pacífico,3
Egypt,Mauritania,3,0,Friendly,3
Iran,Mauritania,2,0,Friendly,2
Malaysia,Sri Lanka,6,0,Friendly,6
Iran,Mozambique,3,0,Friendly,3
Lebanon,Egypt,1,4,Friendly,3
Panama,Guyana,2,0,Friendly,2
Egypt,Togo,3,0,Friendly,3
Botswana,Lesotho,3,0,Friendly,3
Japan,Azerbaijan,2,0,Friendly,2
Libya,Rwanda,2,0,Friendly,2
Venezuela,Moldova,4,0,Friendly,4
Georgia,Turkey,1,3,Friendly,2
Croatia,Estonia,3,1,Friendly,2
Algeria,Niger,3,0,Friendly,3
Denmark,Brazil,1,3,Friendly,2
El Salvador,Moldova,2,0,Friendly,2
Jordan,Sierra Leone,4,0,Friendly,4
Spain,Serbia,2,0,Friendly,2
Switzerland,Germany,5,3,Friendly,2
United States,Scotland,5,1,Friendly,4
Mexico,Wales,2,0,Friendly,2
Tunisia,Rwanda,5,1,Friendly,4
Ukraine,Estonia,4,0,Friendly,4
Bulgaria,Turkey,0,2,Friendly,2
Netherlands,Slovakia,2,0,Friendly,2
Spain,South Korea,4,1,Friendly,3
United States,Brazil,1,4,Friendly,3
France,Serbia,2,0,Friendly,2
Germany,Israel,2,0,Friendly,2
Egypt,Mozambique,2,0,FIFA World Cup qualification,2
Ghana,Lesotho,7,0,FIFA World Cup qualification,7
Italy,Russia,0,3,Friendly,3
Kazakhstan,Kyrgyzstan,5,2,Friendly,3
Latvia,Lithuania,5,0,Baltic Cup,5
Puerto Rico,Nicaragua,3,1,Friendly,2
Samoa,Tahiti,1,10,Oceania Nations Cup,9
Vanuatu,New Caledonia,2,5,Oceania Nations Cup,3
Algeria,Rwanda,4,0,FIFA World Cup qualification,4
Argentina,Ecuador,4,0,FIFA World Cup qualification,4
Bolivia,Chile,0,2,FIFA World Cup qualification,2
Burkina Faso,Congo,0,3,FIFA World Cup qualification,3
Central African Republic,Botswana,2,0,FIFA World Cup qualification,2
Denmark,Australia,2,0,Friendly,2
El Salvador,Honduras,0,3,Friendly,3
Ivory Coast,Tanzania,2,0,FIFA World Cup qualification,2
Luxembourg,Malta,0,2,Friendly,2
Netherlands,Northern Ireland,6,0,Friendly,6
Poland,Andorra,4,0,Friendly,4
Portugal,Turkey,1,3,Friendly,2
Senegal,Liberia,3,1,FIFA World Cup qualification,2
Sudan,Zambia,0,3,FIFA World Cup qualification,3
Tunisia,Equatorial Guinea,3,1,FIFA World Cup qualification,2
Japan,Oman,3,0,FIFA World Cup qualification,3
Mexico,Brazil,2,0,Friendly,2
Niger,Gabon,3,0,FIFA World Cup qualification,3
Vanuatu,Samoa,5,0,Oceania Nations Cup,5
Iraqi Kurdistan,Western Sahara,6,0,Viva World Cup,6
Zanzibar,Raetia,6,0,Viva World Cup,6
Northern Cyprus,Darfur,15,0,Viva World Cup,15
Armenia,Kazakhstan,3,0,Friendly,3
France,Estonia,4,0,Friendly,4
New Caledonia,Samoa,9,0,Oceania Nations Cup,9
Tahiti,Vanuatu,4,1,Oceania Nations Cup,3
Turkey,Ukraine,2,0,Friendly,2
Western Sahara,Occitania,2,6,Viva World Cup,4
Darfur,Provence,0,18,Viva World Cup,18
Tamil Eelam,Zanzibar,0,3,Viva World Cup,3
Western Sahara,Darfur,5,1,Viva World Cup,4
Occitania,Tamil Eelam,7,0,Viva World Cup,7
China PR,Vietnam,3,0,Friendly,3
Honduras,Panama,0,2,FIFA World Cup qualification,2
Japan,Jordan,6,0,FIFA World Cup qualification,6
Mexico,Guyana,3,1,FIFA World Cup qualification,2
New Zealand,New Caledonia,0,2,Oceania Nations Cup,2
Qatar,South Korea,1,4,FIFA World Cup qualification,3
Russia,Czech Republic,4,1,UEFA Euro,3
United States,Antigua and Barbuda,3,1,FIFA World Cup qualification,2
Western Sahara,Raetia,3,0,Viva World Cup,3
Zanzibar,Northern Cyprus,0,2,Viva World Cup,2
Bolivia,Paraguay,3,1,FIFA World Cup qualification,2
Venezuela,Chile,0,2,FIFA World Cup qualification,2
Tamil Eelam,Raetia,4,0,Viva World Cup,4
Occitania,Western Sahara,3,1,Viva World Cup,2
Provence,Zanzibar,2,7,Viva World Cup,5
DR Congo,Togo,2,0,FIFA World Cup qualification,2
Ethiopia,Central African Republic,2,0,FIFA World Cup qualification,2
Republic of Ireland,Croatia,1,3,UEFA Euro,2
Uruguay,Peru,4,2,FIFA World Cup qualification,2
Guyana,Costa Rica,0,4,FIFA World Cup qualification,4
South Korea,Lebanon,3,0,FIFA World Cup qualification,3
Malaysia,Singapore,2,0,Friendly,2
Philippines,Guam,3,0,Friendly,3
Spain,Republic of Ireland,4,0,UEFA Euro,4
Algeria,Gambia,4,1,African Cup of Nations qualification,3
South Africa,Gabon,3,0,Friendly,3
Ukraine,France,0,2,UEFA Euro,2
Cape Verde,Madagascar,3,1,African Cup of Nations qualification,2
Malawi,Chad,2,0,African Cup of Nations qualification,2
Nigeria,Rwanda,2,0,African Cup of Nations qualification,2
Sierra Leone,São Tomé and Príncipe,4,2,African Cup of Nations qualification,2
Uganda,Congo,4,0,African Cup of Nations qualification,4
DR Congo,Seychelles,3,0,African Cup of Nations qualification,3
Italy,Republic of Ireland,2,0,UEFA Euro,2
Saudi Arabia,Morocco,4,0,Friendly,4
Sweden,France,2,0,UEFA Euro,2
Germany,Greece,4,2,UEFA Euro,2
Saudi Arabia,Kuwait,4,0,Arab Cup,4
Libya,Yemen,3,1,Arab Cup,2
Spain,France,2,0,UEFA Euro,2
Kuwait,Palestine,2,0,Arab Cup,2
Bahrain,Yemen,0,2,Arab Cup,2
Lebanon,Sudan,0,2,Arab Cup,2
Spain,Italy,4,0,UEFA Euro,4
Saudi Arabia,Libya,0,2,Arab Cup,2
Kenya,Botswana,3,1,Friendly,2
Suriname,Bonaire,8,0,ABCS Tournament,8
Bonaire,Curaçao,2,9,ABCS Tournament,7
Zimbabwe,Lesotho,5,3,Friendly,2
Guam,Northern Mariana Islands,3,1,EAFF Championship,2
Northern Mariana Islands,Macau,1,5,EAFF Championship,4
Guam,Macau,3,0,EAFF Championship,3
Burkina Faso,Togo,3,0,Friendly,3
Angola,Mozambique,2,0,Friendly,2
Austria,Turkey,2,0,Friendly,2
Azerbaijan,Bahrain,3,0,Friendly,3
Belgium,Netherlands,4,2,Friendly,2
Bolivia,Guyana,2,0,Friendly,2
Canada,Trinidad and Tobago,2,0,Friendly,2
Croatia,Switzerland,2,4,Friendly,2
Denmark,Slovakia,1,3,Friendly,2
Ecuador,Chile,3,0,Friendly,3
El Salvador,Jamaica,0,2,Friendly,2
Germany,Argentina,1,3,Friendly,2
Iceland,Faroe Islands,2,0,Friendly,2
Jordan,Uzbekistan,2,0,Friendly,2
Montenegro,Latvia,2,0,Friendly,2
Portugal,Panama,2,0,Friendly,2
Scotland,Australia,3,1,Friendly,2
Singapore,Hong Kong,2,0,Friendly,2
Sweden,Brazil,0,3,Friendly,3
Wales,Bosnia and Herzegovina,0,2,Friendly,2
India,Maldives,3,0,Nehru Cup,3
Libya,Sudan,3,0,Friendly,3
Nepal,Cameroon,0,5,Nehru Cup,5
Cameroon,Maldives,3,1,Nehru Cup,2
Syria,Nepal,2,0,Nehru Cup,2
Martinique,British Virgin Islands,16,0,CFU Caribbean Cup qualification,16
Montserrat,Suriname,1,7,CFU Caribbean Cup qualification,6
Lebanon,Australia,0,3,Friendly,3
Albania,Cyprus,3,1,FIFA World Cup qualification,2
Andorra,Hungary,0,5,FIFA World Cup qualification,5
Argentina,Paraguay,3,1,FIFA World Cup qualification,2
British Virgin Islands,Suriname,0,4,CFU Caribbean Cup qualification,4
Colombia,Uruguay,4,0,FIFA World Cup qualification,4
Costa Rica,Mexico,0,2,FIFA World Cup qualification,2
Cuba,Honduras,0,3,FIFA World Cup qualification,3
Estonia,Romania,0,2,FIFA World Cup qualification,2
Germany,Faroe Islands,3,0,FIFA World Cup qualification,3
Guatemala,Antigua and Barbuda,3,1,FIFA World Cup qualification,2
Haiti,Saint Martin,7,0,CFU Caribbean Cup qualification,7
Iceland,Norway,2,0,FIFA World Cup qualification,2
Liechtenstein,Bosnia and Herzegovina,1,8,FIFA World Cup qualification,7
Martinique,Montserrat,5,0,CFU Caribbean Cup qualification,5
Moldova,England,0,5,FIFA World Cup qualification,5
Netherlands,Turkey,2,0,FIFA World Cup qualification,2
New Caledonia,New Zealand,0,2,FIFA World Cup qualification,2
Russia,Northern Ireland,2,0,FIFA World Cup qualification,2
Singapore,Philippines,0,2,Friendly,2
Slovenia,Switzerland,0,2,FIFA World Cup qualification,2
Solomon Islands,Tahiti,2,0,FIFA World Cup qualification,2
Spain,Saudi Arabia,5,0,Friendly,5
Uzbekistan,Kuwait,3,0,Friendly,3
Wales,Belgium,0,2,FIFA World Cup qualification,2
Cape Verde,Cameroon,2,0,African Cup of Nations qualification,2
DR Congo,Equatorial Guinea,4,0,African Cup of Nations qualification,4
Ghana,Malawi,2,0,African Cup of Nations qualification,2
Ivory Coast,Senegal,4,2,African Cup of Nations qualification,2
Mali,Botswana,3,0,African Cup of Nations qualification,3
Sudan,Ethiopia,5,3,African Cup of Nations qualification,2
British Virgin Islands,Montserrat,0,7,CFU Caribbean Cup qualification,7
Haiti,Bermuda,3,1,CFU Caribbean Cup qualification,2
Mozambique,Morocco,2,0,African Cup of Nations qualification,2
Puerto Rico,Saint Martin,9,0,CFU Caribbean Cup qualification,9
Zimbabwe,Angola,3,1,African Cup of Nations qualification,2
Brazil,China PR,8,0,Friendly,8
Indonesia,North Korea,0,2,Friendly,2
Bosnia and Herzegovina,Latvia,4,1,FIFA World Cup qualification,3
Chile,Colombia,1,3,FIFA World Cup qualification,2
France,Belarus,3,1,FIFA World Cup qualification,2
Greece,Lithuania,2,0,FIFA World Cup qualification,2
Hungary,Netherlands,1,4,FIFA World Cup qualification,3
Republic of Ireland,Oman,4,1,Friendly,3
Israel,Russia,0,4,FIFA World Cup qualification,4
Italy,Malta,2,0,FIFA World Cup qualification,2
Liberia,Ghana,2,0,Friendly,2
Malaysia,Vietnam,0,2,Friendly,2
New Zealand,Solomon Islands,6,1,FIFA World Cup qualification,5
Panama,Canada,2,0,FIFA World Cup qualification,2
Paraguay,Venezuela,0,2,FIFA World Cup qualification,2
Poland,Moldova,2,0,FIFA World Cup qualification,2
Portugal,Azerbaijan,3,0,FIFA World Cup qualification,3
Romania,Andorra,4,0,FIFA World Cup qualification,4
San Marino,Montenegro,0,6,FIFA World Cup qualification,6
Serbia,Wales,6,1,FIFA World Cup qualification,5
Slovakia,Liechtenstein,2,0,FIFA World Cup qualification,2
South Africa,Mozambique,2,0,Friendly,2
Saint Martin,Bermuda,0,8,CFU Caribbean Cup qualification,8
Sweden,Kazakhstan,2,0,FIFA World Cup qualification,2
Switzerland,Albania,2,0,FIFA World Cup qualification,2
Tahiti,New Caledonia,0,4,FIFA World Cup qualification,4
Turkey,Estonia,3,0,FIFA World Cup qualification,3
United Arab Emirates,Kuwait,3,0,Friendly,3
Senegal,Ivory Coast,0,2,African Cup of Nations qualification,2
Guadeloupe,Saint Pierre and Miquelon,13,0,African Nations Championship,13
Martinique,New Caledonia,2,0,African Nations Championship,2
Réunion,French Guiana,2,0,African Nations Championship,2
Tahiti,Mayotte,1,3,African Nations Championship,2
Guadeloupe,French Guiana,4,2,African Nations Championship,2
New Caledonia,Mayotte,0,2,African Nations Championship,2
Réunion,Saint Pierre and Miquelon,10,0,African Nations Championship,10
French Guiana,Saint Pierre and Miquelon,11,1,African Nations Championship,10
Martinique,Mayotte,3,0,African Nations Championship,3
Philippines,Macau,5,0,Friendly,5
Saint Pierre and Miquelon,New Caledonia,1,16,African Nations Championship,15
Macau,Guam,0,3,Friendly,3
Philippines,Taiwan,3,1,Friendly,2
Cambodia,Timor-Leste,1,5,AFF Championship,4
Timor-Leste,Laos,3,1,AFF Championship,2
French Guiana,Trinidad and Tobago,1,4,CFU Caribbean Cup qualification,3
Brazil,Iraq,6,0,Friendly,6
Brunei,Laos,1,3,AFF Championship,2
Myanmar,Cambodia,3,0,AFF Championship,3
Argentina,Uruguay,3,0,FIFA World Cup qualification,3
Armenia,Italy,1,3,FIFA World Cup qualification,2
Belarus,Spain,0,4,FIFA World Cup qualification,4
Canada,Cuba,3,0,FIFA World Cup qualification,3
Colombia,Paraguay,2,0,FIFA World Cup qualification,2
Czech Republic,Malta,3,1,FIFA World Cup qualification,2
Ecuador,Chile,3,1,FIFA World Cup qualification,2
Egypt,Congo,3,0,Friendly,3
England,San Marino,5,0,FIFA World Cup qualification,5
French Guiana,Anguilla,4,1,CFU Caribbean Cup qualification,3
Guyana,Mexico,0,5,FIFA World Cup qualification,5
Republic of Ireland,Germany,1,6,FIFA World Cup qualification,5
Liechtenstein,Lithuania,0,2,FIFA World Cup qualification,2
Luxembourg,Israel,0,6,FIFA World Cup qualification,6
Netherlands,Andorra,3,0,FIFA World Cup qualification,3
Serbia,Belgium,0,3,FIFA World Cup qualification,3
Solomon Islands,New Caledonia,2,6,FIFA World Cup qualification,4
Tahiti,New Zealand,0,2,FIFA World Cup qualification,2
Saint Kitts and Nevis,French Guiana,0,3,CFU Caribbean Cup qualification,3
Trinidad and Tobago,Anguilla,10,0,CFU Caribbean Cup qualification,10
Austria,Kazakhstan,4,0,FIFA World Cup qualification,4
Belarus,Georgia,2,0,FIFA World Cup qualification,2
Belgium,Scotland,2,0,FIFA World Cup qualification,2
Bolivia,Uruguay,4,1,FIFA World Cup qualification,3
Bosnia and Herzegovina,Lithuania,3,0,FIFA World Cup qualification,3
Colombia,Cameroon,3,0,Friendly,3
Costa Rica,Guyana,7,0,FIFA World Cup qualification,7
Croatia,Wales,2,0,FIFA World Cup qualification,2
Cyprus,Norway,1,3,FIFA World Cup qualification,2
Faroe Islands,Republic of Ireland,1,4,FIFA World Cup qualification,3
Honduras,Canada,8,1,FIFA World Cup qualification,7
Hong Kong,Malaysia,0,3,Friendly,3
Hungary,Turkey,3,1,FIFA World Cup qualification,2
Iceland,Switzerland,0,2,FIFA World Cup qualification,2
Israel,Luxembourg,3,0,FIFA World Cup qualification,3
Italy,Denmark,3,1,FIFA World Cup qualification,2
Jamaica,Antigua and Barbuda,4,1,FIFA World Cup qualification,3
Japan,Brazil,0,4,Friendly,4
Latvia,Liechtenstein,2,0,FIFA World Cup qualification,2
Mexico,El Salvador,2,0,FIFA World Cup qualification,2
New Caledonia,Solomon Islands,5,0,FIFA World Cup qualification,5
New Zealand,Tahiti,3,0,FIFA World Cup qualification,3
Romania,Netherlands,1,4,FIFA World Cup qualification,3
San Marino,Moldova,0,2,FIFA World Cup qualification,2
Singapore,India,2,0,Friendly,2
United Arab Emirates,Bahrain,6,2,Friendly,4
United States,Guatemala,3,1,FIFA World Cup qualification,2
Saint Lucia,Curaçao,5,1,CFU Caribbean Cup qualification,4
Artsakh,Abkhazia,3,0,Friendly,3
Guadeloupe,Dominican Republic,0,2,CFU Caribbean Cup qualification,2
Guadeloupe,Puerto Rico,4,1,CFU Caribbean Cup qualification,3
Saint Vincent and the Grenadines,Curaçao,4,0,CFU Caribbean Cup qualification,4
Vietnam,Laos,4,0,VFF Cup,4
Puerto Rico,Dominican Republic,1,3,CFU Caribbean Cup qualification,2
Laos,Turkmenistan,2,4,VFF Cup,2
Iran,Tajikistan,6,1,Friendly,5
Thailand,Malaysia,2,0,Friendly,2
Bahrain,Jordan,3,0,Friendly,3
Andorra,Iceland,0,2,Friendly,2
Armenia,Lithuania,4,2,Friendly,2
Austria,Ivory Coast,0,3,Friendly,3
Cuba,Suriname,5,0,CFU Caribbean Cup qualification,5
Cyprus,Finland,0,3,Friendly,3
Czech Republic,Slovakia,3,0,Friendly,3
Hungary,Norway,0,2,Friendly,2
Montenegro,San Marino,3,0,FIFA World Cup qualification,3
Panama,Spain,1,5,Friendly,4
Paraguay,Guatemala,3,1,Friendly,2
Poland,Uruguay,1,3,Friendly,2
Serbia,Chile,3,1,Friendly,2
Sweden,England,4,2,Friendly,2
Thailand,Bhutan,5,0,Friendly,5
Venezuela,Nigeria,1,3,Friendly,2
Trinidad and Tobago,Suriname,3,0,CFU Caribbean Cup qualification,3
Thailand,Bangladesh,5,0,Friendly,5
Singapore,Pakistan,4,0,Friendly,4
Guam,Northern Mariana Islands,8,0,Friendly,8
Burundi,Somalia,5,1,CECAFA Cup,4
Malaysia,Singapore,0,3,AFF Championship,3
Tanzania,Sudan,2,0,CECAFA Cup,2
Rwanda,Malawi,2,0,CECAFA Cup,2
South Sudan,Kenya,0,2,CECAFA Cup,2
Thailand,Myanmar,4,0,AFF Championship,4
Malaysia,Laos,4,1,AFF Championship,3
Palestine,Bahrain,0,2,Friendly,2
Kenya,Ethiopia,3,1,CECAFA Cup,2
Philippines,Myanmar,2,0,AFF Championship,2
Thailand,Vietnam,3,1,AFF Championship,2
Uganda,South Sudan,4,0,CECAFA Cup,4
Eritrea,Rwanda,0,2,CECAFA Cup,2
Malawi,Zanzibar,2,0,CECAFA Cup,2
Malaysia,Indonesia,2,0,AFF Championship,2
Mauritius,Comoros,2,0,African Nations Championship,2
Somalia,Tanzania,0,7,CECAFA Cup,7
Mozambique,Seychelles,4,0,African Nations Championship,4
North Korea,Guam,5,0,EAFF Championship,5
Rwanda,Tanzania,0,2,CECAFA Cup,2
Uganda,Ethiopia,2,0,CECAFA Cup,2
Uganda,Tanzania,3,0,CECAFA Cup,3
Guam,Australia,0,9,EAFF Championship,9
Hong Kong,Taiwan,2,0,EAFF Championship,2
Antigua and Barbuda,Trinidad and Tobago,2,0,CFU Caribbean Cup,2
Australia,Taiwan,8,0,EAFF Championship,8
Hong Kong,North Korea,0,4,EAFF Championship,4
Kuwait,Oman,0,2,WAFF Championship,2
French Guiana,Martinique,1,3,CFU Caribbean Cup,2
Thailand,Malaysia,2,0,AFF Championship,2
North Macedonia,Poland,1,4,Friendly,3
Oman,Iraq,0,2,WAFF Championship,2
Oman,Benin,2,0,Friendly,2
Singapore,Thailand,3,1,AFF Championship,2
South Africa,Malawi,3,1,Friendly,2
United Arab Emirates,Yemen,2,0,Friendly,2
Qatar,Egypt,0,2,Friendly,2
Bahrain,Guinea,3,0,Friendly,3
United Arab Emirates,Yemen,3,1,Friendly,2
Basque Country,Bolivia,6,1,Friendly,5
Niger,Togo,3,1,Friendly,2
Qatar,United Arab Emirates,1,3,Gulf Cup,2
Zambia,Angola,0,2,Friendly,2
Kuwait,Yemen,2,0,Gulf Cup,2
Saudi Arabia,Iraq,0,2,Gulf Cup,2
Yemen,Saudi Arabia,0,2,Gulf Cup,2
Ghana,Egypt,3,0,Friendly,3
Panama,Guatemala,3,0,Friendly,3
United Arab Emirates,Oman,2,0,Gulf Cup,2
Iraq,Yemen,2,0,Gulf Cup,2
Angola,Botswana,2,0,Friendly,2
Ghana,Tunisia,4,2,Friendly,2
Panama,Guatemala,2,0,Friendly,2
Ivory Coast,Egypt,4,2,Friendly,2
Eswatini,Burkina Faso,0,3,Friendly,3
Bahrain,Kuwait,1,6,Gulf Cup,5
Chile,Haiti,3,0,Friendly,3
Costa Rica,Nicaragua,2,0,UNCAF Cup,2
South Africa,Angola,2,0,African Cup of Nations,2
Thailand,Finland,1,3,King's Cup,2
Burkina Faso,Ethiopia,4,0,African Cup of Nations,4
Guatemala,Panama,1,3,UNCAF Cup,2
Algeria,Togo,0,2,African Cup of Nations,2
Ivory Coast,Tunisia,3,0,African Cup of Nations,3
Sweden,Finland,3,0,King's Cup,3
Niger,Ghana,0,3,African Cup of Nations,3
Ethiopia,Nigeria,0,2,African Cup of Nations,2
Jordan,Indonesia,5,0,Friendly,5
Ghana,Cape Verde,2,0,African Cup of Nations,2
Romania,Poland,1,4,Friendly,3
Croatia,South Korea,4,0,Friendly,4
Cyprus,Serbia,1,3,Friendly,2
Iceland,Russia,0,2,Friendly,2
India,Palestine,2,4,Friendly,2
Iran,Lebanon,5,0,AFC Asian Cup qualification,5
Republic of Ireland,Poland,2,0,Friendly,2
Japan,Latvia,3,0,Friendly,3
Jordan,Singapore,4,0,AFC Asian Cup qualification,4
Kenya,Libya,3,0,Friendly,3
North Macedonia,Denmark,3,0,Friendly,3
Mali,Nigeria,1,4,African Cup of Nations,3
Moldova,Kazakhstan,1,3,Friendly,2
Norway,Ukraine,0,2,Friendly,2
Qatar,Malaysia,2,0,AFC Asian Cup qualification,2
Slovenia,Bosnia and Herzegovina,0,3,Friendly,3
Spain,Uruguay,3,1,Friendly,2
Thailand,Kuwait,1,3,AFC Asian Cup qualification,2
Turkey,Czech Republic,0,2,Friendly,2
Yemen,Bahrain,0,2,AFC Asian Cup qualification,2
Mali,Ghana,3,1,African Cup of Nations,2
Maldives,Pakistan,3,0,Friendly,3
Gambia,Mauritania,0,2,Friendly,2
Myanmar,Guam,5,0,AFC Challenge Cup qualification,5
Nepal,Northern Mariana Islands,6,0,AFC Challenge Cup qualification,6
Guam,India,0,4,AFC Challenge Cup qualification,4
Laos,Sri Lanka,4,2,AFC Challenge Cup qualification,2
Nepal,Bangladesh,0,2,AFC Challenge Cup qualification,2
Northern Mariana Islands,Palestine,0,9,AFC Challenge Cup qualification,9
Bangladesh,Northern Mariana Islands,4,0,AFC Challenge Cup qualification,4
Sri Lanka,Mongolia,3,0,AFC Challenge Cup qualification,3
Qatar,Egypt,3,1,Friendly,2
Senegal,Libya,0,4,Friendly,4
Malaysia,Saudi Arabia,1,4,Friendly,3
Macau,Tajikistan,0,3,AFC Challenge Cup qualification,3
Oman,Haiti,3,0,Friendly,3
Ecuador,El Salvador,5,0,Friendly,5
Pakistan,Macau,2,0,AFC Challenge Cup qualification,2
Andorra,Turkey,0,2,FIFA World Cup qualification,2
Argentina,Venezuela,3,0,FIFA World Cup qualification,3
Austria,Faroe Islands,6,0,FIFA World Cup qualification,6
Bosnia and Herzegovina,Greece,3,1,FIFA World Cup qualification,2
Bulgaria,Malta,6,0,FIFA World Cup qualification,6
Colombia,Bolivia,5,0,FIFA World Cup qualification,5
Croatia,Serbia,2,0,FIFA World Cup qualification,2
Czech Republic,Denmark,0,3,FIFA World Cup qualification,3
Egypt,Eswatini,10,0,Friendly,10
France,Georgia,3,1,FIFA World Cup qualification,2
Kazakhstan,Germany,0,3,FIFA World Cup qualification,3
Lebanon,Thailand,5,2,AFC Asian Cup qualification,3
North Macedonia,Belgium,0,2,FIFA World Cup qualification,2
Netherlands,Estonia,3,0,FIFA World Cup qualification,3
Poland,Ukraine,1,3,FIFA World Cup qualification,2
San Marino,England,0,8,FIFA World Cup qualification,8
Tahiti,Solomon Islands,2,0,FIFA World Cup qualification,2
Turkmenistan,Cambodia,7,0,AFC Challenge Cup qualification,7
Burkina Faso,Niger,4,0,FIFA World Cup qualification,4
Ivory Coast,Gambia,3,0,FIFA World Cup qualification,3
South Africa,Central African Republic,2,0,FIFA World Cup qualification,2
Dominican Republic,Haiti,3,1,Friendly,2
Equatorial Guinea,Cape Verde,0,3,FIFA World Cup qualification,3
Ghana,Sudan,4,0,FIFA World Cup qualification,4
Liberia,Uganda,2,0,FIFA World Cup qualification,2
Philippines,Cambodia,8,0,AFC Challenge Cup qualification,8
Tanzania,Morocco,3,1,FIFA World Cup qualification,2
Canada,Belarus,0,2,Friendly,2
Albania,Lithuania,4,1,Friendly,3
Algeria,Benin,3,1,FIFA World Cup qualification,2
Armenia,Czech Republic,0,3,FIFA World Cup qualification,3
Azerbaijan,Portugal,0,2,FIFA World Cup qualification,2
Chile,Uruguay,2,0,FIFA World Cup qualification,2
Costa Rica,Jamaica,2,0,FIFA World Cup qualification,2
Ecuador,Paraguay,4,1,FIFA World Cup qualification,3
Estonia,Andorra,2,0,FIFA World Cup qualification,2
Germany,Kazakhstan,4,1,FIFA World Cup qualification,3
Luxembourg,Finland,0,3,Friendly,3
Malaysia,Palestine,0,2,Friendly,2
Malta,Italy,0,2,FIFA World Cup qualification,2
Netherlands,Romania,4,0,FIFA World Cup qualification,4
Northern Ireland,Israel,0,2,FIFA World Cup qualification,2
Panama,Honduras,2,0,FIFA World Cup qualification,2
Peru,Trinidad and Tobago,3,0,Friendly,3
Poland,San Marino,5,0,FIFA World Cup qualification,5
Serbia,Scotland,2,0,FIFA World Cup qualification,2
Solomon Islands,New Zealand,0,2,FIFA World Cup qualification,2
Bolivia,Brazil,0,4,Friendly,4
Qatar,Palestine,2,0,Friendly,2
Saint Vincent and the Grenadines,Saint Lucia,0,2,Windward Islands Tournament,2
Zambia,Zimbabwe,2,0,Friendly,2
Libya,Mauritania,2,0,Friendly,2
Oman,Iran,3,1,Friendly,2
Qatar,Latvia,3,1,Friendly,2
Ethiopia,Sudan,2,0,Friendly,2
Ecuador,Germany,2,4,Friendly,2
United States,Belgium,2,4,Friendly,2
Japan,Bulgaria,0,2,Kirin Challenge Cup,2
Italy,San Marino,4,0,Friendly,4
Turkey,Slovenia,0,2,Friendly,2
Libya,Uganda,3,0,Friendly,3
Algeria,Burkina Faso,2,0,Friendly,2
Honduras,Israel,0,2,Friendly,2
Republic of Ireland,Georgia,4,0,Friendly,4
Lesotho,South Africa,0,2,Friendly,2
Estonia,Belarus,0,2,Friendly,2
Myanmar,Singapore,0,2,Friendly,2
Poland,Liechtenstein,2,0,Friendly,2
Romania,Trinidad and Tobago,4,0,Friendly,4
Iceland,Slovenia,2,4,FIFA World Cup qualification,2
Indonesia,Netherlands,0,3,Friendly,3
Republic of Ireland,Faroe Islands,3,0,FIFA World Cup qualification,3
Laos,Singapore,2,5,Friendly,3
Latvia,Bosnia and Herzegovina,0,5,FIFA World Cup qualification,5
Montenegro,Ukraine,0,4,FIFA World Cup qualification,4
Sudan,Ghana,1,3,FIFA World Cup qualification,2
Botswana,Ethiopia,3,0,FIFA World Cup qualification,3
Cape Verde,Equatorial Guinea,3,0,FIFA World Cup qualification,3
Central African Republic,South Africa,0,3,FIFA World Cup qualification,3
Gambia,Ivory Coast,0,3,FIFA World Cup qualification,3
Zambia,Lesotho,4,0,FIFA World Cup qualification,4
Benin,Algeria,1,3,FIFA World Cup qualification,2
Brazil,France,3,0,Friendly,3
Guinea,Mozambique,6,1,FIFA World Cup qualification,5
Togo,Cameroon,0,3,FIFA World Cup qualification,3
Zimbabwe,Egypt,2,4,FIFA World Cup qualification,2
Australia,Jordan,4,0,FIFA World Cup qualification,4
Chile,Bolivia,3,1,FIFA World Cup qualification,2
China PR,Netherlands,0,2,Friendly,2
Colombia,Peru,2,0,FIFA World Cup qualification,2
Denmark,Armenia,0,4,FIFA World Cup qualification,4
Honduras,Jamaica,2,0,FIFA World Cup qualification,2
Iran,Lebanon,4,0,FIFA World Cup qualification,4
Norway,North Macedonia,2,0,Friendly,2
Spain,Republic of Ireland,2,0,Friendly,2
Sweden,Faroe Islands,2,0,FIFA World Cup qualification,2
United States,Panama,2,0,FIFA World Cup qualification,2
Guatemala,Argentina,0,4,Friendly,4
Libya,Togo,2,0,FIFA World Cup qualification,2
Brazil,Japan,3,0,Confederations Cup,3
China PR,Thailand,1,5,Friendly,4
Gabon,Niger,4,1,FIFA World Cup qualification,3
Morocco,Gambia,2,0,FIFA World Cup qualification,2
Lesotho,Ghana,0,2,FIFA World Cup qualification,2
Liberia,Senegal,0,2,FIFA World Cup qualification,2
Tanzania,Ivory Coast,2,4,FIFA World Cup qualification,2
Tahiti,Nigeria,1,6,Confederations Cup,5
Costa Rica,Panama,2,0,FIFA World Cup qualification,2
Uzbekistan,Qatar,5,1,FIFA World Cup qualification,4
Brazil,Mexico,2,0,Confederations Cup,2
Spain,Tahiti,10,0,Confederations Cup,10
Brazil,Italy,4,2,Confederations Cup,2
Monaco,Vatican City,2,0,Friendly,2
Nigeria,Spain,0,3,Confederations Cup,3
Uruguay,Tahiti,8,0,Confederations Cup,8
Brazil,Spain,3,0,Confederations Cup,3
Mali,Guinea,3,1,African Nations Championship,2
Nigeria,Ivory Coast,4,1,African Nations Championship,3
Haiti,Honduras,0,2,Gold Cup,2
Namibia,Seychelles,4,2,COSAFA Cup,2
Costa Rica,Cuba,3,0,Gold Cup,3
Kenya,Eswatini,2,0,COSAFA Cup,2
United States,Belize,6,1,Gold Cup,5
Mauritius,Seychelles,4,0,COSAFA Cup,4
Lesotho,Eswatini,2,0,COSAFA Cup,2
Mexico,Canada,2,0,Gold Cup,2
Trinidad and Tobago,Haiti,0,2,Gold Cup,2
United States,Cuba,4,1,Gold Cup,3
Martinique,Mexico,1,3,Gold Cup,2
Zambia,Mozambique,3,1,COSAFA Cup,2
Bermuda,Greenland,3,0,Island Games,3
Honduras,Trinidad and Tobago,0,2,Gold Cup,2
Bermuda,Falkland Islands,8,0,Island Games,8
Greenland,Frøya,12,0,Island Games,12
Cuba,Belize,4,0,Gold Cup,4
Falkland Islands,Greenland,0,9,Island Games,9
Bermuda,Frøya,8,0,Island Games,8
Falkland Islands,Frøya,6,0,Island Games,6
Mauritania,Senegal,2,0,African Nations Championship,2
Panama,Cuba,6,1,Gold Cup,5
Zambia,Zimbabwe,2,0,COSAFA Cup,2
United States,El Salvador,5,1,Gold Cup,4
United States,Honduras,3,1,Gold Cup,2
Ivory Coast,Nigeria,2,0,African Nations Championship,2
Uganda,Tanzania,3,1,African Nations Championship,2
Mauritius,Zimbabwe,0,3,African Nations Championship,3
Mozambique,Namibia,3,0,African Nations Championship,3
Namibia,Mozambique,3,0,African Nations Championship,3
Albania,Armenia,2,0,Friendly,2
Austria,Greece,0,2,Friendly,2
Azerbaijan,Malta,3,0,Friendly,3
Chile,Iraq,6,0,Friendly,6
Dominican Republic,Costa Rica,0,4,Friendly,4
Ecuador,Spain,0,2,Friendly,2
Egypt,Uganda,3,0,Friendly,3
Finland,Slovenia,2,0,Friendly,2
Indonesia,Philippines,2,0,Friendly,2
Japan,Uruguay,2,4,Friendly,2
North Macedonia,Bulgaria,2,0,Friendly,2
Mexico,Ivory Coast,4,1,Friendly,3
Singapore,Oman,0,2,AFC Asian Cup qualification,2
South Africa,Nigeria,0,2,Friendly,2
Sweden,Norway,4,2,Friendly,2
Tajikistan,India,3,0,Friendly,3
Tunisia,Congo,3,0,Friendly,3
Ukraine,Israel,2,0,Friendly,2
South Africa,Burkina Faso,2,0,Friendly,2
Afghanistan,Pakistan,3,0,Friendly,3
Botswana,Uganda,1,3,Friendly,2
Nepal,Bangladesh,2,0,SAFF Cup,2
Afghanistan,Bhutan,3,0,SAFF Cup,3
Maldives,Sri Lanka,10,0,SAFF Cup,10
Bhutan,Maldives,2,8,SAFF Cup,6
Sri Lanka,Afghanistan,1,3,SAFF Cup,2
Qatar,Mauritius,3,0,Friendly,3
Belarus,Kyrgyzstan,3,1,Friendly,2
Chile,Venezuela,3,0,FIFA World Cup qualification,3
China PR,Singapore,6,1,Friendly,5
Costa Rica,United States,3,1,FIFA World Cup qualification,2
England,Moldova,4,0,FIFA World Cup qualification,4
Finland,Spain,0,2,FIFA World Cup qualification,2
Germany,Austria,3,0,FIFA World Cup qualification,3
Japan,Guatemala,3,0,Friendly,3
South Korea,Haiti,4,1,Friendly,3
Lebanon,Syria,2,0,Friendly,2
Northern Ireland,Portugal,2,4,FIFA World Cup qualification,2
Norway,Cyprus,2,0,FIFA World Cup qualification,2
Paraguay,Bolivia,4,0,FIFA World Cup qualification,4
Romania,Hungary,3,0,FIFA World Cup qualification,3
Russia,Luxembourg,4,1,FIFA World Cup qualification,3
Scotland,Belgium,0,2,FIFA World Cup qualification,2
Sri Lanka,Bhutan,5,2,SAFF Cup,3
Turkey,Andorra,5,0,FIFA World Cup qualification,5
Ukraine,San Marino,9,0,FIFA World Cup qualification,9
Angola,Liberia,4,1,FIFA World Cup qualification,3
Brazil,Australia,6,0,Friendly,6
Gambia,Tanzania,2,0,FIFA World Cup qualification,2
Nigeria,Malawi,2,0,FIFA World Cup qualification,2
South Africa,Botswana,4,1,FIFA World Cup qualification,3
Tunisia,Cape Verde,3,0,FIFA World Cup qualification,3
Benin,Rwanda,2,0,FIFA World Cup qualification,2
Sudan,Lesotho,1,3,FIFA World Cup qualification,2
Saudi Arabia,Trinidad and Tobago,1,3,OSN Cup,2
United Arab Emirates,New Zealand,2,0,OSN Cup,2
Andorra,Netherlands,0,2,FIFA World Cup qualification,2
Belarus,France,2,4,FIFA World Cup qualification,2
Brazil,Portugal,3,1,Friendly,2
China PR,Malaysia,2,0,Friendly,2
Cyprus,Slovenia,0,2,FIFA World Cup qualification,2
Egypt,Guinea,4,2,FIFA World Cup qualification,2
Faroe Islands,Germany,0,3,FIFA World Cup qualification,3
Hungary,Estonia,5,1,FIFA World Cup qualification,4
Japan,Ghana,3,1,Friendly,2
Lithuania,Liechtenstein,2,0,FIFA World Cup qualification,2
Nigeria,Burkina Faso,4,1,Friendly,3
Norway,Switzerland,0,2,FIFA World Cup qualification,2
Paraguay,Argentina,2,5,FIFA World Cup qualification,3
Romania,Turkey,0,2,FIFA World Cup qualification,2
Russia,Israel,3,1,FIFA World Cup qualification,2
San Marino,Poland,1,5,FIFA World Cup qualification,4
Uruguay,Colombia,2,0,FIFA World Cup qualification,2
United States,Mexico,2,0,FIFA World Cup qualification,2
Wales,Serbia,0,3,FIFA World Cup qualification,3
Egypt,Uganda,2,0,Friendly,2
Andorra,Romania,0,4,FIFA World Cup qualification,4
Argentina,Peru,3,1,FIFA World Cup qualification,2
Azerbaijan,Northern Ireland,2,0,FIFA World Cup qualification,2
Bosnia and Herzegovina,Liechtenstein,4,1,FIFA World Cup qualification,3
England,Montenegro,4,1,FIFA World Cup qualification,3
Estonia,Turkey,0,2,FIFA World Cup qualification,2
France,Australia,6,0,Friendly,6
Germany,Republic of Ireland,3,0,FIFA World Cup qualification,3
Iceland,Cyprus,2,0,FIFA World Cup qualification,2
Lithuania,Latvia,2,0,FIFA World Cup qualification,2
Luxembourg,Russia,0,4,FIFA World Cup qualification,4
Malta,Czech Republic,1,4,FIFA World Cup qualification,3
Moldova,San Marino,3,0,FIFA World Cup qualification,3
Netherlands,Hungary,8,1,FIFA World Cup qualification,7
Serbia,Japan,2,0,Friendly,2
Slovenia,Norway,3,0,FIFA World Cup qualification,3
United States,Jamaica,2,0,FIFA World Cup qualification,2
Ivory Coast,Senegal,3,1,FIFA World Cup qualification,2
South Korea,Brazil,0,2,Friendly,2
Qatar,Yemen,6,0,AFC Asian Cup qualification,6
Australia,Canada,3,0,Friendly,3
Brazil,Zambia,2,0,Friendly,2
Denmark,Malta,6,0,FIFA World Cup qualification,6
England,Poland,2,0,FIFA World Cup qualification,2
Faroe Islands,Austria,0,3,FIFA World Cup qualification,3
France,Finland,3,0,FIFA World Cup qualification,3
Ghana,Egypt,6,1,FIFA World Cup qualification,5
Greece,Liechtenstein,2,0,FIFA World Cup qualification,2
Hong Kong,United Arab Emirates,0,4,AFC Asian Cup qualification,4
Hungary,Andorra,2,0,FIFA World Cup qualification,2
Iraq,Saudi Arabia,0,2,AFC Asian Cup qualification,2
Republic of Ireland,Kazakhstan,3,1,FIFA World Cup qualification,2
South Korea,Mali,3,1,Friendly,2
Kyrgyzstan,Tajikistan,1,4,Friendly,3
Montenegro,Moldova,2,5,FIFA World Cup qualification,3
Philippines,Pakistan,3,1,Friendly,2
Portugal,Luxembourg,3,0,FIFA World Cup qualification,3
Romania,Estonia,2,0,FIFA World Cup qualification,2
San Marino,Ukraine,0,8,FIFA World Cup qualification,8
Scotland,Croatia,2,0,FIFA World Cup qualification,2
Serbia,North Macedonia,5,1,FIFA World Cup qualification,4
Spain,Georgia,2,0,FIFA World Cup qualification,2
Sweden,Germany,3,5,FIFA World Cup qualification,2
Turkey,Netherlands,0,2,FIFA World Cup qualification,2
Uzbekistan,Vietnam,3,1,AFC Asian Cup qualification,2
Indonesia,Kyrgyzstan,4,0,Friendly,4
Kuwait,Malaysia,3,0,Friendly,3
United Arab Emirates,Philippines,4,0,Friendly,4
Jordan,Uruguay,0,5,FIFA World Cup qualification,5
Mexico,New Zealand,5,1,FIFA World Cup qualification,4
Belgium,Colombia,0,2,Friendly,2
Bonaire,Suriname,0,2,ABCS Tournament,2
Curaçao,Aruba,2,0,ABCS Tournament,2
Egypt,Zambia,2,0,Friendly,2
Czech Republic,Canada,2,0,Friendly,2
England,Chile,0,2,Friendly,2
Greece,Romania,3,1,FIFA World Cup qualification,2
Republic of Ireland,Latvia,3,0,Friendly,3
Poland,Slovakia,0,2,Friendly,2
Eswatini,South Africa,0,3,Friendly,3
Syria,Singapore,4,0,AFC Asian Cup qualification,4
Thailand,Iran,0,3,AFC Asian Cup qualification,3
Ukraine,France,2,0,FIFA World Cup qualification,2
United Arab Emirates,Hong Kong,4,0,AFC Asian Cup qualification,4
Vietnam,Uzbekistan,0,3,AFC Asian Cup qualification,3
Yemen,Qatar,1,4,AFC Asian Cup qualification,3
Curaçao,Suriname,1,3,ABCS Tournament,2
Honduras,Brazil,0,5,Friendly,5
Nigeria,Ethiopia,2,0,FIFA World Cup qualification,2
Cameroon,Tunisia,4,1,FIFA World Cup qualification,3
Luxembourg,Montenegro,1,4,Friendly,3
Argentina,Bosnia and Herzegovina,2,0,Friendly,2
Bahrain,Yemen,2,0,AFC Asian Cup qualification,2
Cambodia,Guam,0,2,Friendly,2
Croatia,Iceland,2,0,FIFA World Cup qualification,2
France,Ukraine,3,0,FIFA World Cup qualification,3
Hong Kong,Uzbekistan,0,2,AFC Asian Cup qualification,2
India,Nepal,2,0,Friendly,2
Indonesia,Iraq,0,2,AFC Asian Cup qualification,2
Kuwait,Thailand,3,1,AFC Asian Cup qualification,2
Lebanon,Iran,1,4,AFC Asian Cup qualification,3
Liechtenstein,Estonia,0,3,Friendly,3
Trinidad and Tobago,Jamaica,2,0,Friendly,2
United Arab Emirates,Vietnam,5,0,AFC Asian Cup qualification,5
New Zealand,Mexico,2,4,FIFA World Cup qualification,2
Seychelles,Maldives,3,1,Friendly,2
Burundi,Somalia,2,0,CECAFA Cup,2
Sudan,Eritrea,3,0,CECAFA Cup,3
Ethiopia,Zanzibar,3,1,CECAFA Cup,2
Kenya,South Sudan,3,1,CECAFA Cup,2
Eritrea,Uganda,0,3,CECAFA Cup,3
Kenya,Zanzibar,2,0,CECAFA Cup,2
South Sudan,Ethiopia,0,2,CECAFA Cup,2
Somalia,Zambia,0,4,CECAFA Cup,4
Ethiopia,Sudan,0,2,CECAFA Cup,2
Kenya,Sudan,2,0,CECAFA Cup,2
Basque Country,Peru,6,0,Friendly,6
Lebanon,Kuwait,0,2,WAFF Championship,2
Catalonia,Cape Verde,4,1,Friendly,3
Qatar,Saudi Arabia,4,1,WAFF Championship,3
Qatar,Kuwait,3,0,WAFF Championship,3
Qatar,Jordan,2,0,WAFF Championship,2
Zimbabwe,Gabon,2,0,Friendly,2
South Africa,Mozambique,3,1,African Nations Championship,2
Libya,Ethiopia,2,0,African Nations Championship,2
Nigeria,Mozambique,4,2,African Nations Championship,2
Norway,Poland,0,3,Friendly,3
South Africa,Nigeria,1,3,African Nations Championship,2
Morocco,Uganda,3,1,African Nations Championship,2
Iceland,Sweden,0,2,Friendly,2
Chile,Costa Rica,4,0,Friendly,4
Mauritania,Gabon,2,4,African Nations Championship,2
Mexico,South Korea,4,0,Friendly,4
United States,South Korea,2,0,Friendly,2
Singapore,Jordan,1,3,AFC Asian Cup qualification,2
Lebanon,Pakistan,3,1,Friendly,2
Iraq,North Korea,2,0,Friendly,2
Gibraltar,Faroe Islands,1,4,Friendly,3
Albania,Malta,2,0,Friendly,2
Algeria,Slovenia,2,0,Friendly,2
Andorra,Moldova,0,3,Friendly,3
Bosnia and Herzegovina,Egypt,0,2,Friendly,2
Botswana,South Sudan,3,0,Friendly,3
France,Netherlands,2,0,Friendly,2
Georgia,Liechtenstein,2,0,Friendly,2
Gibraltar,Estonia,0,2,Friendly,2
Greece,South Korea,0,2,Friendly,2
Iraq,China PR,3,1,AFC Asian Cup qualification,2
Israel,Slovakia,1,3,Friendly,2
Japan,New Zealand,4,2,Friendly,2
Malawi,Zimbabwe,1,4,Friendly,3
Oman,Singapore,3,1,AFC Asian Cup qualification,2
Portugal,Cameroon,5,1,Friendly,4
Russia,Armenia,2,0,Friendly,2
South Africa,Brazil,0,5,Friendly,5
Saint Lucia,Jamaica,0,5,Friendly,5
Thailand,Lebanon,2,5,AFC Asian Cup qualification,3
Ukraine,United States,2,0,Friendly,2
Vietnam,Hong Kong,3,1,AFC Asian Cup qualification,2
Wales,Iceland,3,1,Friendly,2
Yemen,Nepal,2,0,Friendly,2
Aruba,Guam,2,0,Friendly,2
Mauritius,Mauritania,0,2,African Cup of Nations qualification,2
Tanzania,Burundi,0,3,Friendly,3
Dominica,Grenada,3,5,Windward Islands Tournament,2
Vatican City,Monaco,0,2,Friendly,2
Malawi,Chad,2,0,African Cup of Nations qualification,2
São Tomé and Príncipe,Benin,0,2,African Cup of Nations qualification,2
Turkmenistan,Laos,5,1,AFC Challenge Cup,4
Myanmar,Palestine,0,2,AFC Challenge Cup,2
Kosovo,Turkey,1,6,Friendly,5
Liechtenstein,Belarus,1,5,Friendly,4
Maldives,Kyrgyzstan,2,0,AFC Challenge Cup,2
Afghanistan,Turkmenistan,3,1,AFC Challenge Cup,2
Laos,Philippines,0,2,AFC Challenge Cup,2
Slovakia,Montenegro,2,0,Friendly,2
Moldova,Saudi Arabia,4,0,Friendly,4
Turkmenistan,Philippines,0,2,AFC Challenge Cup,2
Kosovo,Senegal,1,3,Friendly,2
Belgium,Luxembourg,5,1,Friendly,4
North Macedonia,Cameroon,0,2,Friendly,2
France,Norway,4,0,Friendly,4
Palestine,Afghanistan,2,0,AFC Challenge Cup,2
Angola,Morocco,2,0,Friendly,2
Georgia,Saudi Arabia,2,0,Friendly,2
England,Peru,3,0,Friendly,3
French Guiana,British Virgin Islands,6,0,CFU Caribbean Cup qualification,6
Spain,Bolivia,2,0,Friendly,2
Armenia,Algeria,1,3,Friendly,2
Chad,Malawi,3,1,African Cup of Nations qualification,2
Finland,Estonia,2,0,Baltic Cup,2
Guinea-Bissau,Central African Republic,3,1,African Cup of Nations qualification,2
Mexico,Ecuador,3,1,Friendly,2
Rwanda,Libya,3,0,African Cup of Nations qualification,3
Aruba,British Virgin Islands,7,0,CFU Caribbean Cup qualification,7
Benin,São Tomé and Príncipe,2,0,African Cup of Nations qualification,2
Congo,Namibia,3,0,African Cup of Nations qualification,3
Equatorial Guinea,Mauritania,3,0,African Cup of Nations qualification,3
Honduras,Israel,2,4,Friendly,2
Lesotho,Liberia,2,0,African Cup of Nations qualification,2
Sweden,Belgium,0,2,Friendly,2
Turks and Caicos Islands,French Guiana,0,6,CFU Caribbean Cup qualification,6
Darfur,Padania,0,20,CONIFA World Football Cup,20
Costa Rica,Japan,1,3,Friendly,2
Tamil Eelam,Arameans Suryoye,0,2,CONIFA World Football Cup,2
Darfur,South Ossetia,0,19,CONIFA World Football Cup,19
Ellan Vannin,County of Nice,4,2,CONIFA World Football Cup,2
Aruba,French Guiana,0,2,CFU Caribbean Cup qualification,2
Brazil,Panama,4,0,Friendly,4
British Virgin Islands,Turks and Caicos Islands,0,2,CFU Caribbean Cup qualification,2
Switzerland,Peru,2,0,Friendly,2
Tamil Eelam,Iraqi Kurdistan,0,9,CONIFA World Football Cup,9
South Ossetia,Padania,1,3,CONIFA World Football Cup,2
Argentina,Trinidad and Tobago,3,0,Friendly,3
Netherlands,Wales,2,0,Friendly,2
Sápmi,Tamil Eelam,4,2,CONIFA World Football Cup,2
Darfur,Artsakh,0,12,CONIFA World Football Cup,12
Colombia,Jordan,3,0,Friendly,3
Germany,Armenia,6,1,Friendly,5
Russia,Morocco,2,0,Friendly,2
County of Nice,South Ossetia,3,0,CONIFA World Football Cup,3
Arameans Suryoye,Ellan Vannin,1,4,CONIFA World Football Cup,3
Argentina,Slovenia,2,0,Friendly,2
El Salvador,Spain,0,2,Friendly,2
Hungary,Kazakhstan,3,0,Friendly,3
Sápmi,Artsakh,1,5,CONIFA World Football Cup,4
Tamil Eelam,Darfur,10,0,CONIFA World Football Cup,10
France,Jamaica,8,0,Friendly,8
Iran,Trinidad and Tobago,2,0,Friendly,2
San Marino,Albania,0,3,Friendly,3
South Ossetia,Arameans Suryoye,1,4,CONIFA World Football Cup,3
Ghana,South Korea,4,0,Friendly,4
Republic of Ireland,Portugal,1,5,Friendly,4
Brazil,Croatia,3,1,FIFA World Cup,2
Chile,Australia,3,1,FIFA World Cup,2
Spain,Netherlands,1,5,FIFA World Cup,4
Colombia,Greece,3,0,FIFA World Cup,3
Uruguay,Costa Rica,1,3,FIFA World Cup,2
France,Honduras,3,0,FIFA World Cup,3
Germany,Portugal,4,0,FIFA World Cup,4
Cameroon,Croatia,0,4,FIFA World Cup,4
China PR,North Macedonia,2,0,Friendly,2
Spain,Chile,0,2,FIFA World Cup,2
Switzerland,France,2,5,FIFA World Cup,3
Indonesia,Pakistan,4,0,Friendly,4
South Korea,Algeria,2,4,FIFA World Cup,2
Australia,Spain,0,3,FIFA World Cup,3
Brazil,Cameroon,4,1,FIFA World Cup,3
Croatia,Mexico,1,3,FIFA World Cup,2
Netherlands,Chile,2,0,FIFA World Cup,2
Japan,Colombia,1,4,FIFA World Cup,3
Bosnia and Herzegovina,Iran,3,1,FIFA World Cup,2
Honduras,Switzerland,0,3,FIFA World Cup,3
Indonesia,Nepal,2,0,Friendly,2
Colombia,Uruguay,2,0,FIFA World Cup,2
China PR,Mali,1,3,Friendly,2
France,Nigeria,2,0,FIFA World Cup,2
Vietnam,Myanmar,6,0,Friendly,6
Brazil,Germany,1,7,FIFA World Cup,6
Brazil,Netherlands,0,3,FIFA World Cup,3
Botswana,Lesotho,2,0,Friendly,2
Botswana,Guinea-Bissau,2,0,African Cup of Nations qualification,2
Sierra Leone,Seychelles,2,0,African Cup of Nations qualification,2
Uganda,Mauritania,2,0,African Cup of Nations qualification,2
Congo,Rwanda,2,0,African Cup of Nations qualification,2
Mongolia,Northern Mariana Islands,4,0,EAFF Championship,4
Guam,Mongolia,2,0,EAFF Championship,2
Guam,Northern Mariana Islands,5,0,EAFF Championship,5
Rwanda,Congo,2,0,African Cup of Nations qualification,2
Tajikistan,Malaysia,4,1,Friendly,3
Guatemala,Nicaragua,3,0,Friendly,3
British Virgin Islands,Saint Martin,2,4,Friendly,2
Panama,Cuba,4,0,Friendly,4
Saint Lucia,Martinique,0,2,Friendly,2
Seychelles,Sri Lanka,3,0,Friendly,3
El Salvador,Dominican Republic,2,0,Friendly,2
Zambia,Sudan,3,1,Friendly,2
Niger,Uganda,2,0,Friendly,2
Myanmar,Palestine,4,1,Friendly,3
Costa Rica,Nicaragua,3,0,UNCAF Cup,3
Germany,Argentina,2,4,Friendly,2
Republic of Ireland,Oman,2,0,Friendly,2
Latvia,Armenia,2,0,Friendly,2
Philippines,Taiwan,5,1,Friendly,4
Russia,Azerbaijan,4,0,Friendly,4
Belarus,Tajikistan,6,1,Friendly,5
Belgium,Australia,2,0,Friendly,2
Bosnia and Herzegovina,Liechtenstein,3,0,Friendly,3
China PR,Kuwait,3,1,Friendly,2
Croatia,Cyprus,2,0,Friendly,2
Iraq,Peru,0,2,Friendly,2
Italy,Netherlands,2,0,Friendly,2
Sweden,Estonia,2,0,Friendly,2
Uzbekistan,Jordan,2,0,Friendly,2
Japan,Uruguay,0,2,Kirin Challenge Cup,2
Kazakhstan,Kyrgyzstan,7,1,Friendly,6
South Korea,Venezuela,3,1,Friendly,2
Senegal,Egypt,2,0,African Cup of Nations qualification,2
Saint Kitts and Nevis,Dominica,5,0,CFU Caribbean Cup qualification,5
Saint Lucia,Guyana,2,0,CFU Caribbean Cup qualification,2
Saint Vincent and the Grenadines,Anguilla,4,0,CFU Caribbean Cup qualification,4
Sudan,South Africa,0,3,African Cup of Nations qualification,3
Burkina Faso,Lesotho,2,0,African Cup of Nations qualification,2
DR Congo,Cameroon,0,2,African Cup of Nations qualification,2
Niger,Cape Verde,1,3,African Cup of Nations qualification,2
Palestine,Taiwan,7,3,Friendly,4
Vietnam,Hong Kong,3,1,Friendly,2
Bonaire,Barbados,1,4,CFU Caribbean Cup qualification,3
Burundi,Tanzania,2,0,Friendly,2
Faroe Islands,Finland,1,3,UEFA Euro qualification,2
Gibraltar,Poland,0,7,UEFA Euro qualification,7
Mali,Malawi,2,0,African Cup of Nations qualification,2
Morocco,Libya,3,0,Friendly,3
Montenegro,Moldova,2,0,UEFA Euro qualification,2
Russia,Liechtenstein,4,0,UEFA Euro qualification,4
San Marino,Lithuania,0,2,UEFA Euro qualification,2
Spain,North Macedonia,5,1,UEFA Euro qualification,4
Switzerland,England,0,2,UEFA Euro qualification,2
Uzbekistan,New Zealand,3,1,Friendly,2
Croatia,Malta,2,0,UEFA Euro qualification,2
Iceland,Turkey,3,0,UEFA Euro qualification,3
Norway,Italy,0,2,UEFA Euro qualification,2
Qatar,Peru,0,2,Friendly,2
Angola,Burkina Faso,0,3,African Cup of Nations qualification,3
Botswana,Senegal,0,2,African Cup of Nations qualification,2
Cameroon,Ivory Coast,4,1,African Cup of Nations qualification,3
Congo,Sudan,2,0,African Cup of Nations qualification,2
DR Congo,Sierra Leone,2,0,African Cup of Nations qualification,2
Uganda,Guinea,2,0,African Cup of Nations qualification,2
Indonesia,Malaysia,2,0,Friendly,2
Malaysia,Cambodia,4,1,Friendly,3
Qatar,Uzbekistan,3,0,Friendly,3
Trinidad and Tobago,Dominican Republic,6,1,CFU Caribbean Cup qualification,5
Belarus,Ukraine,0,2,UEFA Euro qualification,2
England,San Marino,5,0,UEFA Euro qualification,5
Morocco,Central African Republic,4,0,Friendly,4
Qatar,Lebanon,5,0,Friendly,5
Belgium,Andorra,6,0,UEFA Euro qualification,6
Botswana,Egypt,0,2,African Cup of Nations qualification,2
China PR,Thailand,3,0,Friendly,3
South Korea,Paraguay,2,0,Friendly,2
Latvia,Iceland,0,3,UEFA Euro qualification,3
Malta,Norway,0,3,UEFA Euro qualification,3
Netherlands,Kazakhstan,3,1,UEFA Euro qualification,2
Trinidad and Tobago,Saint Lucia,2,0,CFU Caribbean Cup qualification,2
Argentina,Brazil,0,2,Superclásico de las Américas,2
Congo,South Africa,0,2,African Cup of Nations qualification,2
Ethiopia,Mali,0,2,African Cup of Nations qualification,2
Gabon,Burkina Faso,2,0,African Cup of Nations qualification,2
Republic of Ireland,Gibraltar,7,0,UEFA Euro qualification,7
Malawi,Algeria,0,2,African Cup of Nations qualification,2
Mozambique,Cape Verde,2,0,African Cup of Nations qualification,2
Northern Ireland,Faroe Islands,2,0,UEFA Euro qualification,2
Poland,Germany,2,0,UEFA Euro qualification,2
Barbados,French Guiana,0,2,CFU Caribbean Cup qualification,2
Belarus,Slovakia,1,3,UEFA Euro qualification,2
Timor-Leste,Brunei,4,2,AFF Championship,2
Lithuania,Slovenia,0,2,UEFA Euro qualification,2
Luxembourg,Spain,0,4,UEFA Euro qualification,4
Pakistan,Palestine,0,2,Friendly,2
Philippines,Papua New Guinea,5,0,Friendly,5
Sweden,Liechtenstein,2,0,UEFA Euro qualification,2
Tanzania,Benin,4,1,Friendly,3
Andorra,Israel,1,4,UEFA Euro qualification,3
Croatia,Azerbaijan,6,0,UEFA Euro qualification,6
Iceland,Netherlands,2,0,UEFA Euro qualification,2
Kazakhstan,Czech Republic,2,4,UEFA Euro qualification,2
Morocco,Kenya,3,0,Friendly,3
Oman,Uruguay,0,3,Friendly,3
Armenia,France,0,3,Friendly,3
Finland,Romania,0,2,UEFA Euro qualification,2
Gibraltar,Georgia,0,3,UEFA Euro qualification,3
Greece,Northern Ireland,0,2,UEFA Euro qualification,2
Hong Kong,Argentina,0,7,Friendly,7
Japan,Brazil,0,4,Friendly,4
South Korea,Costa Rica,1,3,Friendly,2
Laos,Brunei,4,2,AFF Championship,2
San Marino,Switzerland,0,4,UEFA Euro qualification,4
Serbia,Albania,0,3,UEFA Euro qualification,3
United Arab Emirates,Uzbekistan,0,4,Friendly,4
Algeria,Malawi,3,0,African Cup of Nations qualification,3
Angola,Lesotho,4,0,African Cup of Nations qualification,4
Cameroon,Sierra Leone,2,0,African Cup of Nations qualification,2
Egypt,Botswana,2,0,African Cup of Nations qualification,2
Ghana,Guinea,3,1,African Cup of Nations qualification,2
Nigeria,Sudan,3,1,African Cup of Nations qualification,2
Eswatini,Zimbabwe,0,2,Friendly,2
Zambia,Niger,3,0,African Cup of Nations qualification,3
Brunei,Myanmar,1,3,AFF Championship,2
Laos,Timor-Leste,2,0,AFF Championship,2
Philippines,Nepal,3,0,Friendly,3
Qatar,North Korea,3,1,Friendly,2
Saudi Arabia,Palestine,2,0,Friendly,2
Bahrain,Singapore,2,0,Friendly,2
Oman,Yemen,2,0,Friendly,2
Thailand,Philippines,3,0,Friendly,3
Uganda,Ethiopia,3,0,Friendly,3
Vietnam,Palestine,1,3,Friendly,2
Belgium,Iceland,3,1,Friendly,2
Turkey,Brazil,0,4,Friendly,4
Morocco,Benin,6,1,Friendly,5
Singapore,Laos,2,0,Friendly,2
Trinidad and Tobago,French Guiana,4,2,CFU Caribbean Cup,2
Georgia,Poland,0,4,UEFA Euro qualification,4
Germany,Gibraltar,4,0,UEFA Euro qualification,4
Ivory Coast,Sierra Leone,5,1,African Cup of Nations qualification,4
Japan,Honduras,6,0,Friendly,6
Martinique,Haiti,0,3,CFU Caribbean Cup,3
Philippines,Cambodia,3,0,Friendly,3
Romania,Northern Ireland,2,0,UEFA Euro qualification,2
Serbia,Denmark,1,3,UEFA Euro qualification,2
Algeria,Ethiopia,3,1,African Cup of Nations qualification,2
Cape Verde,Niger,3,1,African Cup of Nations qualification,2
Congo,Nigeria,0,2,African Cup of Nations qualification,2
England,Slovenia,3,1,UEFA Euro qualification,2
French Guiana,Curaçao,4,1,CFU Caribbean Cup,3
Indonesia,Syria,0,2,Friendly,2
Luxembourg,Ukraine,0,3,UEFA Euro qualification,3
North Macedonia,Slovakia,0,2,UEFA Euro qualification,2
Malawi,Mali,2,0,African Cup of Nations qualification,2
Spain,Belarus,3,0,UEFA Euro qualification,3
Switzerland,Lithuania,4,0,UEFA Euro qualification,4
Togo,Guinea,1,4,African Cup of Nations qualification,3
Antigua and Barbuda,Martinique,0,2,CFU Caribbean Cup,2
Cyprus,Andorra,5,0,UEFA Euro qualification,5
Guam,North Korea,1,5,EAFF Championship,4
Israel,Bosnia and Herzegovina,3,0,UEFA Euro qualification,3
Netherlands,Latvia,6,0,UEFA Euro qualification,6
Saudi Arabia,Bahrain,3,0,Gulf Cup,3
Turkey,Kazakhstan,3,1,UEFA Euro qualification,2
Vietnam,Malaysia,3,1,Friendly,2
Singapore,Cambodia,4,2,Friendly,2
Greece,Serbia,0,2,Friendly,2
Republic of Ireland,United States,4,1,Friendly,3
Nicaragua,El Salvador,0,2,Friendly,2
Romania,Denmark,2,0,Friendly,2
Scotland,England,1,3,Friendly,2
Thailand,New Zealand,2,0,Friendly,2
DR Congo,Sierra Leone,3,1,African Cup of Nations qualification,2
Gabon,Lesotho,4,2,African Cup of Nations qualification,2
Ghana,Togo,3,1,African Cup of Nations qualification,2
Guinea,Uganda,2,0,African Cup of Nations qualification,2
Mali,Algeria,2,0,African Cup of Nations qualification,2
Senegal,Botswana,3,0,African Cup of Nations qualification,3
Kuwait,Oman,0,5,Gulf Cup,5
United Arab Emirates,Iraq,2,0,Gulf Cup,2
Philippines,Laos,4,1,AFF Championship,3
Oman,Qatar,1,3,Gulf Cup,2
Philippines,Indonesia,4,0,AFF Championship,4
Vietnam,Laos,3,0,AFF Championship,3
Singapore,Myanmar,4,2,AFF Championship,2
Indonesia,Laos,5,1,AFF Championship,4
Vietnam,Philippines,3,1,AFF Championship,2
Singapore,Malaysia,1,3,AFF Championship,2
Thailand,Myanmar,2,0,AFF Championship,2
South Africa,Ivory Coast,2,0,Friendly,2
Thailand,Philippines,3,0,AFF Championship,3
Vietnam,Malaysia,2,4,AFF Championship,2
Thailand,Malaysia,2,0,AFF Championship,2
Qatar,Estonia,3,0,Friendly,3
Bahrain,Saudi Arabia,4,1,Friendly,3
South Korea,Saudi Arabia,2,0,Friendly,2
China PR,Oman,4,1,Friendly,3
Australia,Kuwait,4,1,AFC Asian Cup,3
Burkina Faso,Eswatini,5,1,Friendly,4
Iran,Bahrain,2,0,AFC Asian Cup,2
United Arab Emirates,Qatar,4,1,AFC Asian Cup,3
Japan,Palestine,4,0,AFC Asian Cup,4
Australia,Oman,4,0,AFC Asian Cup,4
Botswana,Burkina Faso,0,2,Friendly,2
Senegal,Guinea,5,2,Friendly,3
North Korea,Saudi Arabia,1,4,AFC Asian Cup,3
Mali,South Africa,0,3,Friendly,3
Sweden,Ivory Coast,2,0,Friendly,2
Palestine,Jordan,1,5,AFC Asian Cup,4
Burkina Faso,Gabon,0,2,African Cup of Nations,2
Yemen,Nigeria,0,2,Friendly,2
Uzbekistan,Saudi Arabia,3,1,AFC Asian Cup,2
Algeria,South Africa,3,1,African Cup of Nations,2
Iraq,Palestine,2,0,AFC Asian Cup,2
Japan,Jordan,2,0,AFC Asian Cup,2
Australia,China PR,2,0,AFC Asian Cup,2
South Korea,Uzbekistan,2,0,AFC Asian Cup,2
Equatorial Guinea,Gabon,2,0,African Cup of Nations,2
South Korea,Iraq,2,0,AFC Asian Cup,2
Australia,United Arab Emirates,2,0,AFC Asian Cup,2
Senegal,Algeria,0,2,African Cup of Nations,2
Suriname,Bonaire,3,0,ABCS Tournament,3
Congo,DR Congo,2,4,African Cup of Nations,2
Curaçao,Bonaire,4,1,ABCS Tournament,3
Ghana,Guinea,3,0,African Cup of Nations,3
Ivory Coast,Algeria,3,1,African Cup of Nations,2
DR Congo,Ivory Coast,1,3,African Cup of Nations,2
Equatorial Guinea,Ghana,0,3,African Cup of Nations,3
United States,Panama,2,0,Friendly,2
Antigua and Barbuda,United States Virgin Islands,2,0,Friendly,2
Bermuda,Grenada,2,0,Friendly,2
Cambodia,Macau,3,0,FIFA World Cup qualification,3
Timor-Leste,Mongolia,0,3,FIFA World Cup qualification,3
India,Nepal,2,0,FIFA World Cup qualification,2
Yemen,Pakistan,3,1,FIFA World Cup qualification,2
Brunei,Taiwan,0,2,FIFA World Cup qualification,2
Mongolia,Timor-Leste,3,0,FIFA World Cup qualification,3
Nicaragua,Anguilla,5,0,FIFA World Cup qualification,5
Saint Kitts and Nevis,Turks and Caicos Islands,6,2,FIFA World Cup qualification,4
Botswana,Lesotho,2,0,Friendly,2
Dominican Republic,Cuba,0,3,Friendly,3
French Guiana,Honduras,3,1,Gold Cup qualification,2
Georgia,Malta,2,0,Friendly,2
Eswatini,South Africa,1,3,Friendly,2
Bahamas,Bermuda,0,5,FIFA World Cup qualification,5
Bahrain,Colombia,0,6,Friendly,6
Chile,Iran,0,2,Friendly,2
Egypt,Equatorial Guinea,2,0,Friendly,2
France,Brazil,1,3,Friendly,2
Ivory Coast,Angola,2,0,Friendly,2
Maldives,Tajikistan,0,2,Friendly,2
Oman,Malaysia,6,0,Friendly,6
Thailand,Singapore,2,0,Friendly,2
United States Virgin Islands,Barbados,0,4,FIFA World Cup qualification,4
Turks and Caicos Islands,Saint Kitts and Nevis,2,6,FIFA World Cup qualification,4
England,Lithuania,4,0,UEFA Euro qualification,4
Japan,Tunisia,2,0,Kirin Challenge Cup,2
Liechtenstein,Austria,0,5,UEFA Euro qualification,5
Moldova,Sweden,0,2,UEFA Euro qualification,2
Slovakia,Luxembourg,3,0,UEFA Euro qualification,3
Slovenia,San Marino,6,0,UEFA Euro qualification,6
Switzerland,Estonia,3,0,UEFA Euro qualification,3
Argentina,El Salvador,2,0,Friendly,2
Andorra,Bosnia and Herzegovina,0,3,UEFA Euro qualification,3
Azerbaijan,Malta,2,0,UEFA Euro qualification,2
Belgium,Cyprus,5,0,UEFA Euro qualification,5
Croatia,Norway,5,1,UEFA Euro qualification,4
Israel,Wales,0,3,UEFA Euro qualification,3
Kazakhstan,Iceland,0,3,UEFA Euro qualification,3
Anguilla,Nicaragua,0,3,FIFA World Cup qualification,3
Bermuda,Bahamas,3,0,FIFA World Cup qualification,3
France,Denmark,2,0,Friendly,2
Georgia,Germany,0,2,UEFA Euro qualification,2
Guyana,Grenada,2,0,Friendly,2
Honduras,French Guiana,3,0,Gold Cup qualification,3
Scotland,Gibraltar,6,1,UEFA Euro qualification,5
Zambia,Rwanda,2,0,Friendly,2
Jamaica,Cuba,3,0,Friendly,3
Kuwait,Colombia,1,3,Friendly,2
Oman,Algeria,1,4,Friendly,3
Japan,Uzbekistan,5,1,Friendly,4
Mauritania,Niger,2,0,Friendly,2
Netherlands,Spain,2,0,Friendly,2
Portugal,Cape Verde,0,2,Friendly,2
Sweden,Iran,3,1,Friendly,2
United States,Mexico,2,0,Friendly,2
Barbados,Saint Kitts and Nevis,1,3,Friendly,2
Zambia,Malawi,2,0,Friendly,2
Dominican Republic,Cayman Islands,6,0,Friendly,6
Saint Lucia,Grenada,0,2,Windward Islands Tournament,2
Zimbabwe,Mauritius,2,0,COSAFA Cup,2
Namibia,Mauritius,2,0,COSAFA Cup,2
Lesotho,Eswatini,0,2,COSAFA Cup,2
Madagascar,Tanzania,2,0,COSAFA Cup,2
Namibia,Zimbabwe,4,1,COSAFA Cup,3
Zambia,Ghana,3,0,COSAFA Cup,3
Laos,Afghanistan,0,2,Friendly,2
Mexico,Guatemala,3,0,Friendly,3
Namibia,Mozambique,2,0,COSAFA Cup,2
El Salvador,Honduras,0,2,Friendly,2
Hungary,Lithuania,4,0,Friendly,4
Argentina,Bolivia,5,0,Friendly,5
Ecuador,Panama,4,0,Friendly,4
Singapore,Brunei,5,1,Friendly,4
Uruguay,Guatemala,5,1,Friendly,4
Brazil,Mexico,2,0,Friendly,2
Croatia,Gibraltar,4,0,Friendly,4
Kenya,South Sudan,2,0,Friendly,2
Russia,Belarus,4,2,Friendly,2
Rwanda,Tanzania,2,0,Friendly,2
Serbia,Azerbaijan,4,1,Friendly,3
Malta,Lithuania,2,0,Friendly,2
Turkey,Bulgaria,4,0,Friendly,4
Finland,Estonia,0,2,Friendly,2
Switzerland,Liechtenstein,3,0,Friendly,3
Antigua and Barbuda,Saint Lucia,1,3,FIFA World Cup qualification,2
Aruba,Barbados,0,2,FIFA World Cup qualification,2
Afghanistan,Syria,0,6,FIFA World Cup qualification,6
Bangladesh,Kyrgyzstan,1,3,FIFA World Cup qualification,2
Cambodia,Singapore,0,4,FIFA World Cup qualification,4
Chile,Ecuador,2,0,Copa América,2
Hong Kong,Bhutan,7,0,FIFA World Cup qualification,7
Japan,Iraq,4,0,Kirin Challenge Cup,4
South Korea,United Arab Emirates,3,0,Friendly,3
Malaysia,Timor-Leste,3,0,FIFA World Cup qualification,3
Tajikistan,Jordan,1,3,FIFA World Cup qualification,2
Yemen,North Korea,0,3,FIFA World Cup qualification,3
Dominica,Canada,0,2,FIFA World Cup qualification,2
Andorra,Cyprus,1,3,UEFA Euro qualification,2
Bosnia and Herzegovina,Israel,3,1,UEFA Euro qualification,2
Latvia,Netherlands,0,2,UEFA Euro qualification,2
Tunisia,Djibouti,8,1,African Cup of Nations qualification,7
Algeria,Seychelles,4,0,African Cup of Nations qualification,4
Angola,Central African Republic,4,0,African Cup of Nations qualification,4
Burkina Faso,Comoros,2,0,African Cup of Nations qualification,2
Cape Verde,São Tomé and Príncipe,7,1,African Cup of Nations qualification,6
Denmark,Serbia,2,0,UEFA Euro qualification,2
Gibraltar,Germany,0,7,UEFA Euro qualification,7
Mali,South Sudan,2,0,African Cup of Nations qualification,2
Nigeria,Chad,2,0,African Cup of Nations qualification,2
Poland,Georgia,4,0,UEFA Euro qualification,4
Senegal,Burundi,3,1,African Cup of Nations qualification,2
Uganda,Botswana,2,0,African Cup of Nations qualification,2
Barbados,Aruba,0,3,FIFA World Cup qualification,3
Egypt,Tanzania,3,0,African Cup of Nations qualification,3
Estonia,San Marino,2,0,UEFA Euro qualification,2
Ghana,Mauritius,7,1,African Cup of Nations qualification,6
Sweden,Montenegro,3,1,UEFA Euro qualification,2
Ukraine,Luxembourg,3,0,UEFA Euro qualification,3
Belize,Dominican Republic,3,0,FIFA World Cup qualification,3
Antigua and Barbuda,Saint Lucia,4,1,FIFA World Cup qualification,3
Bhutan,China PR,0,6,FIFA World Cup qualification,6
Myanmar,South Korea,0,2,FIFA World Cup qualification,2
Timor-Leste,United Arab Emirates,0,3,FIFA World Cup qualification,3
Grenada,Puerto Rico,2,0,FIFA World Cup qualification,2
Hong Kong,Maldives,2,0,FIFA World Cup qualification,2
Jordan,Trinidad and Tobago,3,0,Friendly,3
North Korea,Uzbekistan,4,2,FIFA World Cup qualification,2
Laos,Lebanon,0,2,FIFA World Cup qualification,2
Malaysia,Palestine,0,6,FIFA World Cup qualification,6
Suriname,Nicaragua,1,3,FIFA World Cup qualification,2
Yemen,Philippines,0,2,FIFA World Cup qualification,2
Canada,Dominica,4,0,FIFA World Cup qualification,4
El Salvador,Saint Kitts and Nevis,4,1,FIFA World Cup qualification,3
Taiwan,Thailand,0,2,FIFA World Cup qualification,2
Székely Land,Felvidék,1,3,CONIFA European Football Cup,2
Romani people,Ellan Vannin,1,3,CONIFA European Football Cup,2
Chile,Bolivia,5,0,Copa América,5
Felvidék,County of Nice,1,4,CONIFA European Football Cup,3
Székely Land,Romani people,2,4,CONIFA European Football Cup,2
Mozambique,Seychelles,5,1,African Nations Championship,4
Senegal,Gambia,3,1,African Nations Championship,2
South Africa,Mauritius,3,0,African Nations Championship,3
Tanzania,Uganda,0,3,African Nations Championship,3
County of Nice,Ellan Vannin,3,1,CONIFA European Football Cup,2
Padania,Felvidék,5,0,CONIFA European Football Cup,5
Ethiopia,Kenya,2,0,African Nations Championship,2
Morocco,Libya,3,0,African Nations Championship,3
Zimbabwe,Comoros,2,0,African Nations Championship,2
County of Nice,Padania,1,4,CONIFA European Football Cup,3
Guinea,Liberia,3,1,African Nations Championship,2
Bolivia,Peru,1,3,Copa América,2
Ynys Môn,Guernsey,2,5,Island Games,3
Western Isles,Isle of Man,0,9,Island Games,9
Jersey,Alderney,6,0,Island Games,6
Isle of Man,Alderney,7,0,Island Games,7
Jersey,Western Isles,3,0,Island Games,3
Åland Islands,Greenland,0,2,Island Games,2
Menorca,Saare County,3,0,Island Games,3
Guernsey,Gotland,3,0,Island Games,3
Isle of Wight,Falkland Islands,3,0,Island Games,3
Hitra,Shetland,1,4,Island Games,3
Argentina,Paraguay,6,1,Copa América,5
Åland Islands,Menorca,1,3,Island Games,2
Gibraltar,Guernsey,0,4,Island Games,4
Isle of Wight,Hitra,3,1,Island Games,2
Falkland Islands,Shetland,0,5,Island Games,5
Hitra,Alderney,5,1,Island Games,4
Shetland,Isle of Man,1,3,Island Games,2
Peru,Paraguay,2,0,Copa América,2
Guernsey,Isle of Man,3,0,Island Games,3
Angola,Eswatini,2,0,African Nations Championship,2
Mexico,Cuba,6,0,Gold Cup,6
Trinidad and Tobago,Guatemala,3,1,Gold Cup,2
Trinidad and Tobago,Cuba,2,0,Gold Cup,2
United States,Cuba,6,0,Gold Cup,6
Jamaica,Mexico,1,3,Gold Cup,2
China PR,South Korea,0,2,EAFF Championship,2
China PR,North Korea,2,0,EAFF Championship,2
Fiji,Tonga,5,0,Friendly,5
Cambodia,Bhutan,2,0,Friendly,2
Fiji,American Samoa,6,0,Friendly,6
Qatar,Singapore,4,0,Friendly,4
Rwanda,Ethiopia,3,1,Friendly,2
Tonga,Cook Islands,0,3,FIFA World Cup qualification,3
Australia,Bangladesh,5,0,FIFA World Cup qualification,5
Belgium,Bosnia and Herzegovina,3,1,UEFA Euro qualification,2
Iran,Guam,6,0,FIFA World Cup qualification,6
Iraq,Taiwan,5,1,FIFA World Cup qualification,4
Israel,Andorra,4,0,UEFA Euro qualification,4
Japan,Cambodia,3,0,FIFA World Cup qualification,3
South Korea,Laos,8,0,FIFA World Cup qualification,8
Kuwait,Myanmar,9,0,FIFA World Cup qualification,9
Oman,Turkmenistan,3,1,FIFA World Cup qualification,2
Philippines,Maldives,2,0,Friendly,2
Qatar,Bhutan,15,0,FIFA World Cup qualification,15
Saudi Arabia,Timor-Leste,7,0,FIFA World Cup qualification,7
Thailand,Afghanistan,2,0,Friendly,2
United Arab Emirates,Malaysia,10,0,FIFA World Cup qualification,10
American Samoa,Cook Islands,2,0,FIFA World Cup qualification,2
Djibouti,Togo,0,2,African Cup of Nations qualification,2
Faroe Islands,Northern Ireland,1,3,UEFA Euro qualification,2
Germany,Poland,3,1,UEFA Euro qualification,2
Gibraltar,Republic of Ireland,0,4,UEFA Euro qualification,4
Grenada,Haiti,1,3,FIFA World Cup qualification,2
Serbia,Armenia,2,0,UEFA Euro qualification,2
Tonga,Samoa,0,3,FIFA World Cup qualification,3
Venezuela,Honduras,0,3,Friendly,3
Canada,Belize,3,0,FIFA World Cup qualification,3
Saint Vincent and the Grenadines,Aruba,2,0,FIFA World Cup qualification,2
Argentina,Bolivia,7,0,Friendly,7
Gabon,Sudan,4,0,Friendly,4
Guinea-Bissau,Congo,2,4,African Cup of Nations qualification,2
Mauritania,South Africa,3,1,African Cup of Nations qualification,2
Montenegro,Liechtenstein,2,0,UEFA Euro qualification,2
Namibia,Senegal,0,2,African Cup of Nations qualification,2
San Marino,England,0,6,UEFA Euro qualification,6
São Tomé and Príncipe,Morocco,0,3,African Cup of Nations qualification,3
Spain,Slovakia,2,0,UEFA Euro qualification,2
Ukraine,Belarus,3,1,UEFA Euro qualification,2
Bosnia and Herzegovina,Andorra,3,0,UEFA Euro qualification,3
Central African Republic,DR Congo,2,0,African Cup of Nations qualification,2
Chad,Egypt,1,5,African Cup of Nations qualification,4
Lesotho,Algeria,1,3,African Cup of Nations qualification,2
Norway,Croatia,2,0,UEFA Euro qualification,2
Turkey,Netherlands,3,0,UEFA Euro qualification,3
Poland,Gibraltar,8,1,UEFA Euro qualification,7
United States,Brazil,1,4,Friendly,3
Afghanistan,Japan,0,6,FIFA World Cup qualification,6
Bangladesh,Jordan,0,4,FIFA World Cup qualification,4
Belarus,Luxembourg,2,0,UEFA Euro qualification,2
Cambodia,Syria,0,6,FIFA World Cup qualification,6
China PR,Maldives,3,0,FIFA World Cup qualification,3
Ecuador,Honduras,2,0,Friendly,2
England,Switzerland,2,0,UEFA Euro qualification,2
India,Iran,0,3,FIFA World Cup qualification,3
Laos,Kuwait,0,2,FIFA World Cup qualification,2
Lebanon,South Korea,0,3,FIFA World Cup qualification,3
Liechtenstein,Russia,0,7,UEFA Euro qualification,7
Malaysia,Saudi Arabia,0,3,FIFA World Cup qualification,3
Moldova,Montenegro,0,2,UEFA Euro qualification,2
Nigeria,Niger,2,0,Friendly,2
Philippines,Uzbekistan,1,5,FIFA World Cup qualification,4
Sweden,Austria,1,4,UEFA Euro qualification,3
Tajikistan,Australia,0,3,FIFA World Cup qualification,3
Yemen,Bahrain,0,4,FIFA World Cup qualification,4
Guatemala,Antigua and Barbuda,2,0,FIFA World Cup qualification,2
Haiti,Grenada,3,0,FIFA World Cup qualification,3
Nicaragua,Jamaica,0,2,FIFA World Cup qualification,2
Jordan,Iraq,3,0,Friendly,3
Mauritius,Kenya,2,5,FIFA World Cup qualification,3
Tanzania,Malawi,2,0,FIFA World Cup qualification,2
Albania,Serbia,0,2,UEFA Euro qualification,2
Argentina,Ecuador,0,2,FIFA World Cup qualification,2
Bahrain,Uzbekistan,0,4,FIFA World Cup qualification,4
Bolivia,Uruguay,0,2,FIFA World Cup qualification,2
Myanmar,Lebanon,0,2,FIFA World Cup qualification,2
Chile,Brazil,2,0,FIFA World Cup qualification,2
Colombia,Peru,2,0,FIFA World Cup qualification,2
Timor-Leste,Palestine,0,3,FIFA World Cup qualification,3
France,Armenia,4,0,Friendly,4
Georgia,Gibraltar,4,0,UEFA Euro qualification,4
Jordan,Australia,2,0,FIFA World Cup qualification,2
Laos,Malaysia,1,3,Friendly,2
Nigeria,DR Congo,0,2,Friendly,2
Northern Ireland,Greece,3,1,UEFA Euro qualification,2
Syria,Japan,0,3,FIFA World Cup qualification,3
Burkina Faso,Mali,1,4,Friendly,3
Djibouti,Eswatini,0,6,FIFA World Cup qualification,6
England,Estonia,2,0,UEFA Euro qualification,2
Liechtenstein,Sweden,0,2,UEFA Euro qualification,2
North Macedonia,Ukraine,0,2,UEFA Euro qualification,2
Somalia,Niger,0,2,FIFA World Cup qualification,2
Spain,Luxembourg,4,0,UEFA Euro qualification,4
Switzerland,San Marino,7,0,UEFA Euro qualification,7
Andorra,Belgium,1,4,UEFA Euro qualification,3
Azerbaijan,Italy,1,3,UEFA Euro qualification,2
Bosnia and Herzegovina,Wales,2,0,UEFA Euro qualification,2
Croatia,Bulgaria,3,0,UEFA Euro qualification,3
Czech Republic,Turkey,0,2,UEFA Euro qualification,2
Eritrea,Botswana,0,2,FIFA World Cup qualification,2
Kosovo,Equatorial Guinea,2,0,Friendly,2
Madagascar,Central African Republic,3,0,FIFA World Cup qualification,3
Norway,Malta,2,0,UEFA Euro qualification,2
Armenia,Albania,0,3,UEFA Euro qualification,3
Egypt,Zambia,3,0,Friendly,3
Ethiopia,São Tomé and Príncipe,3,0,FIFA World Cup qualification,3
Faroe Islands,Romania,0,3,UEFA Euro qualification,3
Gibraltar,Scotland,0,6,UEFA Euro qualification,6
Nigeria,Cameroon,3,0,Friendly,3
Austria,Liechtenstein,3,0,UEFA Euro qualification,3
Lithuania,England,0,3,UEFA Euro qualification,3
Luxembourg,Slovakia,2,4,UEFA Euro qualification,2
Russia,Montenegro,2,0,UEFA Euro qualification,2
San Marino,Slovenia,0,2,UEFA Euro qualification,2
Sweden,Moldova,2,0,UEFA Euro qualification,2
Bahrain,Philippines,2,0,FIFA World Cup qualification,2
Belgium,Israel,3,1,UEFA Euro qualification,2
Botswana,Eritrea,3,1,FIFA World Cup qualification,2
Brazil,Venezuela,3,1,FIFA World Cup qualification,2
Bulgaria,Azerbaijan,2,0,UEFA Euro qualification,2
Myanmar,Laos,3,1,FIFA World Cup qualification,2
Burundi,Seychelles,2,0,FIFA World Cup qualification,2
Timor-Leste,Malaysia,0,3,FIFA World Cup qualification,3
Ecuador,Bolivia,2,0,FIFA World Cup qualification,2
Guinea-Bissau,Liberia,1,3,FIFA World Cup qualification,2
Jordan,Tajikistan,3,0,FIFA World Cup qualification,3
South Korea,Jamaica,3,0,Friendly,3
Kyrgyzstan,Bangladesh,2,0,FIFA World Cup qualification,2
Mauritania,South Sudan,4,0,FIFA World Cup qualification,4
Niger,Somalia,4,0,FIFA World Cup qualification,4
Oman,India,3,0,FIFA World Cup qualification,3
Qatar,Maldives,4,0,FIFA World Cup qualification,4
Syria,Afghanistan,5,2,FIFA World Cup qualification,3
Uruguay,Colombia,3,0,FIFA World Cup qualification,3
Vietnam,Thailand,0,3,FIFA World Cup qualification,3
Wales,Andorra,2,0,UEFA Euro qualification,2
Niger,Togo,2,0,African Nations Championship,2
Nigeria,Burkina Faso,2,0,African Nations Championship,2
South Africa,Angola,0,2,African Nations Championship,2
Uganda,Sudan,2,0,African Nations Championship,2
Zambia,Mozambique,3,0,African Nations Championship,3
Zimbabwe,Lesotho,3,1,African Nations Championship,2
Libya,Morocco,0,4,African Nations Championship,4
Senegal,Guinea,3,1,African Nations Championship,2
Ethiopia,Burundi,3,0,African Nations Championship,3
Sudan,Uganda,0,2,African Nations Championship,2
Cambodia,Brunei,6,1,Friendly,5
United Arab Emirates,Turkmenistan,5,1,Friendly,4
DR Congo,Zambia,3,0,Friendly,3
Hong Kong,Myanmar,5,0,Friendly,5
Estonia,Georgia,3,0,Friendly,3
Jordan,Malta,2,0,Friendly,2
Afghanistan,Cambodia,3,0,FIFA World Cup qualification,3
Australia,Kyrgyzstan,3,0,FIFA World Cup qualification,3
Bolivia,Venezuela,4,2,FIFA World Cup qualification,2
China PR,Bhutan,12,0,FIFA World Cup qualification,12
Iran,Turkmenistan,3,1,FIFA World Cup qualification,2
South Korea,Myanmar,4,0,FIFA World Cup qualification,4
Lebanon,Laos,7,0,FIFA World Cup qualification,7
North Macedonia,Montenegro,4,1,Friendly,3
Morocco,Equatorial Guinea,2,0,FIFA World Cup qualification,2
Palestine,Malaysia,6,0,FIFA World Cup qualification,6
Singapore,Japan,0,3,FIFA World Cup qualification,3
Tajikistan,Bangladesh,5,0,FIFA World Cup qualification,5
Thailand,Taiwan,4,2,FIFA World Cup qualification,2
United Arab Emirates,Timor-Leste,8,0,FIFA World Cup qualification,8
Uzbekistan,North Korea,3,1,FIFA World Cup qualification,2
Angola,South Africa,1,3,FIFA World Cup qualification,2
Belgium,Italy,3,1,Friendly,2
Czech Republic,Serbia,4,1,Friendly,3
France,Germany,2,0,Friendly,2
Niger,Cameroon,0,3,FIFA World Cup qualification,3
Poland,Iceland,4,2,Friendly,2
Spain,England,2,0,Friendly,2
Jamaica,Panama,0,2,FIFA World Cup qualification,2
Mexico,El Salvador,3,0,FIFA World Cup qualification,3
United States,Saint Vincent and the Grenadines,6,1,FIFA World Cup qualification,5
Hong Kong,Macau,2,0,Friendly,2
Ukraine,Slovenia,2,0,UEFA Euro qualification,2
DR Congo,Burundi,3,0,FIFA World Cup qualification,3
Guinea,Namibia,2,0,FIFA World Cup qualification,2
Uganda,Togo,3,0,FIFA World Cup qualification,3
Zambia,Sudan,2,0,FIFA World Cup qualification,2
Republic of Ireland,Bosnia and Herzegovina,2,0,UEFA Euro qualification,2
Algeria,Tanzania,7,0,FIFA World Cup qualification,7
Bangladesh,Australia,0,4,FIFA World Cup qualification,4
Bhutan,Qatar,0,3,FIFA World Cup qualification,3
Brazil,Peru,3,0,FIFA World Cup qualification,3
Burkina Faso,Benin,2,0,FIFA World Cup qualification,2
Myanmar,Kuwait,3,0,FIFA World Cup qualification,3
Cambodia,Japan,0,2,FIFA World Cup qualification,2
Cape Verde,Kenya,2,0,FIFA World Cup qualification,2
Timor-Leste,Saudi Arabia,0,10,FIFA World Cup qualification,10
Egypt,Chad,4,0,FIFA World Cup qualification,4
England,France,2,0,Friendly,2
Estonia,Saint Kitts and Nevis,3,0,Friendly,3
Ghana,Comoros,2,0,FIFA World Cup qualification,2
Guam,Iran,0,6,FIFA World Cup qualification,6
Honduras,Mexico,0,2,FIFA World Cup qualification,2
Ivory Coast,Liberia,3,0,FIFA World Cup qualification,3
North Korea,Bahrain,2,0,FIFA World Cup qualification,2
Laos,South Korea,0,5,FIFA World Cup qualification,5
Luxembourg,Portugal,0,2,Friendly,2
Mali,Botswana,2,0,FIFA World Cup qualification,2
Nigeria,Eswatini,2,0,FIFA World Cup qualification,2
Poland,Czech Republic,3,1,Friendly,2
Russia,Croatia,1,3,Friendly,2
Rwanda,Libya,1,3,FIFA World Cup qualification,2
Senegal,Madagascar,3,0,FIFA World Cup qualification,3
Slovakia,Iceland,3,1,Friendly,2
Uruguay,Chile,3,0,FIFA World Cup qualification,3
Venezuela,Ecuador,1,3,FIFA World Cup qualification,2
Yemen,Uzbekistan,1,3,FIFA World Cup qualification,2
Saint Vincent and the Grenadines,Guatemala,0,4,FIFA World Cup qualification,4
Taiwan,Iraq,0,2,FIFA World Cup qualification,2
Kenya,Uganda,2,0,CECAFA Cup,2
Somalia,Tanzania,0,4,CECAFA Cup,4
South Sudan,Djibouti,2,0,CECAFA Cup,2
Zanzibar,Uganda,0,4,CECAFA Cup,4
Ethiopia,Somalia,2,0,CECAFA Cup,2
Malawi,Djibouti,3,0,CECAFA Cup,3
Djibouti,Sudan,0,4,CECAFA Cup,4
Rwanda,Somalia,3,0,CECAFA Cup,3
South Sudan,Malawi,2,0,CECAFA Cup,2
Zanzibar,Kenya,3,1,CECAFA Cup,2
Uganda,Malawi,2,0,CECAFA Cup,2
Nicaragua,Cuba,5,0,Friendly,5
Honduras,Cuba,2,0,Friendly,2
Afghanistan,Bangladesh,4,0,SAFF Cup,4
Maldives,Bhutan,3,1,SAFF Cup,2
India,Sri Lanka,2,0,SAFF Cup,2
Bangladesh,Maldives,1,3,SAFF Cup,2
Bhutan,Afghanistan,0,3,SAFF Cup,3
Martinique,Guadeloupe,2,0,Friendly,2
India,Nepal,4,1,SAFF Cup,3
Afghanistan,Maldives,4,1,SAFF Cup,3
Bhutan,Bangladesh,0,3,SAFF Cup,3
Afghanistan,Sri Lanka,5,0,SAFF Cup,5
Bangladesh,Sri Lanka,4,2,Friendly,2
Panama,Cuba,4,0,Copa América qualification,4
Sweden,Finland,3,0,Friendly,3
DR Congo,Ethiopia,3,0,African Nations Championship,3
Nigeria,Niger,4,1,African Nations Championship,3
Maldives,Nepal,1,4,Friendly,3
DR Congo,Angola,4,2,African Nations Championship,2
Ivory Coast,Gabon,4,1,African Nations Championship,3
Rwanda,Morocco,1,4,African Nations Championship,3
Cameroon,DR Congo,3,1,African Nations Championship,2
Niger,Tunisia,0,5,African Nations Championship,5
Egypt,Libya,2,0,Friendly,2
Cameroon,Ivory Coast,0,3,African Nations Championship,3
Bahrain,Lebanon,2,0,Friendly,2
DR Congo,Mali,3,0,African Nations Championship,3
Uzbekistan,Lebanon,2,0,Friendly,2
Guyana,Suriname,2,0,Friendly,2
Egypt,Burkina Faso,2,0,Friendly,2
Sint Maarten,Anguilla,2,0,Friendly,2
United Arab Emirates,Bangladesh,6,1,Friendly,5
Croatia,Israel,2,0,Friendly,2
Martinique,British Virgin Islands,3,0,CFU Caribbean Cup qualification,3
Australia,Tajikistan,7,0,FIFA World Cup qualification,7
Bahrain,Yemen,3,0,FIFA World Cup qualification,3
China PR,Maldives,4,0,FIFA World Cup qualification,4
Ghana,Mozambique,3,1,African Cup of Nations qualification,2
Iran,India,4,0,FIFA World Cup qualification,4
Japan,Afghanistan,5,0,FIFA World Cup qualification,5
Jordan,Bangladesh,8,0,FIFA World Cup qualification,8
Qatar,Hong Kong,2,0,FIFA World Cup qualification,2
Saudi Arabia,Malaysia,2,0,FIFA World Cup qualification,2
Solomon Islands,Papua New Guinea,2,0,Friendly,2
Syria,Cambodia,6,0,FIFA World Cup qualification,6
United Arab Emirates,Palestine,2,0,FIFA World Cup qualification,2
Vietnam,Taiwan,4,1,FIFA World Cup qualification,3
Algeria,Ethiopia,7,1,African Cup of Nations qualification,6
Canada,Mexico,0,3,FIFA World Cup qualification,3
Guatemala,United States,2,0,FIFA World Cup qualification,2
Luxembourg,Bosnia and Herzegovina,0,3,Friendly,3
Anguilla,Puerto Rico,0,4,CFU Caribbean Cup qualification,4
Aruba,Saint Kitts and Nevis,0,2,CFU Caribbean Cup qualification,2
British Virgin Islands,Dominica,0,7,CFU Caribbean Cup qualification,7
Burundi,Namibia,1,3,African Cup of Nations qualification,2
Poland,Finland,5,0,Friendly,5
Russia,Lithuania,3,0,Friendly,3
Senegal,Niger,2,0,African Cup of Nations qualification,2
Seychelles,Lesotho,2,0,African Cup of Nations qualification,2
Benin,South Sudan,4,1,African Cup of Nations qualification,3
Libya,São Tomé and Príncipe,4,0,African Cup of Nations qualification,4
Angola,DR Congo,0,2,African Cup of Nations qualification,2
Argentina,Bolivia,2,0,FIFA World Cup qualification,2
Australia,Jordan,5,1,FIFA World Cup qualification,4
China PR,Qatar,2,0,FIFA World Cup qualification,2
Colombia,Ecuador,3,1,FIFA World Cup qualification,2
Costa Rica,Jamaica,3,0,FIFA World Cup qualification,3
Dominica,Martinique,1,4,CFU Caribbean Cup qualification,3
Dominican Republic,Barbados,2,0,CFU Caribbean Cup qualification,2
France,Russia,4,2,Friendly,2
French Guiana,Cuba,3,0,CFU Caribbean Cup qualification,3
Germany,Italy,4,1,Friendly,3
Gibraltar,Latvia,0,5,Friendly,5
Honduras,El Salvador,2,0,FIFA World Cup qualification,2
Iran,Oman,2,0,FIFA World Cup qualification,2
Japan,Syria,5,0,FIFA World Cup qualification,5
Liberia,Djibouti,5,0,African Cup of Nations qualification,5
Luxembourg,Albania,0,2,Friendly,2
North Macedonia,Bulgaria,0,2,Friendly,2
Maldives,Bhutan,4,2,FIFA World Cup qualification,2
Mexico,Canada,2,0,FIFA World Cup qualification,2
Morocco,Cape Verde,2,0,African Cup of Nations qualification,2
Namibia,Burundi,1,3,African Cup of Nations qualification,2
Norway,Finland,2,0,Friendly,2
Palestine,Timor-Leste,7,0,FIFA World Cup qualification,7
Rwanda,Mauritius,5,0,African Cup of Nations qualification,5
Switzerland,Bosnia and Herzegovina,0,2,Friendly,2
United States,Guatemala,4,0,FIFA World Cup qualification,4
Venezuela,Chile,1,4,FIFA World Cup qualification,3
Trinidad and Tobago,Saint Vincent and the Grenadines,6,0,FIFA World Cup qualification,6
Martinique,Panama,0,2,Friendly,2
Puerto Rico,United States,1,3,Friendly,2
Czech Republic,Malta,6,0,Friendly,6
Morocco,Congo,2,0,Friendly,2
Northern Ireland,Belarus,3,0,Friendly,3
Slovakia,Georgia,3,1,Friendly,2
El Salvador,Peru,1,3,Friendly,2
Gabon,Mauritania,0,2,Friendly,2
Guatemala,Armenia,1,7,Friendly,6
New Zealand,Fiji,3,1,Oceania Nations Cup,2
Rwanda,Senegal,0,2,Friendly,2
Albania,Qatar,3,1,Friendly,2
Azerbaijan,North Macedonia,1,3,Friendly,2
Bosnia and Herzegovina,Spain,1,3,Friendly,2
Cambodia,Timor-Leste,2,0,Friendly,2
Germany,Slovakia,1,3,Friendly,2
Lithuania,Estonia,2,0,Baltic Cup,2
Portugal,Norway,3,0,Friendly,3
Tahiti,Samoa,4,0,Oceania Nations Cup,4
Abkhazia,Chagos Islands,9,0,CONIFA World Football Cup,9
Iraqi Kurdistan,Székely Land,3,0,CONIFA World Football Cup,3
Sápmi,Somaliland,5,0,CONIFA World Football Cup,5
Chagos Islands,Western Armenia,0,12,CONIFA World Football Cup,12
Raetia,Padania,0,6,CONIFA World Football Cup,6
Luxembourg,Nigeria,1,3,Friendly,2
Serbia,Israel,3,1,Friendly,2
Vanuatu,New Zealand,0,5,Oceania Nations Cup,5
Vietnam,Syria,2,0,Friendly,2
Zimbabwe,Uganda,2,0,Friendly,2
United Koreans in Japan,Iraqi Kurdistan,0,3,CONIFA World Football Cup,3
Northern Cyprus,Raetia,7,0,CONIFA World Football Cup,7
Somaliland,Panjab,0,5,CONIFA World Football Cup,5
Curaçao,Guyana,5,2,CFU Caribbean Cup qualification,3
El Salvador,Armenia,0,4,Friendly,4
Estonia,Andorra,2,0,Friendly,2
Martinique,Guadeloupe,2,0,CFU Caribbean Cup qualification,2
New Caledonia,Samoa,7,0,Oceania Nations Cup,7
Spain,South Korea,6,1,Friendly,5
Abkhazia,Sápmi,2,0,CONIFA World Football Cup,2
North Macedonia,Iran,1,3,Friendly,2
Malaysia,Timor-Leste,3,0,AFC Asian Cup qualification,3
Maldives,Yemen,0,2,AFC Asian Cup qualification,2
Seychelles,Algeria,0,2,African Cup of Nations qualification,2
Tajikistan,Bangladesh,5,0,AFC Asian Cup qualification,5
Székely Land,Raetia,7,0,CONIFA World Football Cup,7
Albania,Ukraine,1,3,Friendly,2
China PR,Trinidad and Tobago,4,2,Friendly,2
Djibouti,Tunisia,0,3,African Cup of Nations qualification,3
Faroe Islands,Kosovo,0,2,Friendly,2
Japan,Bulgaria,7,2,Kirin Cup,5
Romania,Georgia,5,1,Friendly,4
United Arab Emirates,Jordan,1,3,King's Cup,2
United States,Colombia,0,2,Copa América,2
Somaliland,Székely Land,7,0,CONIFA World Football Cup,7
Austria,Netherlands,0,2,Friendly,2
Croatia,San Marino,10,0,Friendly,10
France,Scotland,3,0,Friendly,3
Gambia,South Africa,0,4,African Cup of Nations qualification,4
Germany,Hungary,2,0,Friendly,2
South Sudan,Mali,0,3,African Cup of Nations qualification,3
Tanzania,Egypt,0,2,African Cup of Nations qualification,2
United States Virgin Islands,Guyana,0,7,CFU Caribbean Cup qualification,7
Abkhazia,Northern Cyprus,2,0,CONIFA World Football Cup,2
Sápmi,Western Armenia,3,0,CONIFA World Football Cup,3
Central African Republic,Angola,3,0,African Cup of Nations qualification,3
Madagascar,DR Congo,1,6,African Cup of Nations qualification,5
Mauritius,Ghana,0,2,African Cup of Nations qualification,2
Mexico,Uruguay,3,1,Copa América,2
Papua New Guinea,Samoa,8,0,Oceania Nations Cup,8
Sweden,Wales,3,0,Friendly,3
Thailand,Jordan,2,0,King's Cup,2
Zimbabwe,Malawi,3,0,African Cup of Nations qualification,3
Padania,Northern Cyprus,0,2,CONIFA World Football Cup,2
Myanmar,Hong Kong,3,0,Friendly,3
Iceland,Liechtenstein,4,0,Friendly,4
Italy,Finland,2,0,Friendly,2
Malaysia,Timor-Leste,3,0,AFC Asian Cup qualification,3
Singapore,Vietnam,0,3,Friendly,3
Bulgaria,Denmark,0,4,Kirin Cup,4
Cambodia,Taiwan,2,0,AFC Asian Cup qualification,2
Curaçao,United States Virgin Islands,7,0,CFU Caribbean Cup qualification,7
India,Laos,6,1,AFC Asian Cup qualification,5
Iran,Kyrgyzstan,6,0,Friendly,6
United States,Costa Rica,4,0,Copa América,4
Yemen,Maldives,2,0,AFC Asian Cup qualification,2
Brazil,Haiti,7,1,Copa América,6
Portugal,Estonia,7,0,Friendly,7
Mexico,Jamaica,2,0,Copa América,2
Argentina,Panama,5,0,Copa América,5
Ecuador,Haiti,4,0,Copa América,4
Germany,Ukraine,2,0,UEFA Euro,2
Lesotho,Mauritius,3,0,COSAFA Cup,3
Malawi,Angola,3,0,COSAFA Cup,3
Belgium,Italy,0,2,UEFA Euro,2
Eswatini,Seychelles,4,0,COSAFA Cup,4
Uruguay,Jamaica,3,0,Copa América,3
Angola,Lesotho,0,2,COSAFA Cup,2
Argentina,Bolivia,3,0,Copa América,3
Austria,Hungary,0,2,UEFA Euro,2
Chile,Panama,4,2,Copa América,2
France,Albania,2,0,UEFA Euro,2
Zimbabwe,Seychelles,5,0,COSAFA Cup,5
Angola,Mauritius,0,2,COSAFA Cup,2
Ukraine,Northern Ireland,0,2,UEFA Euro,2
Spain,Turkey,3,0,UEFA Euro,3
Argentina,Venezuela,4,1,Copa América,3
Belgium,Republic of Ireland,3,0,UEFA Euro,3
Mexico,Chile,0,7,Copa América,7
French Guiana,Bermuda,3,0,CFU Caribbean Cup qualification,3
Russia,Wales,0,3,UEFA Euro,3
Czech Republic,Turkey,0,2,UEFA Euro,2
Namibia,Mozambique,3,0,COSAFA Cup,3
United States,Argentina,0,4,Copa América,4
Colombia,Chile,0,2,Copa América,2
South Africa,Eswatini,5,1,COSAFA Cup,4
Germany,Slovakia,3,0,UEFA Euro,3
Hungary,Belgium,0,4,UEFA Euro,4
Italy,Spain,2,0,UEFA Euro,2
Wales,Belgium,3,1,UEFA Euro,2
Mongolia,Taiwan,0,2,EAFF Championship,2
Northern Mariana Islands,Macau,1,3,EAFF Championship,2
France,Iceland,5,2,UEFA Euro,3
Northern Mariana Islands,Mongolia,0,8,EAFF Championship,8
Portugal,Wales,2,0,UEFA Euro,2
France,Germany,2,0,UEFA Euro,2
Bhutan,India,0,3,Friendly,3
North Korea,United Arab Emirates,2,0,Friendly,2
Saudi Arabia,Laos,4,0,Friendly,4
Barawa,Tamil Eelam,0,5,World Unity Cup,5
Chagos Islands,Tamil Eelam,1,5,World Unity Cup,4
Dominican Republic,Puerto Rico,5,0,Friendly,5
Chagos Islands,Tamil Eelam,1,5,World Unity Cup,4
Kyrgyzstan,Kazakhstan,2,0,Friendly,2
Czech Republic,Armenia,3,0,Friendly,3
Denmark,Liechtenstein,5,0,Friendly,5
Germany,Finland,2,0,Friendly,2
Republic of Ireland,Oman,4,0,Friendly,4
Australia,Iraq,2,0,FIFA World Cup qualification,2
Bahrain,Singapore,3,1,Friendly,2
Belgium,Spain,0,2,Friendly,2
Bolivia,Peru,0,3,FIFA World Cup qualification,3
Colombia,Venezuela,2,0,FIFA World Cup qualification,2
Ecuador,Brazil,0,3,FIFA World Cup qualification,3
Hong Kong,Cambodia,4,2,Friendly,2
Iran,Qatar,2,0,FIFA World Cup qualification,2
Italy,France,1,3,Friendly,2
Maldives,Bangladesh,5,0,Friendly,5
Portugal,Gibraltar,5,0,Friendly,5
El Salvador,Mexico,1,3,FIFA World Cup qualification,2
Latvia,Luxembourg,3,1,Friendly,2
Panama,Jamaica,2,0,FIFA World Cup qualification,2
Saint Vincent and the Grenadines,United States,0,6,FIFA World Cup qualification,6
Cameroon,Gambia,2,0,African Cup of Nations qualification,2
India,Puerto Rico,4,1,Friendly,3
Senegal,Namibia,2,0,African Cup of Nations qualification,2
Algeria,Lesotho,6,0,African Cup of Nations qualification,6
DR Congo,Central African Republic,4,1,African Cup of Nations qualification,3
Equatorial Guinea,South Sudan,4,0,African Cup of Nations qualification,4
Malta,Scotland,1,5,FIFA World Cup qualification,4
Norway,Germany,0,3,FIFA World Cup qualification,3
Tunisia,Liberia,4,1,African Cup of Nations qualification,3
Israel,Italy,1,3,FIFA World Cup qualification,2
Lebanon,Afghanistan,2,0,Friendly,2
Spain,Liechtenstein,8,0,FIFA World Cup qualification,8
Wales,Moldova,4,0,FIFA World Cup qualification,4
Bosnia and Herzegovina,Estonia,5,0,FIFA World Cup qualification,5
Canada,El Salvador,3,1,FIFA World Cup qualification,2
Chile,Bolivia,3,0,FIFA World Cup qualification,3
Costa Rica,Panama,3,1,FIFA World Cup qualification,2
Cyprus,Belgium,0,3,FIFA World Cup qualification,3
Gibraltar,Greece,1,4,FIFA World Cup qualification,3
Indonesia,Malaysia,3,0,Friendly,3
Jamaica,Haiti,0,2,FIFA World Cup qualification,2
Maldives,Laos,4,0,AFC Asian Cup qualification,4
Switzerland,Portugal,2,0,FIFA World Cup qualification,2
Thailand,Japan,0,2,FIFA World Cup qualification,2
Uruguay,Paraguay,4,0,FIFA World Cup qualification,4
United States,Trinidad and Tobago,4,0,FIFA World Cup qualification,4
Guatemala,Saint Vincent and the Grenadines,9,3,FIFA World Cup qualification,6
Qatar,Serbia,3,0,Friendly,3
Curaçao,Antigua and Barbuda,3,0,CFU Caribbean Cup qualification,3
Solomon Islands,New Caledonia,0,3,Friendly,3
Trinidad and Tobago,Dominican Republic,4,0,CFU Caribbean Cup qualification,4
Brazil,Bolivia,5,0,FIFA World Cup qualification,5
Cambodia,Hong Kong,0,2,Friendly,2
Ecuador,Chile,3,0,FIFA World Cup qualification,3
Kosovo,Croatia,0,6,FIFA World Cup qualification,6
Liechtenstein,Albania,0,2,FIFA World Cup qualification,2
Mauritania,Canada,0,4,Friendly,4
Moldova,Serbia,0,3,FIFA World Cup qualification,3
United Arab Emirates,Thailand,3,1,FIFA World Cup qualification,2
Uruguay,Venezuela,3,0,FIFA World Cup qualification,3
Vietnam,North Korea,5,2,Friendly,3
Belgium,Bosnia and Herzegovina,4,0,FIFA World Cup qualification,4
Cuba,United States,0,2,Friendly,2
Estonia,Gibraltar,4,0,FIFA World Cup qualification,4
France,Bulgaria,4,1,FIFA World Cup qualification,3
Greece,Cyprus,2,0,FIFA World Cup qualification,2
Latvia,Faroe Islands,0,2,FIFA World Cup qualification,2
Netherlands,Belarus,4,1,FIFA World Cup qualification,3
Philippines,Bahrain,1,3,Friendly,2
Portugal,Andorra,6,0,FIFA World Cup qualification,6
Armenia,Romania,0,5,FIFA World Cup qualification,5
DR Congo,Libya,4,0,FIFA World Cup qualification,4
England,Malta,2,0,FIFA World Cup qualification,2
Germany,Czech Republic,3,0,FIFA World Cup qualification,3
Ivory Coast,Mali,3,1,FIFA World Cup qualification,2
Montenegro,Kazakhstan,5,0,FIFA World Cup qualification,5
Northern Ireland,San Marino,4,0,FIFA World Cup qualification,4
Senegal,Cape Verde,2,0,FIFA World Cup qualification,2
Albania,Spain,0,2,FIFA World Cup qualification,2
Cambodia,Sri Lanka,4,0,Friendly,4
Iceland,Turkey,2,0,FIFA World Cup qualification,2
Moldova,Republic of Ireland,1,3,FIFA World Cup qualification,2
Togo,Mozambique,2,0,Friendly,2
Tunisia,Guinea,2,0,FIFA World Cup qualification,2
Ukraine,Kosovo,3,0,FIFA World Cup qualification,3
Bhutan,Bangladesh,3,1,AFC Asian Cup qualification,2
Bosnia and Herzegovina,Cyprus,2,0,FIFA World Cup qualification,2
Estonia,Greece,0,2,FIFA World Cup qualification,2
Faroe Islands,Portugal,0,6,FIFA World Cup qualification,6
Gibraltar,Belgium,0,6,FIFA World Cup qualification,6
Latvia,Hungary,0,2,FIFA World Cup qualification,2
Philippines,North Korea,1,3,Friendly,2
Sweden,Bulgaria,3,0,FIFA World Cup qualification,3
Germany,Northern Ireland,2,0,FIFA World Cup qualification,2
Hong Kong,Singapore,2,0,Friendly,2
Iraq,Thailand,4,0,FIFA World Cup qualification,4
Lithuania,Malta,2,0,FIFA World Cup qualification,2
Morocco,Canada,4,0,Friendly,4
Norway,San Marino,4,1,FIFA World Cup qualification,3
Puerto Rico,Curaçao,2,4,CFU Caribbean Cup qualification,2
Saudi Arabia,United Arab Emirates,3,0,FIFA World Cup qualification,3
Slovakia,Scotland,3,0,FIFA World Cup qualification,3
Uzbekistan,China PR,2,0,FIFA World Cup qualification,2
Venezuela,Brazil,0,2,FIFA World Cup qualification,2
Cambodia,Brunei,3,0,AFF Championship,3
Brunei,Timor-Leste,4,0,AFC Challenge Cup,4
North Korea,Taiwan,2,0,EAFF Championship,2
Laos,Macau,1,4,AFC Challenge Cup,3
Mongolia,Sri Lanka,2,0,AFC Challenge Cup,2
Tahiti,Solomon Islands,3,0,FIFA World Cup qualification,3
Nepal,Brunei,3,0,AFC Challenge Cup,3
Guam,North Korea,0,2,EAFF Championship,2
Haiti,French Guiana,2,5,CFU Caribbean Cup qualification,3
Hong Kong,Taiwan,4,2,EAFF Championship,2
Mongolia,Laos,0,3,AFC Challenge Cup,3
Syria,Singapore,2,0,Friendly,2
Tajikistan,Turkmenistan,3,0,Friendly,3
United Arab Emirates,Bahrain,2,0,Friendly,2
Brazil,Argentina,3,0,FIFA World Cup qualification,3
Iran,Papua New Guinea,8,1,Friendly,7
Paraguay,Peru,1,4,FIFA World Cup qualification,3
Venezuela,Bolivia,5,0,FIFA World Cup qualification,5
Denmark,Kazakhstan,4,1,FIFA World Cup qualification,3
England,Scotland,3,0,FIFA World Cup qualification,3
Japan,Oman,4,0,Kirin Challenge Cup,4
South Korea,Canada,2,0,Friendly,2
Northern Ireland,Azerbaijan,4,0,FIFA World Cup qualification,4
Romania,Poland,0,3,FIFA World Cup qualification,3
San Marino,Germany,0,8,FIFA World Cup qualification,8
Slovakia,Lithuania,4,0,FIFA World Cup qualification,4
Trinidad and Tobago,Costa Rica,0,2,FIFA World Cup qualification,2
Albania,Israel,0,3,FIFA World Cup qualification,3
Cape Verde,Burkina Faso,0,2,FIFA World Cup qualification,2
Croatia,Iceland,2,0,FIFA World Cup qualification,2
Liechtenstein,Italy,0,4,FIFA World Cup qualification,4
New Zealand,New Caledonia,2,0,FIFA World Cup qualification,2
Nigeria,Algeria,3,1,FIFA World Cup qualification,2
Spain,North Macedonia,4,0,FIFA World Cup qualification,4
Turkey,Kosovo,2,0,FIFA World Cup qualification,2
Belgium,Estonia,8,1,FIFA World Cup qualification,7
Cyprus,Gibraltar,3,1,FIFA World Cup qualification,2
Egypt,Ghana,2,0,FIFA World Cup qualification,2
Hungary,Andorra,4,0,FIFA World Cup qualification,4
Luxembourg,Netherlands,1,3,FIFA World Cup qualification,2
Portugal,Latvia,4,1,FIFA World Cup qualification,3
Saint Kitts and Nevis,Haiti,0,2,CFU Caribbean Cup qualification,2
Switzerland,Faroe Islands,2,0,FIFA World Cup qualification,2
Zimbabwe,Tanzania,3,0,Friendly,3
Myanmar,Oman,0,3,Friendly,3
Argentina,Colombia,3,0,FIFA World Cup qualification,3
Chile,Uruguay,3,1,FIFA World Cup qualification,2
Costa Rica,United States,4,0,FIFA World Cup qualification,4
Ecuador,Venezuela,3,0,FIFA World Cup qualification,3
Honduras,Trinidad and Tobago,3,1,FIFA World Cup qualification,2
Malta,Iceland,0,2,Friendly,2
Northern Ireland,Croatia,0,3,Friendly,3
Peru,Brazil,0,2,FIFA World Cup qualification,2
Ukraine,Serbia,2,0,Friendly,2
United Arab Emirates,Iraq,2,0,FIFA World Cup qualification,2
Thailand,Indonesia,4,2,AFF Championship,2
Myanmar,Cambodia,3,1,AFF Championship,2
Myanmar,Thailand,0,2,AFF Championship,2
Thailand,Myanmar,4,0,AFF Championship,4
Thailand,Indonesia,2,0,AFF Championship,2
Nicaragua,Trinidad and Tobago,1,3,Friendly,2
Basque Country,Tunisia,3,1,Friendly,2
Tunisia,Uganda,2,0,Friendly,2
Cameroon,DR Congo,2,0,Friendly,2
Suriname,Haiti,2,4,CFU Caribbean Cup qualification,2
Algeria,Mauritania,3,1,Friendly,2
Algeria,Mauritania,6,0,Friendly,6
China PR,Iceland,0,2,Friendly,2
Congo,Senegal,0,2,Friendly,2
Ivory Coast,Uganda,3,0,Friendly,3
Cambodia,Saudi Arabia,2,7,Friendly,5
Belize,Costa Rica,0,3,UNCAF Cup,3
Tunisia,Senegal,0,2,African Cup of Nations,2
El Salvador,Belize,3,1,UNCAF Cup,2
Senegal,Zimbabwe,2,0,African Cup of Nations,2
Morocco,Togo,3,1,African Cup of Nations,2
Nicaragua,Belize,3,1,UNCAF Cup,2
Bermuda,Canada,2,4,Friendly,2
Guinea-Bissau,Burkina Faso,0,2,African Cup of Nations,2
Zimbabwe,Tunisia,2,4,African Cup of Nations,2
Togo,DR Congo,1,3,African Cup of Nations,2
Burkina Faso,Tunisia,2,0,African Cup of Nations,2
Cameroon,Ghana,2,0,African Cup of Nations,2
Ecuador,Honduras,3,1,Friendly,2
Trinidad and Tobago,Barbados,2,0,Friendly,2
Burundi,Djibouti,7,0,Friendly,7
Honduras,Nicaragua,2,0,Friendly,2
San Marino,Moldova,0,2,Friendly,2
Indonesia,Myanmar,1,3,Friendly,2
Cyprus,Kazakhstan,3,1,Friendly,2
Czech Republic,Lithuania,3,0,Friendly,3
Djibouti,South Sudan,2,0,African Cup of Nations qualification,2
Jordan,Hong Kong,4,0,Friendly,4
Papua New Guinea,Tahiti,1,3,FIFA World Cup qualification,2
Thailand,Saudi Arabia,0,3,FIFA World Cup qualification,3
United Arab Emirates,Japan,0,2,FIFA World Cup qualification,2
Uruguay,Brazil,1,4,FIFA World Cup qualification,3
Austria,Moldova,2,0,FIFA World Cup qualification,2
Comoros,Mauritius,2,0,African Cup of Nations qualification,2
Georgia,Serbia,1,3,FIFA World Cup qualification,2
Italy,Albania,2,0,FIFA World Cup qualification,2
Liechtenstein,North Macedonia,0,3,FIFA World Cup qualification,3
Mexico,Costa Rica,2,0,FIFA World Cup qualification,2
Morocco,Burkina Faso,2,0,Friendly,2
Russia,Ivory Coast,0,2,Friendly,2
Spain,Israel,4,1,FIFA World Cup qualification,3
Turkey,Finland,2,0,FIFA World Cup qualification,2
United States,Honduras,6,0,FIFA World Cup qualification,6
Bosnia and Herzegovina,Gibraltar,5,0,FIFA World Cup qualification,5
Bulgaria,Netherlands,2,0,FIFA World Cup qualification,2
Fiji,New Zealand,0,2,FIFA World Cup qualification,2
Luxembourg,France,1,3,FIFA World Cup qualification,2
Mozambique,Angola,2,0,Friendly,2
Portugal,Hungary,3,0,FIFA World Cup qualification,3
South Africa,Guinea-Bissau,3,1,Friendly,2
Sweden,Belarus,4,0,FIFA World Cup qualification,4
Tanzania,Botswana,2,0,Friendly,2
Armenia,Kazakhstan,2,0,FIFA World Cup qualification,2
Azerbaijan,Germany,1,4,FIFA World Cup qualification,3
England,Lithuania,2,0,FIFA World Cup qualification,2
Malta,Slovakia,1,3,FIFA World Cup qualification,2
Northern Ireland,Norway,2,0,FIFA World Cup qualification,2
San Marino,Czech Republic,0,6,FIFA World Cup qualification,6
Turkey,Moldova,3,1,Friendly,2
Australia,United Arab Emirates,2,0,FIFA World Cup qualification,2
Bolivia,Argentina,2,0,FIFA World Cup qualification,2
Brazil,Paraguay,3,0,FIFA World Cup qualification,3
Chile,Venezuela,3,1,FIFA World Cup qualification,2
Ecuador,Colombia,0,2,FIFA World Cup qualification,2
Egypt,Togo,3,0,Friendly,3
Estonia,Croatia,3,0,Friendly,3
France,Spain,0,2,Friendly,2
Georgia,Latvia,5,0,Friendly,5
Japan,Thailand,4,0,FIFA World Cup qualification,4
Jordan,Cambodia,7,0,AFC Asian Cup qualification,7
Lebanon,Hong Kong,2,0,AFC Asian Cup qualification,2
Luxembourg,Cape Verde,0,2,Friendly,2
North Macedonia,Belarus,3,0,Friendly,3
Maldives,Palestine,0,3,AFC Asian Cup qualification,3
New Zealand,Fiji,2,0,FIFA World Cup qualification,2
Oman,Bhutan,14,0,AFC Asian Cup qualification,14
Philippines,Nepal,4,1,AFC Asian Cup qualification,3
South Sudan,Djibouti,6,0,African Cup of Nations qualification,6
Martinique,Guadeloupe,4,1,Friendly,3
South Sudan,Somalia,2,0,African Nations Championship,2
Senegal,Mauritania,2,0,Friendly,2
Italy,San Marino,8,0,Friendly,8
Mexico,Republic of Ireland,3,1,Friendly,2
Nigeria,Togo,3,0,Friendly,3
Chile,Burkina Faso,3,0,Friendly,3
France,Paraguay,5,0,Friendly,5
Portugal,Cyprus,4,0,Friendly,4
Armenia,Saint Kitts and Nevis,5,0,Friendly,5
Republic of Ireland,Uruguay,3,1,Friendly,2
Netherlands,Ivory Coast,5,0,Friendly,5
Togo,Comoros,2,0,Friendly,2
DR Congo,Botswana,2,0,Friendly,2
Hungary,Russia,0,3,Friendly,3
Bahrain,Palestine,0,2,Friendly,2
India,Nepal,2,0,Friendly,2
Uzbekistan,Thailand,2,0,Friendly,2
Northern Cyprus,South Ossetia,8,0,CONIFA European Football Cup,8
China PR,Philippines,8,1,Friendly,7
Georgia,Saint Kitts and Nevis,3,0,Friendly,3
Italy,Uruguay,3,0,Friendly,3
United Arab Emirates,Laos,4,0,Friendly,4
South Ossetia,Kárpátalja,1,4,CONIFA European Football Cup,3
Ellan Vannin,Székely Land,2,4,CONIFA European Football Cup,2
Padania,Felvidék,2,0,CONIFA European Football Cup,2
Cambodia,Indonesia,0,2,Friendly,2
Mexico,Honduras,3,0,FIFA World Cup qualification,3
United States,Trinidad and Tobago,2,0,FIFA World Cup qualification,2
Estonia,Belgium,0,2,FIFA World Cup qualification,2
Faroe Islands,Switzerland,0,2,FIFA World Cup qualification,2
Latvia,Portugal,0,3,FIFA World Cup qualification,3
Libya,Seychelles,5,1,African Cup of Nations qualification,4
Netherlands,Luxembourg,5,0,FIFA World Cup qualification,5
Sudan,Madagascar,1,3,African Cup of Nations qualification,2
South Ossetia,Felvidék,0,2,CONIFA European Football Cup,2
Burkina Faso,Angola,3,1,African Cup of Nations qualification,2
Burundi,South Sudan,3,0,African Cup of Nations qualification,3
DR Congo,Congo,3,1,African Cup of Nations qualification,2
Germany,San Marino,7,0,FIFA World Cup qualification,7
Kazakhstan,Denmark,1,3,FIFA World Cup qualification,2
Montenegro,Armenia,4,1,FIFA World Cup qualification,3
Nigeria,South Africa,0,2,African Cup of Nations qualification,2
Poland,Romania,3,1,FIFA World Cup qualification,2
Senegal,Equatorial Guinea,3,0,African Cup of Nations qualification,3
Slovenia,Malta,2,0,FIFA World Cup qualification,2
Székely Land,Abkhazia,3,1,CONIFA European Football Cup,2
Ghana,Ethiopia,5,0,African Cup of Nations qualification,5
Israel,Albania,0,3,FIFA World Cup qualification,3
Italy,Liechtenstein,5,0,FIFA World Cup qualification,5
Kosovo,Turkey,1,4,FIFA World Cup qualification,3
Zimbabwe,Liberia,3,0,African Cup of Nations qualification,3
Iran,Uzbekistan,2,0,FIFA World Cup qualification,2
Australia,Brazil,0,4,Friendly,4
Bhutan,Maldives,0,2,AFC Asian Cup qualification,2
Cameroon,Colombia,0,4,Friendly,4
El Salvador,Ecuador,0,3,Friendly,3
Macau,Myanmar,0,4,AFC Asian Cup qualification,4
Singapore,Argentina,0,6,Friendly,6
French Guiana,Barbados,3,0,Friendly,3
Russia,New Zealand,2,0,Confederations Cup,2
Cameroon,Chile,0,2,Confederations Cup,2
New Zealand,Portugal,0,4,Confederations Cup,4
Germany,Cameroon,3,1,Confederations Cup,2
Tanzania,Malawi,2,0,COSAFA Cup,2
Alderney,Jersey,0,3,Island Games,3
Gotland,Frøya,7,1,Island Games,6
Western Isles,Greenland,0,3,Island Games,3
Isle of Man,Hitra,5,0,Island Games,5
Ynys Môn,Falkland Islands,3,0,Island Games,3
Madagascar,Seychelles,2,0,COSAFA Cup,2
Mozambique,Zimbabwe,0,4,COSAFA Cup,4
Orkney,Alderney,3,0,Island Games,3
Gotland,Western Isles,8,0,Island Games,8
Shetland,Guernsey,0,3,Island Games,3
Falkland Islands,Isle of Man,2,5,Island Games,3
Hitra,Ynys Môn,1,5,Island Games,4
Menorca,Alderney,6,0,Island Games,6
Orkney,Jersey,0,3,Island Games,3
Frøya,Western Isles,2,4,Island Games,2
Isle of Man,Ynys Môn,4,0,Island Games,4
Germany,Mexico,4,1,Confederations Cup,3
Falkland Islands,Alderney,0,3,Island Games,3
Saare County,Frøya,4,2,Island Games,2
Orkney,Shetland,3,1,Island Games,2
Ynys Môn,Åland Islands,0,2,Island Games,2
Mozambique,Madagascar,1,4,COSAFA Cup,3
Zimbabwe,Seychelles,6,0,COSAFA Cup,6
Greenland,Isle of Man,0,6,Island Games,6
South Africa,Botswana,2,0,COSAFA Cup,2
Saint Vincent and the Grenadines,Barbados,4,2,Friendly,2
Zambia,Tanzania,4,2,COSAFA Cup,2
Grenada,Barbados,0,2,Windward Islands Tournament,2
French Guiana,Canada,2,4,Gold Cup,2
Martinique,Nicaragua,2,0,Gold Cup,2
Curaçao,Jamaica,0,2,Gold Cup,2
Mexico,El Salvador,3,1,Gold Cup,2
Zambia,Zimbabwe,1,3,COSAFA Cup,2
El Salvador,Curaçao,2,0,Gold Cup,2
Costa Rica,French Guiana,3,0,Gold Cup,3
Thailand,North Korea,3,0,King's Cup,3
Panama,Martinique,3,0,Gold Cup,3
United States,Nicaragua,3,0,Gold Cup,3
Djibouti,Ethiopia,1,5,African Nations Championship,4
Botswana,South Africa,0,2,African Nations Championship,2
Comoros,Lesotho,2,0,African Nations Championship,2
Guinea-Bissau,Guinea,1,3,African Nations Championship,2
Curaçao,Mexico,0,2,Gold Cup,2
Eswatini,Zambia,0,4,African Nations Championship,4
Liberia,Mauritania,0,2,African Nations Championship,2
United States,El Salvador,2,0,Gold Cup,2
United States,Costa Rica,2,0,Gold Cup,2
Uganda,South Sudan,5,1,African Nations Championship,4
Zambia,Eswatini,3,0,African Nations Championship,3
Guinea,Guinea-Bissau,7,0,African Nations Championship,7
Mali,Gambia,4,0,African Nations Championship,4
Senegal,Sierra Leone,3,1,African Nations Championship,2
Ethiopia,Djibouti,3,0,African Nations Championship,3
Mozambique,Madagascar,0,2,African Nations Championship,2
Ecuador,Trinidad and Tobago,3,1,Friendly,2
São Tomé and Príncipe,Cameroon,0,2,African Nations Championship,2
Morocco,Egypt,3,1,African Nations Championship,2
Cameroon,São Tomé and Príncipe,2,0,African Nations Championship,2
Oman,Afghanistan,2,0,Friendly,2
Belgium,Gibraltar,9,0,FIFA World Cup qualification,9
Brazil,Ecuador,2,0,FIFA World Cup qualification,2
Chile,Paraguay,0,3,FIFA World Cup qualification,3
France,Netherlands,4,0,FIFA World Cup qualification,4
Hungary,Latvia,3,1,FIFA World Cup qualification,2
Japan,Australia,2,0,FIFA World Cup qualification,2
Niger,Togo,0,2,Friendly,2
Portugal,Faroe Islands,5,1,FIFA World Cup qualification,4
Switzerland,Andorra,3,0,FIFA World Cup qualification,3
Syria,Qatar,3,1,FIFA World Cup qualification,2
Denmark,Poland,4,0,FIFA World Cup qualification,4
Kazakhstan,Montenegro,0,3,FIFA World Cup qualification,3
Lithuania,Scotland,0,3,FIFA World Cup qualification,3
Malta,England,0,4,FIFA World Cup qualification,4
Morocco,Mali,6,0,FIFA World Cup qualification,6
New Zealand,Solomon Islands,6,1,FIFA World Cup qualification,5
Nigeria,Cameroon,4,0,FIFA World Cup qualification,4
Norway,Azerbaijan,2,0,FIFA World Cup qualification,2
San Marino,Northern Ireland,0,3,FIFA World Cup qualification,3
United States,Costa Rica,0,2,FIFA World Cup qualification,2
Albania,Liechtenstein,2,0,FIFA World Cup qualification,2
Canada,Jamaica,2,0,Friendly,2
Gabon,Ivory Coast,0,3,FIFA World Cup qualification,3
Serbia,Moldova,3,0,FIFA World Cup qualification,3
Spain,Italy,3,0,FIFA World Cup qualification,3
Ukraine,Turkey,2,0,FIFA World Cup qualification,2
Zambia,Algeria,3,1,FIFA World Cup qualification,2
Belarus,Sweden,0,4,FIFA World Cup qualification,4
Gibraltar,Bosnia and Herzegovina,0,4,FIFA World Cup qualification,4
Latvia,Switzerland,0,3,FIFA World Cup qualification,3
Netherlands,Bulgaria,3,1,FIFA World Cup qualification,2
Armenia,Denmark,1,4,FIFA World Cup qualification,3
Azerbaijan,San Marino,5,1,FIFA World Cup qualification,4
Germany,Norway,6,0,FIFA World Cup qualification,6
Northern Ireland,Czech Republic,2,0,FIFA World Cup qualification,2
Poland,Kazakhstan,3,0,FIFA World Cup qualification,3
Scotland,Malta,2,0,FIFA World Cup qualification,2
Slovenia,Lithuania,4,0,FIFA World Cup qualification,4
Bahrain,Taiwan,5,0,AFC Asian Cup qualification,5
Bhutan,Palestine,0,2,AFC Asian Cup qualification,2
Congo,Ghana,1,5,FIFA World Cup qualification,4
Iceland,Ukraine,2,0,FIFA World Cup qualification,2
Jordan,Afghanistan,4,1,AFC Asian Cup qualification,3
Liechtenstein,Spain,0,8,FIFA World Cup qualification,8
Macau,India,0,2,AFC Asian Cup qualification,2
Mauritania,Niger,0,2,Friendly,2
Moldova,Wales,0,2,FIFA World Cup qualification,2
Oman,Maldives,5,0,AFC Asian Cup qualification,5
Panama,Trinidad and Tobago,3,0,FIFA World Cup qualification,3
Macau,Laos,3,1,Friendly,2
Armenia,Poland,1,6,FIFA World Cup qualification,5
Myanmar,Thailand,1,3,Friendly,2
Hong Kong,Laos,4,0,Friendly,4
Iran,Togo,2,0,Friendly,2
Northern Ireland,Germany,1,3,FIFA World Cup qualification,2
Qatar,Singapore,3,1,Friendly,2
Romania,Kazakhstan,3,1,FIFA World Cup qualification,2
San Marino,Norway,0,8,FIFA World Cup qualification,8
Taiwan,Mongolia,4,2,Friendly,2
Republic of Ireland,Moldova,2,0,FIFA World Cup qualification,2
Kosovo,Ukraine,0,2,FIFA World Cup qualification,2
Mexico,Trinidad and Tobago,3,1,FIFA World Cup qualification,2
Spain,Albania,3,0,FIFA World Cup qualification,3
Turkey,Iceland,0,3,FIFA World Cup qualification,3
United States,Panama,4,0,FIFA World Cup qualification,4
Andorra,Portugal,0,2,FIFA World Cup qualification,2
Belarus,Netherlands,1,3,FIFA World Cup qualification,2
Cameroon,Algeria,2,0,FIFA World Cup qualification,2
Cape Verde,Senegal,0,2,FIFA World Cup qualification,2
Gibraltar,Estonia,0,6,FIFA World Cup qualification,6
Guinea,Tunisia,1,4,FIFA World Cup qualification,3
Morocco,Gabon,3,0,FIFA World Cup qualification,3
Russia,South Korea,4,2,Friendly,2
Saudi Arabia,Jamaica,5,2,Friendly,3
South Africa,Burkina Faso,3,1,FIFA World Cup qualification,2
Sweden,Luxembourg,8,0,FIFA World Cup qualification,8
Switzerland,Hungary,5,2,FIFA World Cup qualification,3
Czech Republic,San Marino,5,0,FIFA World Cup qualification,5
Germany,Azerbaijan,5,1,FIFA World Cup qualification,4
Poland,Montenegro,4,2,FIFA World Cup qualification,2
Slovakia,Malta,3,0,FIFA World Cup qualification,3
Equatorial Guinea,Mauritius,3,1,Friendly,2
Iceland,Kosovo,2,0,FIFA World Cup qualification,2
North Macedonia,Liechtenstein,4,0,FIFA World Cup qualification,4
Ukraine,Croatia,0,2,FIFA World Cup qualification,2
Belgium,Cyprus,4,0,FIFA World Cup qualification,4
Brazil,Chile,3,0,FIFA World Cup qualification,3
Ecuador,Argentina,1,3,FIFA World Cup qualification,2
Greece,Gibraltar,4,0,FIFA World Cup qualification,4
Hong Kong,Malaysia,2,0,AFC Asian Cup qualification,2
South Korea,Morocco,1,3,Friendly,2
Latvia,Andorra,4,0,FIFA World Cup qualification,4
Lebanon,North Korea,5,0,AFC Asian Cup qualification,5
Maldives,Oman,1,3,AFC Asian Cup qualification,2
Netherlands,Sweden,2,0,FIFA World Cup qualification,2
Palestine,Bhutan,10,0,AFC Asian Cup qualification,10
Portugal,Switzerland,2,0,FIFA World Cup qualification,2
Saudi Arabia,Ghana,0,3,Friendly,3
Tajikistan,Nepal,3,0,AFC Asian Cup qualification,3
Uruguay,Bolivia,4,2,FIFA World Cup qualification,2
Vietnam,Cambodia,5,0,AFC Asian Cup qualification,5
India,Macau,4,1,AFC Asian Cup qualification,3
Grenada,Panama,0,5,Friendly,5
Nicaragua,Dominican Republic,0,3,Friendly,3
Armenia,Belarus,4,1,Friendly,3
Croatia,Greece,4,1,FIFA World Cup qualification,3
Finland,Estonia,3,0,Friendly,3
Hong Kong,Bahrain,0,2,Friendly,2
Romania,Turkey,2,0,Friendly,2
Algeria,Nigeria,3,0,FIFA World Cup qualification,3
China PR,Serbia,0,2,Friendly,2
France,Wales,2,0,Friendly,2
Japan,Brazil,1,3,Friendly,2
North Korea,Malaysia,4,1,AFC Asian Cup qualification,3
Portugal,Saudi Arabia,3,0,Friendly,3
South Africa,Senegal,0,2,FIFA World Cup qualification,2
DR Congo,Guinea,3,1,FIFA World Cup qualification,2
Ivory Coast,Morocco,0,2,FIFA World Cup qualification,2
North Macedonia,Norway,2,0,Friendly,2
Namibia,Zimbabwe,3,1,Friendly,2
Spain,Costa Rica,5,0,Friendly,5
Malta,Estonia,0,3,Friendly,3
Togo,Mauritius,6,0,Friendly,6
Malaysia,North Korea,1,4,AFC Asian Cup qualification,3
Algeria,Central African Republic,3,0,Friendly,3
Argentina,Nigeria,2,4,Friendly,2
Bhutan,Oman,2,4,AFC Asian Cup qualification,2
Burkina Faso,Cape Verde,4,0,FIFA World Cup qualification,4
China PR,Colombia,0,4,Friendly,4
Republic of Ireland,Denmark,1,5,FIFA World Cup qualification,4
Palestine,Maldives,8,1,AFC Asian Cup qualification,7
Romania,Netherlands,0,3,Friendly,3
Singapore,Bahrain,0,3,AFC Asian Cup qualification,3
Australia,Honduras,3,1,FIFA World Cup qualification,2
Peru,New Zealand,2,0,FIFA World Cup qualification,2
Fiji,Estonia,0,2,Friendly,2
Laos,Philippines,1,3,Friendly,2
Fiji,Tuvalu,8,0,Pacific Mini Games,8
Indonesia,Brunei,4,0,Friendly,4
Kyrgyzstan,Mongolia,3,0,Friendly,3
Tonga,Solomon Islands,0,8,Pacific Mini Games,8
Kenya,Rwanda,2,0,CECAFA Cup,2
Taiwan,Philippines,3,0,Friendly,3
Brunei,Kyrgyzstan,0,4,Friendly,4
Taiwan,Timor-Leste,3,1,Friendly,2
South Sudan,Ethiopia,0,3,CECAFA Cup,3
Taiwan,Laos,2,0,Friendly,2
Zanzibar,Rwanda,3,1,CECAFA Cup,2
Vanuatu,Tonga,5,0,Pacific Mini Games,5
Burundi,Ethiopia,4,1,CECAFA Cup,3
Uganda,South Sudan,5,1,CECAFA Cup,4
Tonga,New Caledonia,2,4,Pacific Mini Games,2
Solomon Islands,Tuvalu,6,0,Pacific Mini Games,6
Fiji,Tonga,4,0,Pacific Mini Games,4
Vanuatu,Tuvalu,10,0,Pacific Mini Games,10
Japan,South Korea,1,4,EAFF Championship,3
Qatar,Yemen,4,0,Gulf Cup,4
Saudi Arabia,Oman,0,2,Gulf Cup,2
Iraq,Yemen,3,0,Gulf Cup,3
Indonesia,Iceland,0,6,Friendly,6
Morocco,Mauritania,4,0,African Nations Championship,4
Indonesia,Iceland,1,4,Friendly,3
Zambia,Uganda,3,1,African Nations Championship,2
Libya,Equatorial Guinea,3,0,African Nations Championship,3
Morocco,Guinea,3,1,African Nations Championship,2
Ivory Coast,Zambia,0,2,African Nations Championship,2
Congo,Burkina Faso,2,0,African Nations Championship,2
Equatorial Guinea,Nigeria,1,3,African Nations Championship,2
Morocco,Namibia,2,0,African Nations Championship,2
Morocco,Libya,3,1,African Nations Championship,2
Morocco,Nigeria,4,0,African Nations Championship,4
Saudi Arabia,Moldova,3,0,Friendly,3
Iraq,Saudi Arabia,4,1,Friendly,3
Iran,Sierra Leone,4,0,Friendly,4
Algeria,Tanzania,4,1,Friendly,3
Belize,Grenada,4,2,Friendly,2
Burkina Faso,Guinea-Bissau,2,0,Friendly,2
China PR,Wales,0,6,Friendly,6
Dominican Republic,Turks and Caicos Islands,4,0,Friendly,4
Kyrgyzstan,Myanmar,5,1,AFC Asian Cup qualification,4
Nicaragua,Cuba,3,1,Friendly,2
Austria,Slovenia,3,0,Friendly,3
Italy,Argentina,0,2,Friendly,2
Mexico,Iceland,3,0,Friendly,3
Norway,Australia,4,1,Friendly,3
Peru,Croatia,2,0,Friendly,2
Russia,Brazil,0,3,Friendly,3
Uruguay,Czech Republic,2,0,Friendly,2
Georgia,Lithuania,4,0,Friendly,4
Mauritania,Guinea,2,0,Friendly,2
Uganda,São Tomé and Príncipe,3,1,Friendly,2
Zambia,South Africa,0,2,Friendly,2
Faroe Islands,Liechtenstein,3,0,Friendly,3
Kuwait,Cameroon,1,3,Friendly,2
Yorkshire,Chagos Islands,6,0,Friendly,6
China PR,Czech Republic,1,4,Friendly,3
Finland,Malta,5,0,Friendly,5
Portugal,Netherlands,0,3,Friendly,3
Bahrain,Turkmenistan,4,0,AFC Asian Cup qualification,4
Belgium,Saudi Arabia,4,0,Friendly,4
Georgia,Estonia,2,0,Friendly,2
North Korea,Hong Kong,2,0,AFC Asian Cup qualification,2
Kosovo,Burkina Faso,2,0,Friendly,2
Luxembourg,Austria,0,4,Friendly,4
Maldives,Bhutan,7,0,AFC Asian Cup qualification,7
Mongolia,Mauritius,0,2,Friendly,2
Morocco,Uzbekistan,2,0,Friendly,2
Peru,Iceland,3,1,Friendly,2
Russia,France,1,3,Friendly,2
Serbia,Nigeria,2,0,Friendly,2
Slovenia,Belarus,0,2,Friendly,2
Spain,Argentina,6,1,Friendly,5
Switzerland,Panama,6,0,Friendly,6
Tanzania,DR Congo,2,0,Friendly,2
Malaysia,Bhutan,7,0,Friendly,7
Barawa,Chagos Islands,4,1,Friendly,3
Barawa,Yorkshire,2,7,Friendly,5
Saint Kitts and Nevis,Jamaica,1,3,Friendly,2
Antigua and Barbuda,Jamaica,0,2,Friendly,2
Barawa,Surrey,1,3,Friendly,2
Algeria,Saudi Arabia,0,2,Friendly,2
Kuwait,Palestine,2,0,Friendly,2
Saudi Arabia,Greece,2,0,Friendly,2
Jordan,Cyprus,3,0,Friendly,3
United States,Bolivia,3,0,Friendly,3
France,Republic of Ireland,2,0,Friendly,2
South Korea,Honduras,2,0,Friendly,2
Argentina,Haiti,4,0,Friendly,4
Albania,Kosovo,0,3,Friendly,3
Azerbaijan,Kyrgyzstan,3,0,Friendly,3
Peru,Scotland,2,0,Friendly,2
Comoros,Mozambique,0,3,COSAFA Cup,3
Japan,Ghana,0,2,Friendly,2
Estonia,Lithuania,2,0,Baltic Cup,2
Ellan Vannin,Cascadia,4,1,CONIFA World Football Cup,3
Barawa,Tamil Eelam,4,0,CONIFA World Football Cup,4
Abkhazia,Tibet,3,0,CONIFA World Football Cup,3
Székely Land,Tuvalu,4,0,CONIFA World Football Cup,4
Padania,Matabeleland,6,1,CONIFA World Football Cup,5
Panjab,Kabylia,8,0,CONIFA World Football Cup,8
France,Italy,3,1,Friendly,2
South Korea,Bosnia and Herzegovina,1,3,Friendly,2
Czech Republic,Australia,0,4,Friendly,4
Botswana,Mauritius,6,0,COSAFA Cup,6
India,Taiwan,5,0,Intercontinental Cup,5
Thailand,China PR,0,2,Friendly,2
Montenegro,Slovenia,0,2,Friendly,2
Ellan Vannin,Tamil Eelam,2,0,CONIFA World Football Cup,2
Abkhazia,Kárpátalja,0,2,CONIFA World Football Cup,2
Northern Cyprus,Tibet,3,1,CONIFA World Football Cup,2
Székely Land,Matabeleland,5,0,CONIFA World Football Cup,5
Padania,Tuvalu,8,0,CONIFA World Football Cup,8
Albania,Ukraine,1,4,Friendly,3
Saudi Arabia,Peru,0,3,Friendly,3
Croatia,Brazil,0,2,Friendly,2
Costa Rica,Northern Ireland,3,0,Friendly,3
Tamil Eelam,Cascadia,0,6,CONIFA World Football Cup,6
Barawa,Ellan Vannin,2,0,CONIFA World Football Cup,2
Kárpátalja,Tibet,5,1,CONIFA World Football Cup,4
Padania,Székely Land,3,1,CONIFA World Football Cup,2
Tuvalu,Matabeleland,1,3,CONIFA World Football Cup,2
Western Armenia,Kabylia,4,0,CONIFA World Football Cup,4
India,Kenya,3,0,Intercontinental Cup,3
Romania,Finland,2,0,Friendly,2
Kazakhstan,Azerbaijan,3,0,Friendly,3
Martinique,French Guiana,3,0,Friendly,3
South Africa,Namibia,4,1,COSAFA Cup,3
Eswatini,Botswana,0,2,COSAFA Cup,2
Abkhazia,Tamil Eelam,6,0,CONIFA World Football Cup,6
United Koreans in Japan,Tuvalu,5,0,CONIFA World Football Cup,5
Barawa,Northern Cyprus,0,8,CONIFA World Football Cup,8
Padania,Panjab,2,0,CONIFA World Football Cup,2
Kárpátalja,Cascadia,3,1,CONIFA World Football Cup,2
Western Armenia,Székely Land,0,4,CONIFA World Football Cup,4
Belgium,Egypt,3,0,Friendly,3
England,Costa Rica,2,0,Friendly,2
Uruguay,Uzbekistan,3,0,Friendly,3
Portugal,Algeria,3,0,Friendly,3
Guadeloupe,French Guiana,0,2,Friendly,2
Tibet,Kabylia,1,8,CONIFA World Football Cup,7
Abkhazia,United Koreans in Japan,2,0,CONIFA World Football Cup,2
Barawa,Panjab,0,5,CONIFA World Football Cup,5
Cascadia,Western Armenia,4,0,CONIFA World Football Cup,4
Kárpátalja,Székely Land,4,2,CONIFA World Football Cup,2
Switzerland,Japan,2,0,Friendly,2
Taiwan,Kenya,0,4,Intercontinental Cup,4
South Africa,Botswana,3,0,COSAFA Cup,3
Zambia,Zimbabwe,2,4,COSAFA Cup,2
Serbia,Bolivia,5,1,Friendly,4
Denmark,Mexico,2,0,Friendly,2
Estonia,Morocco,1,3,Friendly,2
Latvia,Azerbaijan,1,3,Friendly,2
Finland,Belarus,2,0,Friendly,2
Kabylia,Abkhazia,0,2,CONIFA World Football Cup,2
Barawa,Western Armenia,0,7,CONIFA World Football Cup,7
Austria,Brazil,0,3,Friendly,3
India,Kenya,2,0,Intercontinental Cup,2
South Korea,Senegal,0,2,Friendly,2
Belgium,Costa Rica,4,1,Friendly,3
Japan,Paraguay,4,2,Friendly,2
Poland,Lithuania,4,0,Friendly,4
Russia,Saudi Arabia,5,0,FIFA World Cup,5
Croatia,Nigeria,2,0,FIFA World Cup,2
Belgium,Panama,3,0,FIFA World Cup,3
Russia,Egypt,3,1,FIFA World Cup,2
Argentina,Croatia,0,3,FIFA World Cup,3
Brazil,Costa Rica,2,0,FIFA World Cup,2
Nigeria,Iceland,2,0,FIFA World Cup,2
Belgium,Tunisia,5,2,FIFA World Cup,3
England,Panama,6,1,FIFA World Cup,5
Poland,Colombia,0,3,FIFA World Cup,3
Russia,Uruguay,0,3,FIFA World Cup,3
Australia,Peru,0,2,FIFA World Cup,2
South Korea,Germany,2,0,FIFA World Cup,2
Mexico,Sweden,0,3,FIFA World Cup,3
Serbia,Brazil,0,2,FIFA World Cup,2
Brazil,Mexico,2,0,FIFA World Cup,2
Uruguay,France,0,2,FIFA World Cup,2
Sweden,England,0,2,FIFA World Cup,2
Belgium,England,2,0,FIFA World Cup,2
France,Croatia,4,2,FIFA World Cup,2
Palestine,Iraq,0,3,Friendly,3
Guatemala,Cuba,3,0,Friendly,3
Grenada,Jamaica,1,5,Friendly,4
Barbados,Cuba,0,2,Friendly,2
Macau,Solomon Islands,1,4,Friendly,3
Timor-Leste,Brunei,3,1,AFF Championship qualification,2
Guam,Northern Mariana Islands,4,0,EAFF Championship,4
Mongolia,Macau,4,1,EAFF Championship,3
Macau,Guam,2,0,EAFF Championship,2
Mongolia,Northern Mariana Islands,9,0,EAFF Championship,9
Bangladesh,Bhutan,2,0,SAFF Cup,2
Slovakia,Denmark,3,0,Friendly,3
India,Sri Lanka,2,0,SAFF Cup,2
Wales,Republic of Ireland,4,1,UEFA Nations League,3
Norway,Cyprus,2,0,UEFA Nations League,2
Kazakhstan,Georgia,0,2,UEFA Nations League,2
Gibraltar,North Macedonia,0,2,UEFA Nations League,2
Austria,Sweden,2,0,Friendly,2
Trinidad and Tobago,United Arab Emirates,2,0,Friendly,2
Nepal,Bhutan,4,0,SAFF Cup,4
Guyana,Barbados,3,0,CONCACAF Nations League qualification,3
Faroe Islands,Malta,3,1,UEFA Nations League,2
Argentina,Guatemala,3,0,Friendly,3
Taiwan,Malaysia,2,0,Friendly,2
Ecuador,Jamaica,2,0,Friendly,2
South Korea,Costa Rica,2,0,Friendly,2
Mexico,Uruguay,1,4,Friendly,3
Scotland,Belgium,0,4,Friendly,4
United States,Brazil,0,2,Friendly,2
Anguilla,French Guiana,0,5,CONCACAF Nations League qualification,5
Antigua and Barbuda,Saint Lucia,0,3,CONCACAF Nations League qualification,3
Belize,Bahamas,4,0,CONCACAF Nations League qualification,4
Switzerland,Iceland,6,0,UEFA Nations League,6
Belarus,San Marino,5,0,UEFA Nations League,5
Luxembourg,Moldova,4,0,UEFA Nations League,4
Mauritania,Burkina Faso,2,0,African Cup of Nations qualification,2
Egypt,Niger,6,0,African Cup of Nations qualification,6
Pakistan,Bhutan,3,0,SAFF Cup,3
Bangladesh,Nepal,0,2,SAFF Cup,2
Saint Vincent and the Grenadines,Nicaragua,0,2,CONCACAF Nations League qualification,2
Cuba,Turks and Caicos Islands,11,0,CONCACAF Nations League qualification,11
Denmark,Wales,2,0,UEFA Nations League,2
North Macedonia,Armenia,2,0,UEFA Nations League,2
Liechtenstein,Gibraltar,2,0,UEFA Nations League,2
India,Maldives,2,0,SAFF Cup,2
Bonaire,Dominican Republic,0,5,CONCACAF Nations League qualification,5
United States Virgin Islands,Canada,0,8,CONCACAF Nations League qualification,8
Aruba,Bermuda,3,1,CONCACAF Nations League qualification,2
Jamaica,Cayman Islands,4,0,CONCACAF Nations League qualification,4
Scotland,Albania,2,0,UEFA Nations League,2
Montenegro,Lithuania,2,0,UEFA Nations League,2
Kosovo,Faroe Islands,2,0,UEFA Nations League,2
Cambodia,Malaysia,1,3,Friendly,2
Russia,Czech Republic,5,1,Friendly,4
Haiti,Sint Maarten,13,0,CONCACAF Nations League qualification,13
Curaçao,Grenada,10,0,CONCACAF Nations League qualification,10
Iceland,Belgium,0,3,UEFA Nations League,3
Spain,Croatia,6,0,UEFA Nations League,6
San Marino,Luxembourg,0,3,UEFA Nations League,3
Ecuador,Guatemala,2,0,Friendly,2
Japan,Costa Rica,3,0,Kirin Challenge Cup,3
Laos,United Arab Emirates,0,3,Friendly,3
Northern Ireland,Israel,3,0,Friendly,3
Panama,Venezuela,0,2,Friendly,2
Qatar,Palestine,3,0,Friendly,3
Singapore,Fiji,2,0,Friendly,2
Saint Martin,Guadeloupe,0,3,CONCACAF Nations League qualification,3
Brazil,El Salvador,5,0,Friendly,5
India,Pakistan,3,1,SAFF Cup,2
Nepal,Maldives,0,3,SAFF Cup,3
Indonesia,Myanmar,3,0,Friendly,3
Montenegro,Serbia,0,2,UEFA Nations League,2
Faroe Islands,Azerbaijan,0,3,UEFA Nations League,3
Kosovo,Malta,3,1,UEFA Nations League,2
Argentina,Iraq,4,0,Friendly,4
United States,Colombia,2,4,Friendly,2
Wales,Spain,1,4,Friendly,3
Congo,Liberia,3,1,African Cup of Nations qualification,2
Moldova,San Marino,2,0,UEFA Nations League,2
Japan,Panama,3,0,Kirin Challenge Cup,3
Peru,Chile,3,0,Friendly,3
Saudi Arabia,Brazil,0,2,Friendly,2
Singapore,Mongolia,2,0,Friendly,2
Sri Lanka,Malaysia,1,4,Friendly,3
Gabon,South Sudan,3,0,African Cup of Nations qualification,3
Ivory Coast,Central African Republic,4,0,African Cup of Nations qualification,4
Angola,Mauritania,4,1,African Cup of Nations qualification,3
Egypt,Eswatini,4,1,African Cup of Nations qualification,3
Cape Verde,Tanzania,3,0,African Cup of Nations qualification,3
Basque Country,Venezuela,4,2,Friendly,2
United States Virgin Islands,Curaçao,0,5,CONCACAF Nations League qualification,5
Bahamas,Antigua and Barbuda,0,6,CONCACAF Nations League qualification,6
Dominican Republic,Cayman Islands,3,0,CONCACAF Nations League qualification,3
Bermuda,Sint Maarten,12,0,CONCACAF Nations League qualification,12
Grenada,Cuba,0,2,CONCACAF Nations League qualification,2
Netherlands,Germany,3,0,UEFA Nations League,3
Georgia,Andorra,3,0,UEFA Nations League,3
North Macedonia,Liechtenstein,4,1,UEFA Nations League,3
Myanmar,Bolivia,0,3,Friendly,3
Uzbekistan,North Korea,2,0,Friendly,2
Nigeria,Libya,4,0,African Cup of Nations qualification,4
Turks and Caicos Islands,Guyana,0,8,CONCACAF Nations League qualification,8
Suriname,British Virgin Islands,5,0,CONCACAF Nations League qualification,5
El Salvador,Barbados,3,0,CONCACAF Nations League qualification,3
Russia,Turkey,2,0,UEFA Nations League,2
Israel,Albania,2,0,UEFA Nations League,2
Lithuania,Montenegro,1,4,UEFA Nations League,3
Scotland,Portugal,1,3,Friendly,2
Saint Martin,Saint Kitts and Nevis,0,10,CONCACAF Nations League qualification,10
Bonaire,Jamaica,0,6,CONCACAF Nations League qualification,6
Nicaragua,Anguilla,6,0,CONCACAF Nations League qualification,6
Bosnia and Herzegovina,Northern Ireland,2,0,UEFA Nations League,2
Finland,Greece,2,0,UEFA Nations League,2
Luxembourg,San Marino,3,0,UEFA Nations League,3
Kuwait,Australia,0,4,Friendly,4
Kazakhstan,Andorra,4,0,UEFA Nations League,4
Latvia,Georgia,0,3,UEFA Nations League,3
Armenia,North Macedonia,4,0,UEFA Nations League,4
Bahrain,Myanmar,4,1,Friendly,3
China PR,Syria,2,0,Friendly,2
Colombia,Costa Rica,3,1,Friendly,2
Denmark,Austria,2,0,Friendly,2
Laos,Mongolia,1,4,Friendly,3
United Arab Emirates,Venezuela,0,2,Friendly,2
Uzbekistan,Qatar,2,0,Friendly,2
Eswatini,Egypt,0,2,African Cup of Nations qualification,2
Tanzania,Cape Verde,2,0,African Cup of Nations qualification,2
Martinique,British Virgin Islands,4,0,CONCACAF Nations League qualification,4
Canada,Dominica,5,0,CONCACAF Nations League qualification,5
Malaysia,Maldives,3,0,Friendly,3
Laos,Vietnam,0,3,AFF Championship,3
Thailand,Timor-Leste,7,0,AFF Championship,7
North Korea,Mongolia,4,1,EAFF Championship,3
Myanmar,Cambodia,4,1,AFF Championship,3
Malaysia,Laos,3,1,AFF Championship,2
Indonesia,Timor-Leste,3,1,AFF Championship,2
Belgium,Iceland,2,0,UEFA Nations League,2
Hungary,Estonia,2,0,UEFA Nations League,2
Luxembourg,Belarus,0,2,UEFA Nations League,2
England,United States,3,0,Friendly,3
Germany,Russia,3,0,Friendly,3
Israel,Guatemala,7,0,Friendly,7
Peru,Ecuador,0,2,Friendly,2
Netherlands,France,2,0,UEFA Nations League,2
Slovakia,Ukraine,4,1,UEFA Nations League,3
Gibraltar,Armenia,2,6,UEFA Nations League,4
Liechtenstein,North Macedonia,0,2,UEFA Nations League,2
Argentina,Mexico,2,0,Friendly,2
Laos,Myanmar,1,3,AFF Championship,2
Vietnam,Malaysia,2,0,AFF Championship,2
Morocco,Cameroon,2,0,African Cup of Nations qualification,2
South Sudan,Burundi,2,5,African Cup of Nations qualification,3
Taiwan,North Korea,0,2,EAFF Championship,2
Mongolia,Hong Kong,1,5,EAFF Championship,4
Grenada,Saint Martin,5,2,CONCACAF Nations League qualification,3
Aruba,Montserrat,0,2,CONCACAF Nations League qualification,2
Albania,Scotland,0,4,UEFA Nations League,4
Romania,Lithuania,3,0,UEFA Nations League,3
Malta,Kosovo,0,5,UEFA Nations League,5
Azerbaijan,Faroe Islands,2,0,UEFA Nations League,2
Thailand,Indonesia,4,2,AFF Championship,2
Gambia,Benin,3,1,African Cup of Nations qualification,2
Seychelles,Libya,1,8,African Cup of Nations qualification,7
Nicaragua,Haiti,0,2,CONCACAF Nations League qualification,2
Switzerland,Belgium,5,2,UEFA Nations League,3
Hungary,Finland,2,0,UEFA Nations League,2
San Marino,Belarus,0,2,UEFA Nations League,2
Ethiopia,Ghana,0,2,African Cup of Nations qualification,2
Barbados,United States Virgin Islands,3,0,CONCACAF Nations League qualification,3
Cyprus,Norway,0,2,UEFA Nations League,2
North Macedonia,Gibraltar,4,0,UEFA Nations League,4
Curaçao,Guadeloupe,6,0,CONCACAF Nations League qualification,6
Martinique,Antigua and Barbuda,4,2,CONCACAF Nations League qualification,2
Sweden,Russia,2,0,UEFA Nations League,2
Serbia,Lithuania,4,1,UEFA Nations League,3
Kosovo,Azerbaijan,4,0,UEFA Nations League,4
Argentina,Mexico,2,0,Friendly,2
Australia,Lebanon,3,0,Friendly,3
Chile,Honduras,4,1,Friendly,3
Japan,Kyrgyzstan,4,0,Kirin Challenge Cup,4
South Korea,Uzbekistan,4,0,Friendly,4
United Arab Emirates,Yemen,2,0,Friendly,2
Cambodia,Laos,3,1,AFF Championship,2
Sint Maarten,Dominica,0,2,CONCACAF Nations League qualification,2
Singapore,Timor-Leste,6,1,AFF Championship,5
Vietnam,Cambodia,3,0,AFF Championship,3
Malaysia,Myanmar,3,0,AFF Championship,3
Thailand,Singapore,3,0,AFF Championship,3
Palestine,Pakistan,2,0,Friendly,2
Bahrain,Tajikistan,5,0,Friendly,5
Qatar,Jordan,2,0,Friendly,2
Afghanistan,Turkmenistan,0,2,Friendly,2
United Arab Emirates,Kuwait,0,2,Friendly,2
Bahrain,North Korea,4,0,Friendly,4
Australia,Oman,5,0,Friendly,5
Philippines,Vietnam,2,4,Friendly,2
Oman,Thailand,2,0,Friendly,2
Thailand,India,1,4,AFC Asian Cup,3
Iran,Yemen,5,0,AFC Asian Cup,5
Saudi Arabia,North Korea,4,0,AFC Asian Cup,4
Qatar,Lebanon,2,0,AFC Asian Cup,2
Jordan,Syria,2,0,AFC Asian Cup,2
United Arab Emirates,India,2,0,AFC Asian Cup,2
Palestine,Australia,0,3,AFC Asian Cup,3
Philippines,China PR,0,3,AFC Asian Cup,3
Vietnam,Iran,0,2,AFC Asian Cup,2
Yemen,Iraq,0,3,AFC Asian Cup,3
Lebanon,Saudi Arabia,0,2,AFC Asian Cup,2
North Korea,Qatar,0,6,AFC Asian Cup,6
Turkmenistan,Uzbekistan,0,4,AFC Asian Cup,4
South Korea,China PR,2,0,AFC Asian Cup,2
Kyrgyzstan,Philippines,3,1,AFC Asian Cup,2
Vietnam,Yemen,2,0,AFC Asian Cup,2
Lebanon,North Korea,4,1,AFC Asian Cup,3
Saudi Arabia,Qatar,0,2,AFC Asian Cup,2
Oman,Turkmenistan,3,1,AFC Asian Cup,2
Iran,Oman,2,0,AFC Asian Cup,2
China PR,Iran,0,3,AFC Asian Cup,3
United States,Panama,3,0,Friendly,3
Iran,Japan,0,3,AFC Asian Cup,3
United Arab Emirates,Qatar,0,4,AFC Asian Cup,4
Japan,Qatar,1,3,AFC Asian Cup,2
United States,Costa Rica,2,0,Friendly,2
Cuba,Bermuda,5,0,Friendly,5
Barbados,Grenada,3,0,Friendly,3
El Salvador,Guatemala,3,1,Friendly,2
Bahamas,Turks and Caicos Islands,6,1,Friendly,5
Fiji,New Caledonia,3,0,Friendly,3
Solomon Islands,Vanuatu,3,1,Friendly,2
Mauritius,New Caledonia,3,1,Friendly,2
Northern Ireland,Estonia,2,0,UEFA Euro qualification,2
Netherlands,Belarus,4,0,UEFA Euro qualification,4
Slovakia,Hungary,2,0,UEFA Euro qualification,2
North Macedonia,Latvia,3,1,UEFA Euro qualification,2
Cyprus,San Marino,5,0,UEFA Euro qualification,5
Belgium,Russia,3,1,UEFA Euro qualification,2
Kazakhstan,Scotland,3,0,UEFA Euro qualification,3
Argentina,Venezuela,1,3,Friendly,2
Mexico,Chile,3,1,Friendly,2
England,Czech Republic,5,0,UEFA Euro qualification,5
Albania,Turkey,0,2,UEFA Euro qualification,2
Andorra,Iceland,0,2,UEFA Euro qualification,2
Moldova,France,1,4,UEFA Euro qualification,3
Anguilla,United States Virgin Islands,0,3,CONCACAF Nations League qualification,3
Georgia,Switzerland,0,2,UEFA Euro qualification,2
Italy,Finland,2,0,UEFA Euro qualification,2
Liechtenstein,Greece,0,2,UEFA Euro qualification,2
Senegal,Madagascar,2,0,African Cup of Nations qualification,2
Cameroon,Comoros,3,0,African Cup of Nations qualification,3
Mali,South Sudan,3,0,African Cup of Nations qualification,3
Zambia,Namibia,4,1,African Cup of Nations qualification,3
Dominica,Bahamas,4,0,CONCACAF Nations League qualification,4
Suriname,Saint Kitts and Nevis,2,0,CONCACAF Nations League qualification,2
Israel,Austria,4,2,UEFA Euro qualification,2
Poland,Latvia,2,0,UEFA Euro qualification,2
San Marino,Scotland,0,2,UEFA Euro qualification,2
Kazakhstan,Russia,0,4,UEFA Euro qualification,4
Cyprus,Belgium,0,2,UEFA Euro qualification,2
Zimbabwe,Congo,2,0,African Cup of Nations qualification,2
Tanzania,Uganda,3,0,African Cup of Nations qualification,3
Puerto Rico,Grenada,0,2,CONCACAF Nations League qualification,2
Canada,French Guiana,4,1,CONCACAF Nations League qualification,3
Dominican Republic,Bermuda,1,3,CONCACAF Nations League qualification,2
El Salvador,Jamaica,2,0,CONCACAF Nations League qualification,2
Myanmar,Indonesia,0,2,Friendly,2
Montenegro,England,1,5,UEFA Euro qualification,4
Turkey,Moldova,4,0,UEFA Euro qualification,4
Andorra,Albania,0,3,UEFA Euro qualification,3
France,Iceland,4,0,UEFA Euro qualification,4
Czech Republic,Brazil,1,3,Friendly,2
Ghana,Mauritania,3,1,Friendly,2
Paraguay,Mexico,2,4,Friendly,2
Peru,El Salvador,0,2,Friendly,2
Malta,Spain,0,2,UEFA Euro qualification,2
Romania,Faroe Islands,4,1,UEFA Euro qualification,3
Italy,Liechtenstein,6,0,UEFA Euro qualification,6
Armenia,Finland,0,2,UEFA Euro qualification,2
Botswana,Seychelles,2,0,African Nations Championship qualification,2
Yorkshire,Somaliland,6,2,Friendly,4
Seychelles,Botswana,1,3,African Nations Championship qualification,2
Kernow,Barawa,5,0,Friendly,5
Cascadia,Chagos Islands,6,3,Friendly,3
Malawi,Seychelles,3,0,COSAFA Cup,3
Namibia,Seychelles,3,0,COSAFA Cup,3
Zimbabwe,Comoros,2,0,COSAFA Cup,2
France,Bolivia,2,0,Friendly,2
Malaysia,Nepal,2,0,Friendly,2
Abkhazia,Chameria,3,1,CONIFA European Football Cup,2
Padania,Székely Land,4,0,CONIFA European Football Cup,4
Parishes of Jersey,Chagos Islands,9,2,Atlantic Heritage Cup,7
Colombia,Panama,3,0,Friendly,3
Vanuatu,Tahiti,2,0,Friendly,2
Artsakh,Chameria,1,4,CONIFA European Football Cup,3
Székely Land,Western Armenia,0,5,CONIFA European Football Cup,5
Chameria,Sápmi,4,0,CONIFA European Football Cup,4
Brazil,Qatar,2,0,Friendly,2
Mexico,Venezuela,3,1,Friendly,2
Portugal,Switzerland,3,1,UEFA Nations League,2
Iran,Syria,5,0,Friendly,5
Slovakia,Jordan,5,1,Friendly,4
England,Netherlands,1,3,UEFA Nations League,2
Padania,Sápmi,4,0,CONIFA European Football Cup,4
Cambodia,Pakistan,2,0,FIFA World Cup qualification,2
Mongolia,Brunei,2,0,FIFA World Cup qualification,2
Ukraine,Serbia,5,0,UEFA Euro qualification,5
Georgia,Gibraltar,3,0,UEFA Euro qualification,3
Faroe Islands,Spain,1,4,UEFA Euro qualification,3
Sweden,Malta,3,0,UEFA Euro qualification,3
Latvia,Israel,0,3,UEFA Euro qualification,3
Argentina,Nicaragua,5,1,Friendly,4
China PR,Philippines,2,0,Friendly,2
Ivory Coast,Comoros,3,1,Friendly,2
Tunisia,Iraq,2,0,Friendly,2
Uruguay,Panama,3,0,Friendly,3
Uzbekistan,North Korea,4,0,Friendly,4
Malaysia,Timor-Leste,7,1,FIFA World Cup qualification,6
Belarus,Germany,0,2,UEFA Euro qualification,2
Azerbaijan,Hungary,1,3,UEFA Euro qualification,2
Turkey,France,2,0,UEFA Euro qualification,2
Russia,San Marino,9,0,UEFA Euro qualification,9
Belgium,Kazakhstan,3,0,UEFA Euro qualification,3
Finland,Bosnia and Herzegovina,2,0,UEFA Euro qualification,2
Armenia,Liechtenstein,3,0,UEFA Euro qualification,3
Greece,Italy,0,3,UEFA Euro qualification,3
Angola,Guinea-Bissau,2,0,Friendly,2
Artsakh,Padania,2,0,CONIFA European Football Cup,2
Brazil,Honduras,7,0,Friendly,7
Japan,El Salvador,2,0,Kirin Challenge Cup,2
Paraguay,Guatemala,2,0,Friendly,2
Peru,Colombia,0,3,Friendly,3
United States,Venezuela,0,3,Friendly,3
Czech Republic,Montenegro,3,0,UEFA Euro qualification,3
Serbia,Lithuania,4,1,UEFA Euro qualification,3
Republic of Ireland,Gibraltar,2,0,UEFA Euro qualification,2
Denmark,Georgia,5,1,UEFA Euro qualification,4
Faroe Islands,Norway,0,2,UEFA Euro qualification,2
Malta,Romania,0,4,UEFA Euro qualification,4
Spain,Sweden,3,0,UEFA Euro qualification,3
North Macedonia,Austria,1,4,UEFA Euro qualification,3
Poland,Israel,4,0,UEFA Euro qualification,4
Latvia,Slovenia,0,5,UEFA Euro qualification,5
Germany,Estonia,8,0,UEFA Euro qualification,8
Azerbaijan,Slovakia,1,5,UEFA Euro qualification,4
Albania,Moldova,2,0,UEFA Euro qualification,2
Andorra,France,0,4,UEFA Euro qualification,4
Kazakhstan,San Marino,4,0,UEFA Euro qualification,4
Belgium,Scotland,3,0,UEFA Euro qualification,3
Liechtenstein,Finland,0,2,UEFA Euro qualification,2
Hong Kong,Taiwan,0,2,Friendly,2
Jordan,Indonesia,4,1,Friendly,3
Uzbekistan,Syria,2,0,Friendly,2
Guam,Bhutan,5,0,FIFA World Cup qualification,5
Sri Lanka,Macau,3,0,FIFA World Cup qualification,3
Malaysia,Timor-Leste,5,1,FIFA World Cup qualification,4
Ynys Môn,Saint Helena,7,2,Friendly,5
Madagascar,Mauritania,1,3,Friendly,2
Brazil,Bolivia,3,0,Copa América,3
Argentina,Colombia,0,2,Copa América,2
Canada,Martinique,4,0,Gold Cup,4
Mexico,Cuba,7,0,Gold Cup,7
Indonesia,Vanuatu,6,0,Friendly,6
Jersey,Orkney,5,0,Inter Games Football Tournament,5
Alderney,Hitra,2,4,Inter Games Football Tournament,2
Saint Helena,Shetland,1,6,Inter Games Football Tournament,5
Uruguay,Ecuador,4,0,Copa América,4
Costa Rica,Nicaragua,4,0,Gold Cup,4
Egypt,Guinea,3,1,Friendly,2
Ynys Môn,Orkney,3,1,Inter Games Football Tournament,2
Jersey,Western Isles,7,0,Inter Games Football Tournament,7
Isle of Man,Hitra,7,1,Inter Games Football Tournament,6
Japan,Chile,0,4,Copa América,4
Isle of Man,Alderney,6,1,Inter Games Football Tournament,5
Guernsey,Saint Helena,9,0,Inter Games Football Tournament,9
Bolivia,Peru,1,3,Copa América,2
Panama,Trinidad and Tobago,2,0,Gold Cup,2
United States,Guyana,4,0,Gold Cup,4
Benin,Mauritania,3,1,Friendly,2
Cuba,Martinique,0,3,Gold Cup,3
Mexico,Canada,3,1,Gold Cup,2
Ivory Coast,Zambia,4,1,Friendly,3
Jersey,Hitra,3,1,Inter Games Football Tournament,2
Nicaragua,Haiti,0,2,Gold Cup,2
Shetland,Isle of Man,0,5,Inter Games Football Tournament,5
DR Congo,Uganda,0,2,African Cup of Nations,2
Bolivia,Venezuela,1,3,Copa América,2
Guyana,Panama,2,4,Gold Cup,2
United States,Trinidad and Tobago,6,0,Gold Cup,6
Brazil,Peru,5,0,Copa América,5
Senegal,Tanzania,2,0,African Cup of Nations,2
Algeria,Kenya,2,0,African Cup of Nations,2
Qatar,Argentina,0,2,Copa América,2
Canada,Cuba,7,0,Gold Cup,7
Mali,Mauritania,4,1,African Cup of Nations,3
Bermuda,Nicaragua,2,0,Gold Cup,2
Cameroon,Guinea-Bissau,2,0,African Cup of Nations,2
Honduras,El Salvador,4,0,Gold Cup,4
Egypt,DR Congo,2,0,African Cup of Nations,2
Venezuela,Argentina,0,2,Copa América,2
Egypt,Uganda,2,0,African Cup of Nations,2
Zimbabwe,DR Congo,0,4,African Cup of Nations,4
Burundi,Guinea,0,2,African Cup of Nations,2
Madagascar,Nigeria,2,0,African Cup of Nations,2
Kenya,Senegal,0,3,African Cup of Nations,3
Tanzania,Algeria,0,3,African Cup of Nations,3
Namibia,Ivory Coast,1,4,African Cup of Nations,3
Guinea-Bissau,Ghana,0,2,African Cup of Nations,2
Brazil,Argentina,2,0,Copa América,2
Chile,Peru,0,3,Copa América,3
United States,Jamaica,3,1,Gold Cup,2
Algeria,Guinea,3,0,African Cup of Nations,3
Brazil,Peru,3,1,Copa América,2
India,Tajikistan,2,4,Intercontinental Cup,2
Samoa,Papua New Guinea,0,6,Pacific Games,6
American Samoa,New Caledonia,0,5,Pacific Games,5
Tuvalu,Solomon Islands,0,13,Pacific Games,13
Syria,North Korea,5,2,Intercontinental Cup,3
Papua New Guinea,Vanuatu,2,0,Pacific Games,2
Tuvalu,Tahiti,0,7,Pacific Games,7
American Samoa,Fiji,0,9,Pacific Games,9
Solomon Islands,New Caledonia,0,2,Pacific Games,2
Tajikistan,Syria,2,0,Intercontinental Cup,2
Madagascar,Tunisia,0,3,African Cup of Nations,3
Samoa,Tonga,2,0,Pacific Games,2
Solomon Islands,Tahiti,0,3,Pacific Games,3
India,North Korea,2,5,Intercontinental Cup,3
Tonga,Vanuatu,0,14,Pacific Games,14
Fiji,Tuvalu,10,1,Pacific Games,9
Solomon Islands,American Samoa,13,0,Pacific Games,13
Tahiti,New Caledonia,0,3,Pacific Games,3
Papua New Guinea,Tonga,8,0,Pacific Games,8
Samoa,Vanuatu,0,11,Pacific Games,11
New Caledonia,Tuvalu,11,0,Pacific Games,11
American Samoa,Tahiti,8,1,Pacific Games,7
Comoros,Namibia,0,2,African Nations Championship qualification,2
Burundi,South Sudan,2,0,African Nations Championship qualification,2
Somalia,Uganda,1,3,African Nations Championship qualification,2
Guinea-Bissau,Mali,0,4,African Nations Championship qualification,4
Mauritius,Zimbabwe,0,4,African Nations Championship qualification,4
Uganda,Somalia,4,1,African Nations Championship qualification,3
Senegal,Liberia,3,0,African Nations Championship qualification,3
South Africa,Lesotho,0,3,African Nations Championship qualification,3
Zimbabwe,Mauritius,3,1,African Nations Championship qualification,2
Mali,Guinea-Bissau,3,0,African Nations Championship qualification,3
Taiwan,Guam,3,0,Friendly,3
United Arab Emirates,Dominican Republic,4,0,Friendly,4
China PR,Myanmar,4,1,Friendly,3
United Arab Emirates,Sri Lanka,5,1,Friendly,4
Liberia,Sierra Leone,3,1,FIFA World Cup qualification,2
Honduras,Puerto Rico,4,0,Friendly,4
Gibraltar,Denmark,0,6,UEFA Euro qualification,6
Faroe Islands,Sweden,0,4,UEFA Euro qualification,4
Norway,Malta,2,0,UEFA Euro qualification,2
Armenia,Italy,1,3,UEFA Euro qualification,2
Bosnia and Herzegovina,Liechtenstein,5,0,UEFA Euro qualification,5
Japan,Paraguay,2,0,Kirin Challenge Cup,2
Bermuda,Panama,1,4,CONCACAF Nations League,3
French Guiana,Belize,3,0,CONCACAF Nations League,3
United States Virgin Islands,Cayman Islands,0,2,CONCACAF Nations League,2
Barbados,Saint Martin,4,0,CONCACAF Nations League,4
Guatemala,Anguilla,10,0,CONCACAF Nations League,10
Philippines,Syria,2,5,FIFA World Cup qualification,3
Kuwait,Nepal,7,0,FIFA World Cup qualification,7
Palestine,Uzbekistan,2,0,FIFA World Cup qualification,2
Qatar,Afghanistan,6,0,FIFA World Cup qualification,6
North Korea,Lebanon,2,0,FIFA World Cup qualification,2
Sri Lanka,Turkmenistan,0,2,FIFA World Cup qualification,2
Chad,Sudan,1,3,FIFA World Cup qualification,2
Seychelles,Rwanda,0,3,FIFA World Cup qualification,3
United States,Mexico,0,3,Friendly,3
Germany,Netherlands,2,4,UEFA Euro qualification,2
Slovakia,Croatia,0,4,UEFA Euro qualification,4
Austria,Latvia,6,0,UEFA Euro qualification,6
Slovenia,Poland,2,0,UEFA Euro qualification,2
San Marino,Belgium,0,4,UEFA Euro qualification,4
Jamaica,Antigua and Barbuda,6,0,CONCACAF Nations League,6
Bonaire,British Virgin Islands,4,2,CONCACAF Nations League,2
Libya,Niger,2,0,Friendly,2
England,Bulgaria,4,0,UEFA Euro qualification,4
Lithuania,Ukraine,0,3,UEFA Euro qualification,3
Serbia,Portugal,2,4,UEFA Euro qualification,2
Iceland,Moldova,3,0,UEFA Euro qualification,3
France,Albania,4,1,UEFA Euro qualification,3
Canada,Cuba,6,0,CONCACAF Nations League,6
El Salvador,Saint Lucia,3,0,CONCACAF Nations League,3
Guadeloupe,Sint Maarten,5,1,CONCACAF Nations League,4
Switzerland,Gibraltar,4,0,UEFA Euro qualification,4
Spain,Faroe Islands,4,0,UEFA Euro qualification,4
Armenia,Bosnia and Herzegovina,4,2,UEFA Euro qualification,2
Panama,Bermuda,0,2,CONCACAF Nations League,2
Suriname,Nicaragua,6,0,CONCACAF Nations League,6
Northern Ireland,Germany,0,2,UEFA Euro qualification,2
Estonia,Netherlands,0,4,UEFA Euro qualification,4
Latvia,North Macedonia,0,2,UEFA Euro qualification,2
Scotland,Belgium,0,4,UEFA Euro qualification,4
San Marino,Cyprus,0,4,UEFA Euro qualification,4
Guyana,Jamaica,0,4,CONCACAF Nations League,4
Argentina,Mexico,4,0,Friendly,4
Ecuador,Bolivia,3,0,Friendly,3
Jordan,Paraguay,2,4,Friendly,2
Republic of Ireland,Bulgaria,3,1,Friendly,2
England,Kosovo,5,3,UEFA Euro qualification,2
Montenegro,Czech Republic,0,3,UEFA Euro qualification,3
Luxembourg,Serbia,1,3,UEFA Euro qualification,2
Lithuania,Portugal,1,5,UEFA Euro qualification,4
Albania,Iceland,4,2,UEFA Euro qualification,2
France,Andorra,3,0,UEFA Euro qualification,3
Moldova,Turkey,0,4,UEFA Euro qualification,4
Puerto Rico,Guatemala,0,5,CONCACAF Nations League,5
Turks and Caicos Islands,Guadeloupe,0,3,CONCACAF Nations League,3
Guam,Philippines,1,4,FIFA World Cup qualification,3
Maldives,China PR,0,5,FIFA World Cup qualification,5
Kuwait,Australia,0,3,FIFA World Cup qualification,3
Taiwan,Nepal,0,2,FIFA World Cup qualification,2
Hong Kong,Iran,0,2,FIFA World Cup qualification,2
Myanmar,Japan,0,2,FIFA World Cup qualification,2
Indonesia,Thailand,0,3,FIFA World Cup qualification,3
Turkmenistan,South Korea,0,2,FIFA World Cup qualification,2
Mozambique,Mauritius,2,0,FIFA World Cup qualification,2
Namibia,Eritrea,2,0,FIFA World Cup qualification,2
Rwanda,Seychelles,7,0,FIFA World Cup qualification,7
Togo,Comoros,2,0,FIFA World Cup qualification,2
Zimbabwe,Somalia,3,1,FIFA World Cup qualification,2
Burundi,Uganda,0,3,African Nations Championship qualification,3
Central African Republic,DR Congo,0,2,African Nations Championship qualification,2
Zimbabwe,Lesotho,3,1,African Nations Championship qualification,2
Niger,Ivory Coast,2,0,African Nations Championship qualification,2
Togo,Nigeria,4,1,African Nations Championship qualification,3
Bangladesh,Bhutan,4,1,Friendly,3
Mexico,Trinidad and Tobago,2,0,Friendly,2
Bangladesh,Bhutan,2,0,Friendly,2
Malaysia,Sri Lanka,6,0,Friendly,6
Mauritius,São Tomé and Príncipe,1,3,African Cup of Nations qualification,2
Netherlands,Northern Ireland,3,1,UEFA Euro qualification,2
Croatia,Hungary,3,0,UEFA Euro qualification,3
Austria,Israel,3,1,UEFA Euro qualification,2
Latvia,Poland,0,3,UEFA Euro qualification,3
Belgium,San Marino,9,0,UEFA Euro qualification,9
Russia,Scotland,4,0,UEFA Euro qualification,4
Venezuela,Bolivia,4,1,Friendly,3
Trinidad and Tobago,Honduras,0,2,CONCACAF Nations League,2
Belize,Saint Kitts and Nevis,0,4,CONCACAF Nations League,4
British Virgin Islands,Bahamas,0,4,CONCACAF Nations League,4
Sint Maarten,Turks and Caicos Islands,2,5,CONCACAF Nations League,3
China PR,Guam,7,0,FIFA World Cup qualification,7
Australia,Nepal,5,0,FIFA World Cup qualification,5
Iran,Cambodia,14,0,FIFA World Cup qualification,14
Iraq,Hong Kong,2,0,FIFA World Cup qualification,2
Uzbekistan,Yemen,5,0,FIFA World Cup qualification,5
Saudi Arabia,Singapore,3,0,FIFA World Cup qualification,3
Bangladesh,Qatar,0,2,FIFA World Cup qualification,2
Oman,Afghanistan,3,0,FIFA World Cup qualification,3
Japan,Mongolia,6,0,FIFA World Cup qualification,6
Kyrgyzstan,Myanmar,7,0,FIFA World Cup qualification,7
United Arab Emirates,Indonesia,5,0,FIFA World Cup qualification,5
South Korea,Sri Lanka,8,0,FIFA World Cup qualification,8
Portugal,Luxembourg,3,0,UEFA Euro qualification,3
Ukraine,Lithuania,2,0,UEFA Euro qualification,2
United States,Cuba,7,0,CONCACAF Nations League,7
Bermuda,Mexico,1,5,CONCACAF Nations League,4
Nicaragua,Dominica,3,1,CONCACAF Nations League,2
Faroe Islands,Romania,0,3,UEFA Euro qualification,3
Malta,Sweden,0,4,UEFA Euro qualification,4
Bosnia and Herzegovina,Finland,4,1,UEFA Euro qualification,3
Italy,Greece,2,0,UEFA Euro qualification,2
Ivory Coast,DR Congo,3,1,Friendly,2
Dominican Republic,Saint Lucia,3,0,CONCACAF Nations League,3
Montserrat,El Salvador,0,2,CONCACAF Nations League,2
Jamaica,Aruba,2,0,CONCACAF Nations League,2
Saint Martin,Cayman Islands,3,0,CONCACAF Nations League,3
Anguilla,Guatemala,0,5,CONCACAF Nations League,5
Estonia,Germany,0,3,UEFA Euro qualification,3
Poland,North Macedonia,2,0,UEFA Euro qualification,2
Scotland,San Marino,6,0,UEFA Euro qualification,6
Cyprus,Russia,0,5,UEFA Euro qualification,5
Kazakhstan,Belgium,0,2,UEFA Euro qualification,2
Ecuador,Argentina,1,6,Friendly,5
Niger,Central African Republic,0,2,Friendly,2
Kosovo,Montenegro,2,0,UEFA Euro qualification,2
Bulgaria,England,0,6,UEFA Euro qualification,6
Iceland,Andorra,2,0,UEFA Euro qualification,2
Moldova,Albania,0,4,UEFA Euro qualification,4
Venezuela,Trinidad and Tobago,2,0,Friendly,2
Guyana,Antigua and Barbuda,5,1,CONCACAF Nations League,4
Dominica,Nicaragua,0,4,CONCACAF Nations League,4
Switzerland,Republic of Ireland,2,0,UEFA Euro qualification,2
Israel,Latvia,3,1,UEFA Euro qualification,2
Finland,Armenia,3,0,UEFA Euro qualification,3
Liechtenstein,Italy,0,5,UEFA Euro qualification,5
Algeria,Colombia,3,0,Friendly,3
Bolivia,Haiti,3,1,Friendly,2
Denmark,Luxembourg,4,0,Friendly,4
Canada,United States,2,0,CONCACAF Nations League,2
Mexico,Panama,3,1,CONCACAF Nations League,2
Saint Lucia,El Salvador,0,2,CONCACAF Nations League,2
Aruba,Jamaica,0,6,CONCACAF Nations League,6
United States Virgin Islands,Barbados,0,4,CONCACAF Nations League,4
Syria,Guam,4,0,FIFA World Cup qualification,4
Jordan,Nepal,3,0,FIFA World Cup qualification,3
Taiwan,Australia,1,7,FIFA World Cup qualification,6
Cambodia,Iraq,0,4,FIFA World Cup qualification,4
Singapore,Uzbekistan,1,3,FIFA World Cup qualification,2
Tajikistan,Japan,0,3,FIFA World Cup qualification,3
Indonesia,Vietnam,1,3,FIFA World Cup qualification,2
Sri Lanka,Lebanon,0,3,FIFA World Cup qualification,3
Uganda,Burundi,3,0,African Nations Championship qualification,3
Morocco,Algeria,3,0,African Nations Championship qualification,3
Namibia,Madagascar,2,0,African Nations Championship qualification,2
Nigeria,Togo,2,0,African Nations Championship qualification,2
DR Congo,Central African Republic,4,1,African Nations Championship qualification,3
Mali,Mauritania,2,0,African Nations Championship qualification,2
Namibia,Zambia,0,2,Friendly,2
Uzbekistan,Kyrgyzstan,3,1,Friendly,2
Trinidad and Tobago,Anguilla,15,0,Friendly,15
Sudan,São Tomé and Príncipe,4,0,African Cup of Nations qualification,4
Angola,Gambia,1,3,African Cup of Nations qualification,2
Central African Republic,Burundi,2,0,African Cup of Nations qualification,2
Guinea-Bissau,Eswatini,3,0,African Cup of Nations qualification,3
Senegal,Congo,2,0,African Cup of Nations qualification,2
Ghana,South Africa,2,0,African Cup of Nations qualification,2
Mozambique,Rwanda,2,0,African Cup of Nations qualification,2
Algeria,Zambia,5,0,African Cup of Nations qualification,5
England,Montenegro,7,0,UEFA Euro qualification,7
Portugal,Lithuania,6,0,UEFA Euro qualification,6
Belize,French Guiana,2,0,CONCACAF Nations League,2
Bahamas,British Virgin Islands,3,0,CONCACAF Nations League,3
Ecuador,Trinidad and Tobago,3,0,Friendly,3
Qatar,Singapore,2,0,Friendly,2
Republic of Ireland,New Zealand,3,1,Friendly,2
Kuwait,Taiwan,9,0,FIFA World Cup qualification,9
Oman,Bangladesh,4,1,FIFA World Cup qualification,3
Kyrgyzstan,Japan,0,2,FIFA World Cup qualification,2
Turkmenistan,North Korea,3,1,FIFA World Cup qualification,2
Tunisia,Libya,4,1,African Cup of Nations qualification,3
Denmark,Gibraltar,6,0,UEFA Euro qualification,6
Norway,Faroe Islands,4,0,UEFA Euro qualification,4
Spain,Malta,7,0,UEFA Euro qualification,7
Romania,Sweden,0,2,UEFA Euro qualification,2
Finland,Liechtenstein,3,0,UEFA Euro qualification,3
Bosnia and Herzegovina,Italy,0,3,UEFA Euro qualification,3
United States,Canada,4,1,CONCACAF Nations League,3
Panama,Mexico,0,3,CONCACAF Nations League,3
Antigua and Barbuda,Jamaica,0,2,CONCACAF Nations League,2
Guyana,Aruba,4,2,CONCACAF Nations League,2
Suriname,Dominica,4,0,CONCACAF Nations League,4
Germany,Belarus,4,0,UEFA Euro qualification,4
Croatia,Slovakia,3,1,UEFA Euro qualification,2
Azerbaijan,Wales,0,2,UEFA Euro qualification,2
San Marino,Kazakhstan,1,3,UEFA Euro qualification,2
Russia,Belgium,1,4,UEFA Euro qualification,3
Guatemala,Puerto Rico,5,0,CONCACAF Nations League,5
Chad,Mali,0,2,African Cup of Nations qualification,2
Guinea,Namibia,2,0,African Cup of Nations qualification,2
Uganda,Malawi,2,0,African Cup of Nations qualification,2
Congo,Guinea-Bissau,3,0,African Cup of Nations qualification,3
Eswatini,Senegal,1,4,African Cup of Nations qualification,3
Lesotho,Nigeria,2,4,African Cup of Nations qualification,2
Kosovo,England,0,4,UEFA Euro qualification,4
Luxembourg,Portugal,0,2,UEFA Euro qualification,2
Albania,France,0,2,UEFA Euro qualification,2
Andorra,Turkey,0,2,UEFA Euro qualification,2
Honduras,Trinidad and Tobago,4,0,CONCACAF Nations League,4
French Guiana,Saint Kitts and Nevis,3,1,CONCACAF Nations League,2
Guadeloupe,Turks and Caicos Islands,10,0,CONCACAF Nations League,10
Niger,Madagascar,2,6,African Cup of Nations qualification,4
Gibraltar,Switzerland,1,6,UEFA Euro qualification,5
Spain,Romania,5,0,UEFA Euro qualification,5
Sweden,Faroe Islands,3,0,UEFA Euro qualification,3
Italy,Armenia,9,1,UEFA Euro qualification,8
Liechtenstein,Bosnia and Herzegovina,0,3,UEFA Euro qualification,3
Burundi,Morocco,0,3,African Cup of Nations qualification,3
Mauritania,Central African Republic,2,0,African Cup of Nations qualification,2
Germany,Northern Ireland,6,1,UEFA Euro qualification,5
Netherlands,Estonia,5,0,UEFA Euro qualification,5
Wales,Hungary,2,0,UEFA Euro qualification,2
Slovakia,Azerbaijan,2,0,UEFA Euro qualification,2
Japan,Venezuela,1,4,Kirin Challenge Cup,3
Scotland,Kazakhstan,3,1,UEFA Euro qualification,2
Belgium,Cyprus,6,1,UEFA Euro qualification,5
San Marino,Russia,0,5,UEFA Euro qualification,5
Cuba,United States,0,4,CONCACAF Nations League,4
El Salvador,Dominican Republic,2,0,CONCACAF Nations League,2
Barbados,Cayman Islands,3,0,CONCACAF Nations League,3
Puerto Rico,Anguilla,3,0,CONCACAF Nations League,3
Brazil,South Korea,3,0,Friendly,3
Montenegro,Belarus,2,0,Friendly,2
Maldives,Guam,3,1,FIFA World Cup qualification,2
Jordan,Taiwan,5,0,FIFA World Cup qualification,5
Hong Kong,Cambodia,2,0,FIFA World Cup qualification,2
Uzbekistan,Palestine,2,0,FIFA World Cup qualification,2
Malaysia,Indonesia,2,0,FIFA World Cup qualification,2
Turkmenistan,Sri Lanka,2,0,FIFA World Cup qualification,2
Guatemala,Antigua and Barbuda,8,0,Friendly,8
United Arab Emirates,Yemen,3,0,Gulf Cup,3
Saudi Arabia,Kuwait,1,3,Gulf Cup,2
United Arab Emirates,Iraq,0,2,Gulf Cup,2
Qatar,Yemen,6,0,Gulf Cup,6
Bahrain,Saudi Arabia,0,2,Gulf Cup,2
Qatar,United Arab Emirates,4,2,Gulf Cup,2
Kuwait,Bahrain,2,4,Gulf Cup,2
Oman,Saudi Arabia,1,3,Gulf Cup,2
South Korea,Hong Kong,2,0,EAFF Championship,2
Japan,Hong Kong,5,0,EAFF Championship,5
Hong Kong,China PR,0,2,EAFF Championship,2
Barbados,Canada,1,4,Friendly,3
Barbados,Canada,1,4,Friendly,3
Russia,Serbia,3,1,UEFA Nations League,2
Slovakia,Czech Republic,1,3,UEFA Nations League,2
Lithuania,Kazakhstan,0,2,UEFA Nations League,2
Belarus,Albania,0,2,UEFA Nations League,2
Denmark,Belgium,0,2,UEFA Nations League,2
Portugal,Croatia,4,1,UEFA Nations League,3
Cyprus,Montenegro,0,2,UEFA Nations League,2
Spain,Ukraine,4,0,UEFA Nations League,4
Northern Ireland,Norway,1,5,UEFA Nations League,4
Belgium,Iceland,5,1,UEFA Nations League,4
France,Croatia,4,2,UEFA Nations League,2
Sweden,Portugal,0,2,UEFA Nations League,2
Armenia,Estonia,2,0,UEFA Nations League,2
San Marino,Liechtenstein,0,2,UEFA Nations League,2
Denmark,Faroe Islands,4,0,Friendly,4
Estonia,Lithuania,1,3,Friendly,2
France,Ukraine,7,1,Friendly,6
Italy,Moldova,6,0,Friendly,6
Malta,Gibraltar,2,0,Friendly,2
Poland,Finland,5,1,Friendly,4
Slovenia,San Marino,4,0,Friendly,4
England,Wales,3,0,Friendly,3
Bulgaria,Hungary,1,3,UEFA Euro qualification,2
Burkina Faso,DR Congo,3,0,Friendly,3
Mali,Ghana,3,0,Friendly,3
Morocco,Senegal,3,1,Friendly,2
Tunisia,Sudan,3,0,Friendly,3
Colombia,Venezuela,3,0,FIFA World Cup qualification,3
Brazil,Bolivia,5,0,FIFA World Cup qualification,5
Luxembourg,Cyprus,2,0,UEFA Nations League,2
Montenegro,Azerbaijan,2,0,UEFA Nations League,2
Niger,Chad,2,0,Friendly,2
Iceland,Denmark,0,3,UEFA Nations League,3
Norway,Romania,4,0,UEFA Nations League,4
Finland,Bulgaria,2,0,UEFA Nations League,2
Greece,Moldova,2,0,UEFA Nations League,2
Gabon,Benin,0,2,Friendly,2
Ghana,Qatar,5,1,Friendly,4
Faroe Islands,Andorra,2,0,UEFA Nations League,2
Mozambique,Angola,0,3,Friendly,3
Ecuador,Uruguay,4,2,FIFA World Cup qualification,2
Peru,Brazil,2,4,FIFA World Cup qualification,2
Poland,Bosnia and Herzegovina,3,0,UEFA Nations League,3
Portugal,Sweden,3,0,UEFA Nations League,3
Moldova,Slovenia,0,4,UEFA Nations League,4
Belarus,Kazakhstan,2,0,UEFA Nations League,2
Bulgaria,Gibraltar,3,0,Friendly,3
Denmark,Sweden,2,0,Friendly,2
France,Finland,0,2,Friendly,2
Italy,Estonia,4,0,Friendly,4
Luxembourg,Austria,0,3,Friendly,3
Malta,Liechtenstein,3,0,Friendly,3
Poland,Ukraine,2,0,Friendly,2
Portugal,Andorra,7,0,Friendly,7
Romania,Belarus,5,3,Friendly,2
San Marino,Latvia,0,3,Friendly,3
Bosnia and Herzegovina,Iran,0,2,Friendly,2
England,Republic of Ireland,3,0,Friendly,3
Lebanon,Bahrain,1,3,Friendly,2
Bangladesh,Nepal,2,0,Friendly,2
Colombia,Uruguay,0,3,FIFA World Cup qualification,3
Chile,Peru,2,0,FIFA World Cup qualification,2
Germany,Ukraine,3,1,UEFA Nations League,2
Malta,Andorra,3,1,UEFA Nations League,2
Saudi Arabia,Jamaica,3,0,Friendly,3
Netherlands,Bosnia and Herzegovina,3,1,UEFA Nations League,2
Italy,Poland,2,0,UEFA Nations League,2
Belgium,England,2,0,UEFA Nations League,2
Romania,Norway,3,0,UEFA Nations League,3
Moldova,Greece,0,2,UEFA Nations League,2
Albania,Kazakhstan,3,1,UEFA Nations League,2
Belarus,Lithuania,2,0,UEFA Nations League,2
United States,Panama,6,2,Friendly,4
France,Sweden,4,2,UEFA Nations League,2
Spain,Germany,6,0,UEFA Nations League,6
Switzerland,Ukraine,3,0,UEFA Nations League,3
Montenegro,Cyprus,4,0,UEFA Nations League,4
Andorra,Latvia,0,5,UEFA Nations League,5
Japan,Mexico,0,2,Friendly,2
Ecuador,Colombia,6,1,FIFA World Cup qualification,5
Peru,Argentina,0,2,FIFA World Cup qualification,2
Uruguay,Brazil,0,2,FIFA World Cup qualification,2
Bosnia and Herzegovina,Italy,0,2,UEFA Nations League,2
England,Iceland,4,0,UEFA Nations League,4
Belgium,Denmark,4,2,UEFA Nations League,2
Czech Republic,Slovakia,2,0,UEFA Nations League,2
Hungary,Turkey,2,0,UEFA Nations League,2
Serbia,Russia,5,0,UEFA Nations League,5
Wales,Finland,3,1,UEFA Nations League,2
Qatar,Bangladesh,5,0,FIFA World Cup qualification,5
United States,El Salvador,6,0,Friendly,6
United States,Trinidad and Tobago,7,0,Friendly,7
Jordan,Tajikistan,2,0,Friendly,2
Jordan,Uzbekistan,0,2,Friendly,2
Ethiopia,Malawi,4,0,Friendly,4
Kosovo,Lithuania,4,0,Friendly,4
Suriname,Cayman Islands,3,0,FIFA World Cup qualification,3
Belgium,Wales,3,1,FIFA World Cup qualification,2
Estonia,Czech Republic,2,6,FIFA World Cup qualification,4
Turkey,Netherlands,4,2,FIFA World Cup qualification,2
Gibraltar,Norway,0,3,FIFA World Cup qualification,3
Malta,Russia,1,3,FIFA World Cup qualification,2
Chad,Namibia,0,3,African Cup of Nations qualification,3
São Tomé and Príncipe,Sudan,0,2,African Cup of Nations qualification,2
Ethiopia,Madagascar,4,0,African Cup of Nations qualification,4
Bahrain,Syria,3,1,Friendly,2
Japan,South Korea,3,0,Friendly,3
United States,Jamaica,4,1,Friendly,3
El Salvador,Grenada,2,0,FIFA World Cup qualification,2
Canada,Bermuda,5,1,FIFA World Cup qualification,4
Curaçao,Saint Vincent and the Grenadines,5,0,FIFA World Cup qualification,5
Haiti,Belize,2,0,FIFA World Cup qualification,2
Trinidad and Tobago,Guyana,3,0,FIFA World Cup qualification,3
Bulgaria,Switzerland,1,3,FIFA World Cup qualification,2
Italy,Northern Ireland,2,0,FIFA World Cup qualification,2
Israel,Denmark,0,2,FIFA World Cup qualification,2
England,San Marino,5,0,FIFA World Cup qualification,5
Germany,Iceland,3,0,FIFA World Cup qualification,3
Gabon,DR Congo,3,0,African Cup of Nations qualification,3
Libya,Tunisia,2,5,African Cup of Nations qualification,3
Tajikistan,Mongolia,3,0,FIFA World Cup qualification,3
Cape Verde,Cameroon,3,1,African Cup of Nations qualification,2
Eswatini,Guinea-Bissau,1,3,African Cup of Nations qualification,2
Niger,Ivory Coast,0,3,African Cup of Nations qualification,3
United States Virgin Islands,Antigua and Barbuda,0,3,FIFA World Cup qualification,3
Aruba,Suriname,0,6,FIFA World Cup qualification,6
British Virgin Islands,Guatemala,0,3,FIFA World Cup qualification,3
Anguilla,Dominican Republic,0,6,FIFA World Cup qualification,6
Turks and Caicos Islands,Nicaragua,0,7,FIFA World Cup qualification,7
Bahamas,Saint Kitts and Nevis,0,4,FIFA World Cup qualification,4
Belarus,Estonia,4,2,FIFA World Cup qualification,2
Montenegro,Gibraltar,4,1,FIFA World Cup qualification,3
Netherlands,Latvia,2,0,FIFA World Cup qualification,2
Norway,Turkey,0,3,FIFA World Cup qualification,3
Kosovo,Sweden,0,3,FIFA World Cup qualification,3
Bulgaria,Italy,0,2,FIFA World Cup qualification,2
Kazakhstan,France,0,2,FIFA World Cup qualification,2
Denmark,Moldova,8,0,FIFA World Cup qualification,8
Austria,Faroe Islands,3,1,FIFA World Cup qualification,2
Albania,England,0,2,FIFA World Cup qualification,2
Poland,Andorra,3,0,FIFA World Cup qualification,3
San Marino,Hungary,0,3,FIFA World Cup qualification,3
Armenia,Iceland,2,0,FIFA World Cup qualification,2
North Macedonia,Liechtenstein,5,0,FIFA World Cup qualification,5
Mali,Chad,3,0,African Cup of Nations qualification,3
Ghana,São Tomé and Príncipe,3,1,African Cup of Nations qualification,2
Sudan,South Africa,2,0,African Cup of Nations qualification,2
Cayman Islands,Canada,0,11,FIFA World Cup qualification,11
Angola,Gabon,2,0,African Cup of Nations qualification,2
Egypt,Comoros,4,0,African Cup of Nations qualification,4
Algeria,Botswana,5,0,African Cup of Nations qualification,5
Zimbabwe,Zambia,0,2,African Cup of Nations qualification,2
United Arab Emirates,India,6,0,Friendly,6
Iran,Syria,3,0,Friendly,3
Bermuda,Aruba,5,0,FIFA World Cup qualification,5
Saint Vincent and the Grenadines,British Virgin Islands,3,0,FIFA World Cup qualification,3
Belize,Turks and Caicos Islands,5,0,FIFA World Cup qualification,5
Guyana,Bahamas,4,0,FIFA World Cup qualification,4
Luxembourg,Portugal,1,3,FIFA World Cup qualification,2
Belgium,Belarus,8,0,FIFA World Cup qualification,8
Gibraltar,Netherlands,0,7,FIFA World Cup qualification,7
Croatia,Malta,3,0,FIFA World Cup qualification,3
Saudi Arabia,Palestine,5,0,FIFA World Cup qualification,5
Japan,Mongolia,14,0,FIFA World Cup qualification,14
Guinea-Bissau,Congo,3,0,African Cup of Nations qualification,3
Ivory Coast,Ethiopia,3,1,African Cup of Nations qualification,2
Nigeria,Lesotho,3,0,African Cup of Nations qualification,3
Spain,Kosovo,3,1,FIFA World Cup qualification,2
Lithuania,Italy,0,2,FIFA World Cup qualification,2
Scotland,Faroe Islands,4,0,FIFA World Cup qualification,4
Austria,Denmark,0,4,FIFA World Cup qualification,4
Moldova,Israel,1,4,FIFA World Cup qualification,3
Andorra,Hungary,1,4,FIFA World Cup qualification,3
San Marino,Albania,0,2,FIFA World Cup qualification,2
Liechtenstein,Iceland,1,4,FIFA World Cup qualification,3
United Arab Emirates,Jordan,5,1,Friendly,4
Bahrain,Malaysia,2,0,Friendly,2
Italy,San Marino,7,0,Friendly,7
Japan,Myanmar,10,0,FIFA World Cup qualification,10
Indonesia,Oman,1,3,Friendly,2
Iraq,Nepal,6,2,Friendly,4
Sweden,Finland,2,0,Friendly,2
Malta,Northern Ireland,0,3,Friendly,3
China PR,Guam,7,0,FIFA World Cup qualification,7
Kosovo,San Marino,4,1,Friendly,3
France,Wales,3,0,Friendly,3
Mozambique,Lesotho,5,0,Friendly,5
Montserrat,United States Virgin Islands,4,0,FIFA World Cup qualification,4
Cayman Islands,Aruba,1,3,FIFA World Cup qualification,2
Cuba,British Virgin Islands,5,0,FIFA World Cup qualification,5
Dominica,Anguilla,3,0,FIFA World Cup qualification,3
Puerto Rico,Bahamas,7,0,FIFA World Cup qualification,7
Algeria,Mauritania,4,1,Friendly,3
Andorra,Republic of Ireland,1,4,Friendly,3
Switzerland,Liechtenstein,7,0,Friendly,7
Turkey,Moldova,2,0,Friendly,2
Nepal,Taiwan,2,0,FIFA World Cup qualification,2
Iran,Hong Kong,3,1,FIFA World Cup qualification,2
Bahrain,Cambodia,8,0,FIFA World Cup qualification,8
Palestine,Singapore,4,0,FIFA World Cup qualification,4
United Arab Emirates,Malaysia,4,0,FIFA World Cup qualification,4
Bolivia,Venezuela,3,1,FIFA World Cup qualification,2
Peru,Colombia,0,3,FIFA World Cup qualification,3
Kuwait,Australia,0,3,FIFA World Cup qualification,3
Italy,Czech Republic,4,0,Friendly,4
North Macedonia,Kazakhstan,4,0,Friendly,4
Rwanda,Central African Republic,2,0,Friendly,2
Slovenia,Gibraltar,6,0,Friendly,6
Latvia,Lithuania,3,1,Baltic Cup,2
Maldives,Syria,0,4,FIFA World Cup qualification,4
Suriname,Bermuda,6,0,FIFA World Cup qualification,6
Guatemala,Saint Vincent and the Grenadines,10,0,FIFA World Cup qualification,10
Nicaragua,Belize,3,0,FIFA World Cup qualification,3
Saint Kitts and Nevis,Guyana,3,0,FIFA World Cup qualification,3
Brazil,Ecuador,2,0,FIFA World Cup qualification,2
Guinea,Togo,0,2,Friendly,2
Montenegro,Israel,1,3,Friendly,2
Niger,Gambia,0,2,Friendly,2
Senegal,Zambia,3,1,Friendly,2
Sweden,Armenia,3,1,Friendly,2
Saudi Arabia,Yemen,3,0,FIFA World Cup qualification,3
South Korea,Turkmenistan,5,0,FIFA World Cup qualification,5
United States Virgin Islands,El Salvador,0,7,FIFA World Cup qualification,7
Aruba,Canada,0,7,FIFA World Cup qualification,7
British Virgin Islands,Curaçao,0,8,FIFA World Cup qualification,8
Panama,Anguilla,13,0,FIFA World Cup qualification,13
Turks and Caicos Islands,Haiti,0,10,FIFA World Cup qualification,10
Denmark,Bosnia and Herzegovina,2,0,Friendly,2
Netherlands,Georgia,3,0,Friendly,3
Faroe Islands,Liechtenstein,5,1,Friendly,4
Germany,Latvia,7,1,Friendly,6
Rwanda,Central African Republic,5,0,Friendly,5
Ukraine,Cyprus,4,0,Friendly,4
Guam,Syria,0,3,FIFA World Cup qualification,3
China PR,Philippines,2,0,FIFA World Cup qualification,2
Nepal,Jordan,0,3,FIFA World Cup qualification,3
Australia,Taiwan,5,1,FIFA World Cup qualification,4
Iraq,Cambodia,4,1,FIFA World Cup qualification,3
Uzbekistan,Singapore,5,0,FIFA World Cup qualification,5
Bangladesh,India,0,2,FIFA World Cup qualification,2
Japan,Tajikistan,4,1,FIFA World Cup qualification,3
United Arab Emirates,Thailand,3,1,FIFA World Cup qualification,2
Vietnam,Indonesia,4,0,FIFA World Cup qualification,4
Bahrain,Iran,0,3,FIFA World Cup qualification,3
Czech Republic,Albania,3,1,Friendly,2
France,Bulgaria,3,0,Friendly,3
Senegal,Cape Verde,2,0,Friendly,2
Spain,Lithuania,4,0,Friendly,4
El Salvador,Antigua and Barbuda,3,0,FIFA World Cup qualification,3
Canada,Suriname,4,0,FIFA World Cup qualification,4
Panama,Dominican Republic,3,0,FIFA World Cup qualification,3
Guyana,Puerto Rico,0,2,FIFA World Cup qualification,2
Trinidad and Tobago,Saint Kitts and Nevis,2,0,FIFA World Cup qualification,2
Paraguay,Brazil,0,2,FIFA World Cup qualification,2
Portugal,Israel,4,0,Friendly,4
United States,Costa Rica,4,0,Friendly,4
South Korea,Sri Lanka,5,0,FIFA World Cup qualification,5
Philippines,Guam,3,0,FIFA World Cup qualification,3
China PR,Maldives,5,0,FIFA World Cup qualification,5
Nepal,Australia,0,3,FIFA World Cup qualification,3
Cambodia,Iran,0,10,FIFA World Cup qualification,10
Myanmar,Kyrgyzstan,1,8,FIFA World Cup qualification,7
Tunisia,Algeria,0,2,Friendly,2
Italy,Turkey,3,0,UEFA Euro,3
Saudi Arabia,Singapore,3,0,FIFA World Cup qualification,3
United Arab Emirates,Indonesia,5,0,FIFA World Cup qualification,5
Saint Kitts and Nevis,El Salvador,0,4,FIFA World Cup qualification,4
Russia,Belgium,0,3,UEFA Euro,3
Tanzania,Malawi,2,0,Friendly,2
Austria,North Macedonia,3,1,UEFA Euro,2
Brazil,Venezuela,3,0,Copa América,3
Scotland,Czech Republic,0,2,UEFA Euro,2
Paraguay,Bolivia,3,1,Copa América,2
China PR,Syria,3,1,FIFA World Cup qualification,2
Bahrain,Hong Kong,4,0,FIFA World Cup qualification,4
Palestine,Yemen,3,0,FIFA World Cup qualification,3
Saudi Arabia,Uzbekistan,3,0,FIFA World Cup qualification,3
Bangladesh,Oman,0,3,FIFA World Cup qualification,3
Tajikistan,Myanmar,4,0,FIFA World Cup qualification,4
Japan,Kyrgyzstan,5,1,FIFA World Cup qualification,4
Canada,Haiti,3,0,FIFA World Cup qualification,3
El Salvador,Saint Kitts and Nevis,2,0,FIFA World Cup qualification,2
Hungary,Portugal,0,3,UEFA Euro,3
Turkey,Wales,0,2,UEFA Euro,2
Italy,Switzerland,3,0,UEFA Euro,3
Netherlands,Austria,2,0,UEFA Euro,2
Brazil,Peru,4,0,Copa América,4
Algeria,Liberia,5,1,Friendly,4
Germany,Portugal,4,2,UEFA Euro,2
Switzerland,Turkey,3,1,UEFA Euro,2
Denmark,Russia,4,1,UEFA Euro,3
Finland,Belgium,0,2,UEFA Euro,2
Netherlands,North Macedonia,3,0,UEFA Euro,3
Scotland,Croatia,1,3,UEFA Euro,2
Mauritania,Yemen,2,0,Arab Cup qualification,2
Spain,Slovakia,5,0,UEFA Euro,5
Bolivia,Uruguay,0,2,Copa América,2
Chile,Paraguay,0,2,Copa América,2
Palestine,Comoros,5,1,Arab Cup qualification,4
Bahrain,Kuwait,2,0,Arab Cup qualification,2
Wales,Denmark,0,4,UEFA Euro,4
Netherlands,Czech Republic,0,2,UEFA Euro,2
Croatia,Spain,3,5,UEFA Euro,2
Argentina,Bolivia,4,1,Copa América,3
England,Germany,2,0,UEFA Euro,2
Mexico,Panama,3,0,Friendly,3
Haiti,Saint Vincent and the Grenadines,6,1,Gold Cup qualification,5
Trinidad and Tobago,Montserrat,6,1,Gold Cup qualification,5
Bermuda,Barbados,8,1,Gold Cup qualification,7
Ukraine,England,0,4,UEFA Euro,4
Mexico,Nigeria,4,0,Friendly,4
Argentina,Ecuador,3,0,Copa América,3
Guatemala,Guyana,4,0,Gold Cup qualification,4
Cuba,French Guiana,0,3,Gold Cup qualification,3
Guadeloupe,Bahamas,2,0,Gold Cup qualification,2
Haiti,Bermuda,4,1,Gold Cup qualification,3
Eswatini,Lesotho,3,1,COSAFA Cup,2
Lesotho,Botswana,0,4,COSAFA Cup,4
Namibia,Zimbabwe,2,0,COSAFA Cup,2
Mozambique,Malawi,2,0,COSAFA Cup,2
El Salvador,Guatemala,2,0,Gold Cup,2
Canada,Martinique,4,1,Gold Cup,3
Jamaica,Suriname,2,0,Gold Cup,2
Costa Rica,Guadeloupe,3,1,Gold Cup,2
South Africa,Lesotho,4,0,COSAFA Cup,4
Honduras,Grenada,4,0,Gold Cup,4
Trinidad and Tobago,El Salvador,0,2,Gold Cup,2
Guatemala,Mexico,0,3,Gold Cup,3
Haiti,Canada,1,4,Gold Cup,3
United States,Martinique,6,1,Gold Cup,5
South Africa,Mozambique,3,0,COSAFA Cup,3
Grenada,Qatar,0,4,Gold Cup,4
Panama,Grenada,3,1,Gold Cup,2
Honduras,Qatar,0,2,Gold Cup,2
Mexico,Honduras,3,0,Gold Cup,3
Costa Rica,Canada,0,2,Gold Cup,2
Sudan,Niger,3,0,Friendly,3
Bahrain,Haiti,6,1,Friendly,5
Comoros,Seychelles,7,1,Friendly,6
Qatar,Serbia,0,4,Friendly,4
Senegal,Togo,2,0,FIFA World Cup qualification,2
Faroe Islands,Israel,0,4,FIFA World Cup qualification,4
Denmark,Scotland,2,0,FIFA World Cup qualification,2
Moldova,Austria,0,2,FIFA World Cup qualification,2
Latvia,Gibraltar,3,1,FIFA World Cup qualification,2
Malta,Cyprus,3,0,FIFA World Cup qualification,3
Niger,Burkina Faso,0,2,FIFA World Cup qualification,2
Algeria,Djibouti,8,0,FIFA World Cup qualification,8
Morocco,Sudan,2,0,FIFA World Cup qualification,2
Australia,China PR,3,0,FIFA World Cup qualification,3
Saudi Arabia,Vietnam,3,1,FIFA World Cup qualification,2
Lithuania,Northern Ireland,1,4,FIFA World Cup qualification,3
Estonia,Belgium,2,5,FIFA World Cup qualification,3
Andorra,San Marino,2,0,FIFA World Cup qualification,2
Hungary,England,0,4,FIFA World Cup qualification,4
Poland,Albania,4,1,FIFA World Cup qualification,3
Iceland,Romania,0,2,FIFA World Cup qualification,2
Liechtenstein,Germany,0,2,FIFA World Cup qualification,2
Ecuador,Paraguay,2,0,FIFA World Cup qualification,2
Venezuela,Argentina,1,3,FIFA World Cup qualification,2
Tunisia,Equatorial Guinea,3,0,FIFA World Cup qualification,3
Nigeria,Liberia,2,0,FIFA World Cup qualification,2
Cameroon,Malawi,2,0,FIFA World Cup qualification,2
Burundi,Seychelles,8,1,Friendly,7
Haiti,Jordan,2,0,Friendly,2
Qatar,Portugal,1,3,Friendly,2
Serbia,Luxembourg,4,1,FIFA World Cup qualification,3
Israel,Austria,5,2,FIFA World Cup qualification,3
Latvia,Norway,0,2,FIFA World Cup qualification,2
Gibraltar,Turkey,0,3,FIFA World Cup qualification,3
Netherlands,Montenegro,4,0,FIFA World Cup qualification,4
Cyprus,Russia,0,2,FIFA World Cup qualification,2
Bangladesh,Palestine,0,2,Three Nations Cup,2
Spain,Georgia,4,0,FIFA World Cup qualification,4
Belgium,Czech Republic,3,0,FIFA World Cup qualification,3
England,Andorra,4,0,FIFA World Cup qualification,4
San Marino,Poland,1,7,FIFA World Cup qualification,6
Germany,Armenia,6,0,FIFA World Cup qualification,6
Romania,Liechtenstein,2,0,FIFA World Cup qualification,2
Uruguay,Bolivia,4,2,FIFA World Cup qualification,2
Jamaica,Panama,0,3,FIFA World Cup qualification,3
Djibouti,Niger,2,4,FIFA World Cup qualification,2
Kyrgyzstan,Bangladesh,4,1,Three Nations Cup,3
Zambia,Tunisia,0,2,FIFA World Cup qualification,2
Congo,Senegal,1,3,FIFA World Cup qualification,2
Sudan,Guinea-Bissau,2,4,FIFA World Cup qualification,2
Iraq,Iran,0,3,FIFA World Cup qualification,3
Azerbaijan,Portugal,0,3,FIFA World Cup qualification,3
France,Finland,2,0,FIFA World Cup qualification,2
Denmark,Israel,5,0,FIFA World Cup qualification,5
Netherlands,Turkey,6,1,FIFA World Cup qualification,5
Norway,Gibraltar,5,1,FIFA World Cup qualification,4
Croatia,Slovenia,3,0,FIFA World Cup qualification,3
Slovakia,Cyprus,2,0,FIFA World Cup qualification,2
Russia,Malta,2,0,FIFA World Cup qualification,2
Bulgaria,Georgia,4,1,Friendly,3
Kosovo,Spain,0,2,FIFA World Cup qualification,2
Italy,Lithuania,5,0,FIFA World Cup qualification,5
Albania,San Marino,5,0,FIFA World Cup qualification,5
Iceland,Germany,0,4,FIFA World Cup qualification,4
Canada,El Salvador,3,0,FIFA World Cup qualification,3
Honduras,United States,1,4,FIFA World Cup qualification,3
Colombia,Chile,3,1,FIFA World Cup qualification,2
Argentina,Bolivia,3,0,FIFA World Cup qualification,3
Brazil,Peru,2,0,FIFA World Cup qualification,2
El Salvador,Guatemala,0,2,Friendly,2
Egypt,Liberia,2,0,Friendly,2
Morocco,Guinea-Bissau,5,0,FIFA World Cup qualification,5
Bahrain,Curaçao,4,0,Friendly,4
Jordan,Malaysia,4,0,Friendly,4
Australia,Oman,3,1,FIFA World Cup qualification,2
United States,Jamaica,2,0,FIFA World Cup qualification,2
Equatorial Guinea,Zambia,2,0,FIFA World Cup qualification,2
Tunisia,Mauritania,3,0,FIFA World Cup qualification,3
Mali,Kenya,5,0,FIFA World Cup qualification,5
DR Congo,Madagascar,2,0,FIFA World Cup qualification,2
Ecuador,Bolivia,3,0,FIFA World Cup qualification,3
Venezuela,Brazil,1,3,FIFA World Cup qualification,2
Peru,Chile,2,0,FIFA World Cup qualification,2
Maldives,Bangladesh,2,0,SAFF Cup,2
Estonia,Belarus,2,0,FIFA World Cup qualification,2
Gibraltar,Montenegro,0,3,FIFA World Cup qualification,3
Malta,Slovenia,0,4,FIFA World Cup qualification,4
Cyprus,Croatia,0,3,FIFA World Cup qualification,3
Liechtenstein,North Macedonia,0,4,FIFA World Cup qualification,4
Algeria,Niger,6,1,FIFA World Cup qualification,5
Djibouti,Burkina Faso,0,4,FIFA World Cup qualification,4
Malawi,Ivory Coast,0,3,FIFA World Cup qualification,3
Cameroon,Mozambique,3,1,FIFA World Cup qualification,2
Angola,Gabon,3,1,FIFA World Cup qualification,2
Azerbaijan,Republic of Ireland,0,3,FIFA World Cup qualification,3
Sweden,Kosovo,3,0,FIFA World Cup qualification,3
Georgia,Greece,0,2,FIFA World Cup qualification,2
Lithuania,Bulgaria,3,1,FIFA World Cup qualification,2
Switzerland,Northern Ireland,2,0,FIFA World Cup qualification,2
Kazakhstan,Bosnia and Herzegovina,0,2,FIFA World Cup qualification,2
Faroe Islands,Austria,0,2,FIFA World Cup qualification,2
Moldova,Denmark,0,4,FIFA World Cup qualification,4
Andorra,England,0,5,FIFA World Cup qualification,5
Poland,San Marino,5,0,FIFA World Cup qualification,5
Ethiopia,South Africa,1,3,FIFA World Cup qualification,2
Ghana,Zimbabwe,3,1,FIFA World Cup qualification,2
Senegal,Namibia,4,1,FIFA World Cup qualification,3
Portugal,Qatar,3,0,Friendly,3
Uzbekistan,Malaysia,5,1,Friendly,4
Morocco,Guinea-Bissau,3,0,FIFA World Cup qualification,3
Mexico,Honduras,3,0,FIFA World Cup qualification,3
Central African Republic,Nigeria,0,2,FIFA World Cup qualification,2
Argentina,Uruguay,3,0,FIFA World Cup qualification,3
Chile,Paraguay,2,0,FIFA World Cup qualification,2
Belarus,Czech Republic,0,2,FIFA World Cup qualification,2
Netherlands,Gibraltar,6,0,FIFA World Cup qualification,6
Norway,Montenegro,2,0,FIFA World Cup qualification,2
Iceland,Liechtenstein,4,0,FIFA World Cup qualification,4
North Macedonia,Germany,0,4,FIFA World Cup qualification,4
Burkina Faso,Djibouti,2,0,FIFA World Cup qualification,2
Gabon,Angola,2,0,FIFA World Cup qualification,2
Libya,Egypt,0,3,FIFA World Cup qualification,3
Taiwan,Indonesia,0,3,AFC Asian Cup qualification,3
Oman,Vietnam,3,1,FIFA World Cup qualification,2
Portugal,Luxembourg,5,0,FIFA World Cup qualification,5
Serbia,Azerbaijan,3,1,FIFA World Cup qualification,2
Sweden,Greece,2,0,FIFA World Cup qualification,2
Lithuania,Switzerland,0,4,FIFA World Cup qualification,4
Kazakhstan,Finland,0,2,FIFA World Cup qualification,2
San Marino,Andorra,0,3,FIFA World Cup qualification,3
Niger,Algeria,0,4,FIFA World Cup qualification,4
Namibia,Senegal,1,3,FIFA World Cup qualification,2
Jordan,Uzbekistan,3,0,Friendly,3
Republic of Ireland,Qatar,4,0,Friendly,4
Morocco,Guinea,4,1,FIFA World Cup qualification,3
Honduras,Jamaica,0,2,FIFA World Cup qualification,2
Canada,Panama,4,1,FIFA World Cup qualification,3
El Salvador,Mexico,0,2,FIFA World Cup qualification,2
Maldives,India,1,3,SAFF Cup,2
Bolivia,Paraguay,4,0,FIFA World Cup qualification,4
Brazil,Uruguay,4,1,FIFA World Cup qualification,3
Chile,Venezuela,3,0,FIFA World Cup qualification,3
India,Nepal,3,0,SAFF Cup,3
Kosovo,Jordan,0,2,Friendly,2
Nicaragua,Cuba,0,3,Friendly,3
Czech Republic,Kuwait,7,0,Friendly,7
Serbia,Qatar,4,0,Friendly,4
Rwanda,Mali,0,3,FIFA World Cup qualification,3
Tanzania,DR Congo,0,3,FIFA World Cup qualification,3
Benin,Madagascar,2,0,FIFA World Cup qualification,2
Azerbaijan,Luxembourg,1,3,FIFA World Cup qualification,2
Georgia,Sweden,2,0,FIFA World Cup qualification,2
Russia,Cyprus,6,0,FIFA World Cup qualification,6
Malta,Croatia,1,7,FIFA World Cup qualification,6
Germany,Liechtenstein,9,0,FIFA World Cup qualification,9
Armenia,North Macedonia,0,5,FIFA World Cup qualification,5
Peru,Bolivia,3,0,FIFA World Cup qualification,3
Djibouti,Algeria,0,4,FIFA World Cup qualification,4
Morocco,Sudan,3,0,FIFA World Cup qualification,3
United States,Mexico,2,0,FIFA World Cup qualification,2
Moldova,Scotland,0,2,FIFA World Cup qualification,2
Denmark,Faroe Islands,3,1,FIFA World Cup qualification,2
Austria,Israel,4,2,FIFA World Cup qualification,2
England,Albania,5,0,FIFA World Cup qualification,5
Andorra,Poland,1,4,FIFA World Cup qualification,3
Hungary,San Marino,4,0,FIFA World Cup qualification,4
Nicaragua,Cuba,2,0,Friendly,2
Sierra Leone,Comoros,0,2,Friendly,2
Zambia,Mauritania,4,0,FIFA World Cup qualification,4
Liberia,Nigeria,0,2,FIFA World Cup qualification,2
Malawi,Cameroon,0,4,FIFA World Cup qualification,4
Ivory Coast,Mozambique,3,0,FIFA World Cup qualification,3
Bosnia and Herzegovina,Finland,1,3,FIFA World Cup qualification,2
France,Kazakhstan,8,0,FIFA World Cup qualification,8
Wales,Belarus,5,1,FIFA World Cup qualification,4
Belgium,Estonia,3,1,FIFA World Cup qualification,2
Turkey,Gibraltar,6,0,FIFA World Cup qualification,6
Nicaragua,Cuba,2,0,Friendly,2
Senegal,Congo,2,0,FIFA World Cup qualification,2
DR Congo,Benin,2,0,FIFA World Cup qualification,2
Luxembourg,Republic of Ireland,0,3,FIFA World Cup qualification,3
Malta,Slovakia,0,6,FIFA World Cup qualification,6
Liechtenstein,Romania,0,2,FIFA World Cup qualification,2
North Macedonia,Iceland,3,1,FIFA World Cup qualification,2
Armenia,Germany,1,4,FIFA World Cup qualification,3
Niger,Djibouti,7,2,FIFA World Cup qualification,5
Switzerland,Bulgaria,4,0,FIFA World Cup qualification,4
Scotland,Denmark,2,0,FIFA World Cup qualification,2
Austria,Moldova,4,1,FIFA World Cup qualification,3
San Marino,England,0,10,FIFA World Cup qualification,10
Bahrain,Kyrgyzstan,4,2,Friendly,2
New Zealand,Gambia,2,0,Friendly,2
Tunisia,Zambia,3,1,FIFA World Cup qualification,2
Liberia,Central African Republic,3,1,FIFA World Cup qualification,2
Morocco,Guinea,3,0,FIFA World Cup qualification,3
Iraq,South Korea,0,3,FIFA World Cup qualification,3
Syria,Iran,0,3,FIFA World Cup qualification,3
Bosnia and Herzegovina,Ukraine,0,2,FIFA World Cup qualification,2
Finland,France,0,2,FIFA World Cup qualification,2
Czech Republic,Estonia,2,0,FIFA World Cup qualification,2
Gibraltar,Latvia,1,3,FIFA World Cup qualification,2
Netherlands,Norway,2,0,FIFA World Cup qualification,2
Bolivia,Uruguay,3,0,FIFA World Cup qualification,3
Chile,Ecuador,0,2,FIFA World Cup qualification,2
Indonesia,Myanmar,4,1,Friendly,3
Tunisia,Mauritania,5,1,Arab Cup,4
Morocco,Palestine,4,0,Arab Cup,4
Algeria,Sudan,4,0,Arab Cup,4
Syria,Tunisia,2,0,Arab Cup,2
Jordan,Morocco,0,4,Arab Cup,4
Lebanon,Algeria,0,2,Arab Cup,2
Sudan,Egypt,0,5,Arab Cup,5
Oman,Bahrain,3,0,Arab Cup,3
Qatar,Iraq,3,0,Arab Cup,3
Jordan,Palestine,5,1,Arab Cup,4
Tanzania,Uganda,0,2,Friendly,2
Qatar,United Arab Emirates,5,0,Arab Cup,5
Egypt,Jordan,3,1,Arab Cup,2
Tunisia,Algeria,0,2,Arab Cup,2
Gabon,Burkina Faso,0,3,Friendly,3
Rwanda,Guinea,3,0,Friendly,3
Algeria,Ghana,3,0,Friendly,3
Rwanda,Guinea,0,2,Friendly,2
Cameroon,Ethiopia,4,1,African Cup of Nations,3
Morocco,Comoros,2,0,African Cup of Nations,2
South Korea,Iceland,5,1,Friendly,4
Nigeria,Sudan,3,1,African Cup of Nations,2
Tunisia,Mauritania,4,0,African Cup of Nations,4
Guinea-Bissau,Nigeria,0,2,African Cup of Nations,2
South Korea,Moldova,4,0,Friendly,4
Peru,Jamaica,3,0,Friendly,3
Ivory Coast,Algeria,3,1,African Cup of Nations,2
Mali,Mauritania,2,0,African Cup of Nations,2
Bolivia,Trinidad and Tobago,5,0,Friendly,5
Senegal,Cape Verde,2,0,African Cup of Nations,2
Bahrain,Uganda,3,1,Friendly,2
Indonesia,Timor-Leste,4,1,Friendly,3
Uzbekistan,South Sudan,3,0,Friendly,3
Honduras,Canada,0,2,FIFA World Cup qualification,2
United Arab Emirates,Syria,2,0,FIFA World Cup qualification,2
Japan,China PR,2,0,FIFA World Cup qualification,2
Australia,Vietnam,4,0,FIFA World Cup qualification,4
Jordan,New Zealand,3,1,Friendly,2
Venezuela,Bolivia,4,1,FIFA World Cup qualification,3
Kuwait,Libya,2,0,Friendly,2
Nicaragua,Belize,4,0,Friendly,4
Cameroon,Gambia,2,0,African Cup of Nations,2
Indonesia,Timor-Leste,3,0,Friendly,3
Senegal,Equatorial Guinea,3,1,African Cup of Nations,2
Canada,United States,2,0,FIFA World Cup qualification,2
Honduras,El Salvador,0,2,FIFA World Cup qualification,2
Kuwait,Libya,0,2,Friendly,2
Syria,South Korea,0,2,FIFA World Cup qualification,2
Vietnam,China PR,3,1,FIFA World Cup qualification,2
Japan,Saudi Arabia,2,0,FIFA World Cup qualification,2
Uruguay,Venezuela,4,1,FIFA World Cup qualification,3
Brazil,Paraguay,4,0,FIFA World Cup qualification,4
Burkina Faso,Senegal,1,3,African Cup of Nations,2
United States,Honduras,3,0,FIFA World Cup qualification,3
El Salvador,Canada,0,2,FIFA World Cup qualification,2
Cook Islands,Solomon Islands,0,2,FIFA World Cup qualification,2
Iraq,Zambia,3,1,Friendly,2
New Zealand,Fiji,4,0,FIFA World Cup qualification,4
Guinea-Bissau,Equatorial Guinea,3,0,Friendly,3
Guadeloupe,Cape Verde,0,2,Friendly,2
Malaysia,Philippines,2,0,Friendly,2
Tanzania,Central African Republic,3,1,Friendly,2
Djibouti,South Sudan,2,4,African Cup of Nations qualification,2
Somalia,Eswatini,0,3,African Cup of Nations qualification,3
Lebanon,Syria,0,3,FIFA World Cup qualification,3
South Korea,Iran,2,0,FIFA World Cup qualification,2
Australia,Japan,0,2,FIFA World Cup qualification,2
Solomon Islands,Tahiti,3,1,FIFA World Cup qualification,2
New Zealand,New Caledonia,7,1,FIFA World Cup qualification,6
Colombia,Bolivia,3,0,FIFA World Cup qualification,3
Brazil,Chile,4,0,FIFA World Cup qualification,4
Paraguay,Ecuador,3,1,FIFA World Cup qualification,2
Portugal,Turkey,3,1,FIFA World Cup qualification,2
Kosovo,Burkina Faso,5,0,Friendly,5
Liberia,Benin,0,4,Friendly,4
Maldives,Bangladesh,2,0,Friendly,2
Thailand,Nepal,2,0,Friendly,2
Togo,Sierra Leone,3,0,Friendly,3
Mauritius,São Tomé and Príncipe,3,0,African Cup of Nations qualification,3
Argentina,Venezuela,3,0,FIFA World Cup qualification,3
Cape Verde,Liechtenstein,6,0,Friendly,6
Congo,Zambia,1,3,Friendly,2
Luxembourg,Northern Ireland,1,3,Friendly,2
Norway,Slovakia,2,0,Friendly,2
Trinidad and Tobago,Barbados,9,0,Friendly,9
Uzbekistan,Kyrgyzstan,3,1,Navruz Cup,2
Belarus,India,3,0,Friendly,3
Germany,Israel,2,0,Friendly,2
Netherlands,Denmark,4,2,Friendly,2
Canada,Jamaica,4,0,FIFA World Cup qualification,4
United States,Panama,5,1,FIFA World Cup qualification,4
Barbados,Guyana,0,5,Friendly,5
Belize,Cuba,0,3,Friendly,3
Lesotho,Seychelles,3,1,African Cup of Nations qualification,2
Cape Verde,San Marino,2,0,Friendly,2
Morocco,DR Congo,4,1,FIFA World Cup qualification,3
Iran,Lebanon,2,0,FIFA World Cup qualification,2
Oman,China PR,2,0,FIFA World Cup qualification,2
Peru,Paraguay,2,0,FIFA World Cup qualification,2
Bolivia,Brazil,0,4,FIFA World Cup qualification,4
Chile,Uruguay,0,2,FIFA World Cup qualification,2
Poland,Sweden,2,0,FIFA World Cup qualification,2
Portugal,North Macedonia,2,0,FIFA World Cup qualification,2
Belgium,Burkina Faso,3,0,Friendly,3
Denmark,Serbia,3,0,Friendly,3
England,Ivory Coast,3,0,Friendly,3
Finland,Slovakia,0,2,Friendly,2
France,South Africa,5,0,Friendly,5
Malta,Kuwait,2,0,Friendly,2
Mauritania,Libya,2,0,Friendly,2
Norway,Armenia,9,0,Friendly,9
Singapore,Philippines,2,0,Friendly,2
Spain,Iceland,5,0,Friendly,5
Uzbekistan,Uganda,4,2,Navruz Cup,2
Cyprus,Estonia,2,0,UEFA Nations League,2
Mexico,El Salvador,2,0,FIFA World Cup qualification,2
Costa Rica,United States,2,0,FIFA World Cup qualification,2
Solomon Islands,New Zealand,0,5,FIFA World Cup qualification,5
El Salvador,Guatemala,0,4,Friendly,4
Bahamas,Turks and Caicos Islands,4,2,Friendly,2
Dominica,Saint Vincent and the Grenadines,3,1,Friendly,2
Thailand,Bahrain,3,1,Friendly,2
Bahrain,Myanmar,2,0,Friendly,2
Malaysia,Brunei,4,0,Friendly,4
India,Jordan,0,2,Friendly,2
Italy,Argentina,0,3,CONMEBOL–UEFA Cup of Champions,3
Scotland,Ukraine,1,3,FIFA World Cup qualification,2
Ghana,Madagascar,3,0,African Cup of Nations qualification,3
Malaysia,Hong Kong,2,0,Friendly,2
United States,Morocco,3,0,Friendly,3
Vietnam,Afghanistan,2,0,Friendly,2
Tunisia,Equatorial Guinea,4,0,African Cup of Nations qualification,4
Panama,Costa Rica,2,0,CONCACAF Nations League,2
Belize,Dominican Republic,0,2,CONCACAF Nations League,2
French Guiana,Guatemala,2,0,CONCACAF Nations League,2
Slovenia,Sweden,0,2,UEFA Nations League,2
Cyprus,Kosovo,0,2,UEFA Nations League,2
Georgia,Gibraltar,4,0,UEFA Nations League,4
Estonia,San Marino,2,0,UEFA Nations League,2
Japan,Paraguay,4,1,Friendly,3
South Korea,Brazil,1,5,Friendly,4
Mexico,Uruguay,0,3,Friendly,3
Burkina Faso,Cape Verde,2,0,African Cup of Nations qualification,2
Comoros,Lesotho,2,0,African Cup of Nations qualification,2
Ivory Coast,Zambia,3,1,African Cup of Nations qualification,2
Turks and Caicos Islands,Bonaire,1,4,CONCACAF Nations League,3
Croatia,Austria,0,3,UEFA Nations League,3
Belgium,Netherlands,1,4,UEFA Nations League,3
Kazakhstan,Azerbaijan,2,0,UEFA Nations League,2
Liechtenstein,Moldova,0,2,UEFA Nations League,2
Latvia,Andorra,3,0,UEFA Nations League,3
Nepal,Oman,0,2,Friendly,2
Algeria,Uganda,2,0,African Cup of Nations qualification,2
Mali,Congo,4,0,African Cup of Nations qualification,4
Mauritania,Sudan,3,0,African Cup of Nations qualification,3
Senegal,Benin,3,1,African Cup of Nations qualification,2
El Salvador,Grenada,3,1,CONCACAF Nations League,2
Montenegro,Romania,2,0,UEFA Nations League,2
Lithuania,Luxembourg,0,2,UEFA Nations League,2
Turkey,Faroe Islands,4,0,UEFA Nations League,4
Costa Rica,Martinique,2,0,CONCACAF Nations League,2
Cuba,Barbados,3,0,CONCACAF Nations League,3
Guatemala,Belize,2,0,CONCACAF Nations League,2
Portugal,Switzerland,4,0,UEFA Nations League,4
Serbia,Slovenia,4,1,UEFA Nations League,3
Gibraltar,North Macedonia,0,2,UEFA Nations League,2
Bulgaria,Georgia,2,5,UEFA Nations League,3
San Marino,Malta,0,2,UEFA Nations League,2
Argentina,Estonia,5,0,Friendly,5
Equatorial Guinea,Libya,2,0,African Cup of Nations qualification,2
Aruba,Saint Martin,3,0,CONCACAF Nations League,3
South Korea,Chile,2,0,Friendly,2
Eswatini,Burkina Faso,1,3,African Cup of Nations qualification,2
Cape Verde,Togo,2,0,African Cup of Nations qualification,2
Jamaica,Suriname,3,1,CONCACAF Nations League,2
Finland,Montenegro,2,0,UEFA Nations League,2
Lithuania,Turkey,0,6,UEFA Nations League,6
Jordan,Nepal,2,0,AFC Asian Cup qualification,2
Thailand,Maldives,3,0,AFC Asian Cup qualification,3
Uzbekistan,Sri Lanka,3,0,AFC Asian Cup qualification,3
India,Cambodia,2,0,AFC Asian Cup qualification,2
Bahrain,Bangladesh,2,0,AFC Asian Cup qualification,2
Malaysia,Turkmenistan,3,1,AFC Asian Cup qualification,2
Tajikistan,Myanmar,4,0,AFC Asian Cup qualification,4
Tanzania,Algeria,0,2,African Cup of Nations qualification,2
Belgium,Poland,6,1,UEFA Nations League,5
Scotland,Armenia,2,0,UEFA Nations League,2
Guinea-Bissau,São Tomé and Príncipe,5,1,African Cup of Nations qualification,4
Ethiopia,Egypt,2,0,African Cup of Nations qualification,2
South Sudan,Mali,1,3,African Cup of Nations qualification,2
Panama,Martinique,5,0,CONCACAF Nations League,5
Canada,Curaçao,4,0,CONCACAF Nations League,4
Antigua and Barbuda,Cuba,0,2,CONCACAF Nations League,2
Cayman Islands,Puerto Rico,0,3,CONCACAF Nations League,3
Portugal,Czech Republic,2,0,UEFA Nations League,2
Greece,Cyprus,3,0,UEFA Nations League,3
North Macedonia,Georgia,0,3,UEFA Nations League,3
United States,Grenada,5,0,CONCACAF Nations League,5
Saint Vincent and the Grenadines,Trinidad and Tobago,0,2,CONCACAF Nations League,2
Bahamas,Nicaragua,0,2,CONCACAF Nations League,2
Moldova,Latvia,2,4,UEFA Nations League,2
Chile,Tunisia,0,2,Kirin Cup,2
Japan,Ghana,4,1,Kirin Cup,3
Kuwait,Nepal,4,1,AFC Asian Cup qualification,3
Yemen,Palestine,0,5,AFC Asian Cup qualification,5
Sri Lanka,Thailand,0,2,AFC Asian Cup qualification,2
Uzbekistan,Maldives,4,0,AFC Asian Cup qualification,4
Cambodia,Hong Kong,0,3,AFC Asian Cup qualification,3
Kyrgyzstan,Myanmar,2,0,AFC Asian Cup qualification,2
Mexico,Suriname,3,0,CONCACAF Nations League,3
Guyana,Haiti,2,6,CONCACAF Nations League,4
United States Virgin Islands,Bonaire,0,2,CONCACAF Nations League,2
Sint Maarten,Turks and Caicos Islands,8,2,CONCACAF Nations League,6
Ukraine,Armenia,3,0,UEFA Nations League,3
Republic of Ireland,Scotland,3,0,UEFA Nations League,3
Luxembourg,Turkey,0,2,UEFA Nations League,2
Uruguay,Panama,5,0,Friendly,5
Cuba,Antigua and Barbuda,3,1,CONCACAF Nations League,2
Saint Lucia,Anguilla,2,0,CONCACAF Nations League,2
Puerto Rico,British Virgin Islands,6,0,CONCACAF Nations League,6
Spain,Czech Republic,2,0,UEFA Nations League,2
Greece,Kosovo,2,0,UEFA Nations League,2
North Macedonia,Gibraltar,4,0,UEFA Nations League,4
São Tomé and Príncipe,Nigeria,0,10,African Cup of Nations qualification,10
Morocco,Liberia,2,0,African Cup of Nations qualification,2
Nicaragua,Bahamas,4,0,CONCACAF Nations League,4
Trinidad and Tobago,Saint Vincent and the Grenadines,4,1,CONCACAF Nations League,3
Guatemala,Dominican Republic,2,0,CONCACAF Nations League,2
Denmark,Austria,2,0,UEFA Nations League,2
Azerbaijan,Belarus,2,0,UEFA Nations League,2
Kuwait,Jordan,0,3,AFC Asian Cup qualification,3
Indonesia,Nepal,7,0,AFC Asian Cup qualification,7
Palestine,Philippines,4,0,AFC Asian Cup qualification,4
Mongolia,Yemen,2,0,AFC Asian Cup qualification,2
Uzbekistan,Thailand,2,0,AFC Asian Cup qualification,2
India,Hong Kong,4,0,AFC Asian Cup qualification,4
Malaysia,Bangladesh,4,1,AFC Asian Cup qualification,3
Myanmar,Singapore,2,6,AFC Asian Cup qualification,4
Haiti,Guyana,6,0,CONCACAF Nations League,6
Bonaire,United States Virgin Islands,2,0,CONCACAF Nations League,2
Turks and Caicos Islands,Sint Maarten,2,0,CONCACAF Nations League,2
England,Hungary,0,4,UEFA Nations League,4
Germany,Italy,5,2,UEFA Nations League,3
Armenia,Scotland,1,4,UEFA Nations League,3
Romania,Montenegro,0,3,UEFA Nations League,3
Turkey,Lithuania,2,0,UEFA Nations League,2
Liechtenstein,Latvia,0,2,UEFA Nations League,2
Japan,Tunisia,0,3,Kirin Cup,3
South Korea,Egypt,4,1,Friendly,3
Mapuche,Aymara,3,1,CONIFA South America Football Cup,2
Brunei,Maldives,0,3,Friendly,3
Hong Kong,Myanmar,2,0,Friendly,2
Vietnam,Singapore,4,0,Friendly,4
Scotland,Ukraine,3,0,UEFA Nations League,3
France,Austria,2,0,UEFA Nations League,2
Poland,Netherlands,0,2,UEFA Nations League,2
Liechtenstein,Andorra,0,2,UEFA Nations League,2
Japan,United States,2,0,Kirin Challenge Cup,2
Argentina,Honduras,3,0,Friendly,3
Brazil,Ghana,3,0,Friendly,3
Cameroon,Uzbekistan,0,2,Friendly,2
Canada,Qatar,2,0,Friendly,2
Egypt,Niger,3,0,Friendly,3
Jordan,Syria,2,0,Jordan International Tournament,2
Morocco,Chile,2,0,Friendly,2
Georgia,North Macedonia,2,0,UEFA Nations League,2
Bulgaria,Gibraltar,5,1,UEFA Nations League,4
Bolivia,Senegal,0,2,Friendly,2
Colombia,Guatemala,4,1,Friendly,3
Grenada,Saint Vincent and the Grenadines,1,3,Friendly,2
Laos,Maldives,1,3,Friendly,2
South Africa,Sierra Leone,4,0,Friendly,4
Czech Republic,Portugal,0,4,UEFA Nations League,4
Armenia,Ukraine,0,5,UEFA Nations League,5
Serbia,Sweden,4,1,UEFA Nations League,3
New Zealand,Australia,0,2,Friendly,2
Austria,Croatia,1,3,UEFA Nations League,2
Denmark,France,2,0,UEFA Nations League,2
Azerbaijan,Kazakhstan,3,0,UEFA Nations League,3
Moldova,Liechtenstein,2,0,UEFA Nations League,2
Hungary,Italy,0,2,UEFA Nations League,2
Montenegro,Finland,0,2,UEFA Nations League,2
Romania,Bosnia and Herzegovina,4,1,UEFA Nations League,3
San Marino,Estonia,0,4,UEFA Nations League,4
Argentina,Jamaica,3,0,Friendly,3
Bahrain,Panama,0,2,Friendly,2
Brazil,Tunisia,5,1,Friendly,4
Canada,Uruguay,0,2,Friendly,2
DR Congo,Sierra Leone,3,0,Friendly,3
Egypt,Liberia,3,0,Friendly,3
Ivory Coast,Guinea,3,1,Friendly,2
Madagascar,Benin,3,1,Friendly,2
Mauritania,Congo,2,0,Friendly,2
Nepal,Bangladesh,3,1,Friendly,2
Peru,El Salvador,4,1,Friendly,3
United Arab Emirates,Venezuela,0,4,Friendly,4
Vietnam,India,3,0,Friendly,3
Norway,Serbia,0,2,UEFA Nations League,2
Kosovo,Cyprus,5,1,UEFA Nations League,4
Greece,Northern Ireland,3,1,UEFA Nations League,2
Saint Vincent and the Grenadines,Grenada,1,5,Friendly,4
Qatar,Guatemala,2,0,Friendly,2
Brunei,Timor-Leste,6,2,AFF Championship qualification,4
Costa Rica,Nigeria,2,0,Friendly,2
Mexico,Iraq,4,0,Friendly,4
Albania,Italy,1,3,Friendly,2
Cyprus,Bulgaria,0,2,Friendly,2
Czech Republic,Faroe Islands,5,0,Friendly,5
Dominican Republic,Cuba,2,4,Friendly,2
Gibraltar,Liechtenstein,2,0,Friendly,2
Iran,Tunisia,0,2,Friendly,2
Ivory Coast,Burundi,4,0,Friendly,4
United Arab Emirates,Argentina,0,5,Friendly,5
Uzbekistan,Kazakhstan,2,0,Friendly,2
Gabon,Guinea-Bissau,3,1,Friendly,2
Israel,Zambia,4,2,Friendly,2
Jordan,Spain,1,3,Friendly,2
Morocco,Georgia,3,0,Friendly,3
Portugal,Nigeria,4,0,Friendly,4
Switzerland,Ghana,0,2,Friendly,2
Bahrain,Serbia,1,5,Friendly,4
Albania,Armenia,2,0,Friendly,2
Colombia,Paraguay,2,0,Friendly,2
Guatemala,Nicaragua,3,1,Friendly,2
Kuwait,Lebanon,2,0,Friendly,2
Sweden,Algeria,2,0,Friendly,2
Estonia,Lithuania,2,0,Baltic Cup,2
Austria,Italy,2,0,Friendly,2
Moldova,Romania,0,5,Friendly,5
Niger,Gabon,1,3,Friendly,2
North Macedonia,Azerbaijan,1,3,Friendly,2
Oman,Belarus,2,0,Friendly,2
Qatar,Ecuador,0,2,FIFA World Cup,2
Senegal,Netherlands,0,2,FIFA World Cup,2
England,Iran,6,2,FIFA World Cup,4
France,Australia,4,1,FIFA World Cup,3
Spain,Costa Rica,7,0,FIFA World Cup,7
Brazil,Serbia,2,0,FIFA World Cup,2
Qatar,Senegal,1,3,FIFA World Cup,2
Wales,Iran,0,2,FIFA World Cup,2
Poland,Saudi Arabia,2,0,FIFA World Cup,2
Argentina,Mexico,2,0,FIFA World Cup,2
Belgium,Morocco,0,2,FIFA World Cup,2
Croatia,Canada,4,1,FIFA World Cup,3
Portugal,Uruguay,2,0,FIFA World Cup,2
Qatar,Netherlands,0,2,FIFA World Cup,2
Wales,England,0,3,FIFA World Cup,3
Poland,Argentina,0,2,FIFA World Cup,2
Costa Rica,Germany,2,4,FIFA World Cup,2
Ghana,Uruguay,0,2,FIFA World Cup,2
Netherlands,United States,3,1,FIFA World Cup,2
France,Poland,3,1,FIFA World Cup,2
England,Senegal,3,0,FIFA World Cup,3
Brazil,South Korea,4,1,FIFA World Cup,3
Portugal,Switzerland,6,1,FIFA World Cup,5
Malaysia,Cambodia,4,0,Friendly,4
Thailand,Myanmar,6,0,Friendly,6
Argentina,Croatia,3,0,FIFA World Cup,3
France,Morocco,2,0,FIFA World Cup,2
Malaysia,Maldives,3,0,Friendly,3
Singapore,Maldives,3,1,Friendly,2
Yemen,Saudi Arabia,0,2,Gulf Cup,2
Kuwait,Qatar,0,2,Gulf Cup,2
Sweden,Finland,2,0,Friendly,2
Iraq,Saudi Arabia,2,0,Gulf Cup,2
Iraq,Yemen,5,0,Gulf Cup,5
Grenada,Saint Lucia,2,0,Friendly,2
Tahiti,New Caledonia,0,2,Friendly,2
Nepal,Laos,2,0,Tri Nation Tournament,2
Argentina,Panama,2,0,Friendly,2
Solomon Islands,Vanuatu,2,0,Friendly,2
Madagascar,Central African Republic,0,3,African Cup of Nations qualification,3
Zambia,Lesotho,3,1,African Cup of Nations qualification,2
Denmark,Finland,3,1,UEFA Euro qualification,2
San Marino,Northern Ireland,0,2,UEFA Euro qualification,2
Portugal,Liechtenstein,4,0,UEFA Euro qualification,4
Bosnia and Herzegovina,Iceland,3,0,UEFA Euro qualification,3
Suriname,Mexico,0,2,CONCACAF Nations League,2
Saint Martin,Saint Kitts and Nevis,1,3,CONCACAF Nations League,2
British Virgin Islands,Puerto Rico,1,3,CONCACAF Nations League,2
Australia,Ecuador,3,1,Friendly,2
Kuwait,Philippines,2,0,Friendly,2
Guinea,Ethiopia,2,0,African Cup of Nations qualification,2
Egypt,Malawi,2,0,African Cup of Nations qualification,2
Mali,Gambia,2,0,African Cup of Nations qualification,2
Ivory Coast,Comoros,3,1,African Cup of Nations qualification,2
DR Congo,Mauritania,3,1,African Cup of Nations qualification,2
Equatorial Guinea,Botswana,2,0,African Cup of Nations qualification,2
Tunisia,Libya,3,0,African Cup of Nations qualification,3
Senegal,Mozambique,5,1,African Cup of Nations qualification,4
Gibraltar,Greece,0,3,UEFA Euro qualification,3
France,Netherlands,4,0,UEFA Euro qualification,4
Czech Republic,Poland,3,1,UEFA Euro qualification,2
Austria,Azerbaijan,4,1,UEFA Euro qualification,3
Sweden,Belgium,0,3,UEFA Euro qualification,3
Serbia,Lithuania,2,0,UEFA Euro qualification,2
Grenada,United States,1,7,CONCACAF Nations League,6
Bahamas,Trinidad and Tobago,0,3,CONCACAF Nations League,3
Nicaragua,Saint Vincent and the Grenadines,4,1,CONCACAF Nations League,3
Georgia,Mongolia,6,1,Friendly,5
Germany,Peru,2,0,Friendly,2
Indonesia,Burundi,3,1,Friendly,2
Thailand,Syria,1,3,Friendly,2
Scotland,Cyprus,3,0,UEFA Euro qualification,3
Spain,Norway,3,0,UEFA Euro qualification,3
Belarus,Switzerland,0,5,UEFA Euro qualification,5
Andorra,Romania,0,2,UEFA Euro qualification,2
Curaçao,Canada,0,2,CONCACAF Nations League,2
Bermuda,Guyana,0,2,CONCACAF Nations League,2
Montserrat,Haiti,0,4,CONCACAF Nations League,4
Sint Maarten,Bonaire,6,1,CONCACAF Nations League,5
Fiji,Solomon Islands,0,2,Friendly,2
Russia,Iraq,2,0,Friendly,2
São Tomé and Príncipe,Sierra Leone,0,2,African Cup of Nations qualification,2
Lesotho,Zambia,0,2,African Cup of Nations qualification,2
England,Ukraine,2,0,UEFA Euro qualification,2
Malta,Italy,0,2,UEFA Euro qualification,2
Slovenia,San Marino,2,0,UEFA Euro qualification,2
Liechtenstein,Iceland,0,7,UEFA Euro qualification,7
Luxembourg,Portugal,0,6,UEFA Euro qualification,6
Slovakia,Bosnia and Herzegovina,2,0,UEFA Euro qualification,2
Puerto Rico,Cayman Islands,5,1,CONCACAF Nations League,4
Oman,Lebanon,2,0,Friendly,2
Central African Republic,Madagascar,2,0,African Cup of Nations qualification,2
Netherlands,Gibraltar,3,0,UEFA Euro qualification,3
Sweden,Azerbaijan,5,0,UEFA Euro qualification,5
Hungary,Bulgaria,3,0,UEFA Euro qualification,3
Montenegro,Serbia,0,2,UEFA Euro qualification,2
Dominican Republic,Belize,2,0,CONCACAF Nations League,2
Guatemala,French Guiana,4,0,CONCACAF Nations League,4
Saint Kitts and Nevis,Aruba,2,0,CONCACAF Nations League,2
Saint Lucia,Dominica,3,1,CONCACAF Nations League,2
Argentina,Curaçao,7,0,Friendly,7
India,Kyrgyzstan,2,0,Tri Nation Tournament,2
Jordan,Philippines,4,0,Friendly,4
Malaysia,Hong Kong,2,0,Friendly,2
United Arab Emirates,Thailand,2,0,Friendly,2
Malawi,Egypt,0,4,African Cup of Nations qualification,4
Comoros,Ivory Coast,0,2,African Cup of Nations qualification,2
Scotland,Spain,2,0,UEFA Euro qualification,2
Turkey,Croatia,0,2,UEFA Euro qualification,2
Switzerland,Israel,3,0,UEFA Euro qualification,3
Canada,Honduras,4,1,CONCACAF Nations League,3
Haiti,Bermuda,3,1,CONCACAF Nations League,2
Mexico,Guatemala,2,0,Friendly,2
Chile,Cuba,3,0,Friendly,3
Uzbekistan,Oman,3,0,CAFA Nations Cup,3
Mauritius,Pakistan,3,0,Mauritius Four Nations Cup,3
Iran,Afghanistan,6,1,CAFA Nations Cup,5
Malaysia,Solomon Islands,4,1,Friendly,3
Togo,Lesotho,2,0,Friendly,2
Uruguay,Nicaragua,4,1,Friendly,3
Netherlands,Croatia,2,4,UEFA Nations League,2
Uzbekistan,Turkmenistan,2,0,CAFA Nations Cup,2
Mauritius,Djibouti,1,3,Mauritius Four Nations Cup,2
Panama,Canada,0,2,CONCACAF Nations League,2
United States,Mexico,3,0,CONCACAF Nations League,3
Argentina,Australia,2,0,Friendly,2
Japan,El Salvador,6,0,Friendly,6
Antigua and Barbuda,Guadeloupe,0,5,Gold Cup qualification,5
Martinique,Saint Lucia,3,1,Gold Cup qualification,2
Chile,Dominican Republic,5,0,Friendly,5
China PR,Myanmar,4,0,Friendly,4
Sweden,New Zealand,4,1,Friendly,3
Gibraltar,France,0,3,UEFA Euro qualification,3
Malta,England,0,4,UEFA Euro qualification,4
Wales,Armenia,2,4,UEFA Euro qualification,2
Finland,Slovenia,2,0,UEFA Euro qualification,2
San Marino,Kazakhstan,0,3,UEFA Euro qualification,3
Kyrgyzstan,Iran,1,5,CAFA Nations Cup,4
French Guiana,Sint Maarten,4,1,Gold Cup qualification,3
Brazil,Guinea,4,1,Friendly,3
Faroe Islands,Czech Republic,0,3,UEFA Euro qualification,3
Albania,Moldova,2,0,UEFA Euro qualification,2
Luxembourg,Liechtenstein,2,0,UEFA Euro qualification,2
Portugal,Bosnia and Herzegovina,3,0,UEFA Euro qualification,3
Ticino,Raetia,1,8,CONIFA World Football Cup qualification,7
Turkmenistan,Oman,0,2,CAFA Nations Cup,2
Uzbekistan,Tajikistan,5,1,CAFA Nations Cup,4
Djibouti,Pakistan,3,1,Mauritius Four Nations Cup,2
United States,Canada,2,0,CONCACAF Nations League,2
Egypt,South Sudan,3,0,Friendly,3
Paraguay,Nicaragua,2,0,Friendly,2
Indonesia,Argentina,0,2,Friendly,2
Macau,Myanmar,0,2,Friendly,2
Republic of Ireland,Gibraltar,3,0,UEFA Euro qualification,3
England,North Macedonia,7,0,UEFA Euro qualification,7
Turkey,Wales,2,0,UEFA Euro qualification,2
Finland,San Marino,6,0,UEFA Euro qualification,6
Guadeloupe,Guyana,2,0,Gold Cup qualification,2
Martinique,Puerto Rico,2,0,Gold Cup qualification,2
Brazil,Senegal,2,4,Friendly,2
China PR,Palestine,2,0,Friendly,2
Ecuador,Costa Rica,3,1,Friendly,2
Germany,Colombia,0,2,Friendly,2
Japan,Peru,4,1,Friendly,3
Malaysia,Papua New Guinea,10,0,Friendly,10
Montenegro,Czech Republic,1,4,Friendly,3
Uruguay,Cuba,2,0,Friendly,2
Scotland,Georgia,2,0,UEFA Euro qualification,2
Norway,Cyprus,3,1,UEFA Euro qualification,2
Faroe Islands,Albania,1,3,UEFA Euro qualification,2
Austria,Sweden,2,0,UEFA Euro qualification,2
Estonia,Belgium,0,3,UEFA Euro qualification,3
Hungary,Lithuania,2,0,UEFA Euro qualification,2
Bosnia and Herzegovina,Luxembourg,0,2,UEFA Euro qualification,2
Kuwait,Nepal,3,1,SAFF Cup,2
India,Pakistan,4,0,SAFF Cup,4
Lebanon,Bangladesh,2,0,SAFF Cup,2
Maldives,Bhutan,2,0,SAFF Cup,2
Pakistan,Kuwait,0,4,SAFF Cup,4
India,Nepal,2,0,SAFF Cup,2
Bangladesh,Maldives,3,1,SAFF Cup,2
Bhutan,Lebanon,1,4,SAFF Cup,3
Trinidad and Tobago,Saint Kitts and Nevis,3,0,Gold Cup,3
Mexico,Honduras,4,0,Gold Cup,4
Bhutan,Bangladesh,1,3,SAFF Cup,2
Jamaica,Trinidad and Tobago,4,1,Gold Cup,3
United States,Saint Kitts and Nevis,6,0,Gold Cup,6
Haiti,Mexico,1,3,Gold Cup,2
Chameria,Two Sicilies,3,1,CONIFA World Football Cup qualification,2
Cuba,Guadeloupe,1,4,Gold Cup,3
Székely Land,Two Sicilies,7,0,CONIFA World Football Cup qualification,7
United States,Trinidad and Tobago,6,0,Gold Cup,6
Jamaica,Saint Kitts and Nevis,5,0,Gold Cup,5
Costa Rica,Martinique,6,4,Gold Cup,2
Canada,Cuba,4,2,Gold Cup,2
Panama,Qatar,4,0,Gold Cup,4
Mexico,Costa Rica,2,0,Gold Cup,2
Åland,Isle of Wight,0,2,Island Games,2
Isle of Man,Falkland Islands,3,0,Island Games,3
Ynys Môn,Shetland,2,0,Island Games,2
Menorca,Saint Helena,5,0,Island Games,5
Guernsey,Åland,4,1,Island Games,3
Falkland Islands,Ynys Môn,1,5,Island Games,4
Greenland,Frøya,2,0,Island Games,2
Gozo,Saint Helena,3,0,Island Games,3
Jersey,Menorca,4,0,Island Games,4
Åland,Western Isles,0,2,Island Games,2
Falkland Islands,Shetland,1,4,Island Games,3
Saint Helena,Jersey,0,5,Island Games,5
Jamaica,Mexico,0,3,Gold Cup,3
Frøya,Saint Helena,4,2,Island Games,2
Shetland,Greenland,5,1,Island Games,4
Ynys Môn,Jersey,2,5,Island Games,3
Ethiopia,Guyana,2,0,Friendly,2
Tamil Eelam,Hmong,3,0,CONIFA Asia Cup,3
Tibet,Tamil Eelam,1,3,CONIFA Asia Cup,2
Tamil Eelam,Hmong,3,1,CONIFA Asia Cup,2
Tahiti,Cook Islands,9,1,Friendly,8
Tahiti,Cook Islands,3,0,Friendly,3
Panama,Martinique,3,0,CONCACAF Nations League,3
Guatemala,El Salvador,2,0,CONCACAF Nations League,2
Sint Maarten,Saint Lucia,1,5,CONCACAF Nations League,4
Anguilla,Saint Martin,0,6,CONCACAF Nations League,6
Bahrain,Kuwait,1,3,Friendly,2
Norway,Jordan,6,0,Friendly,6
Niger,Uganda,0,2,African Cup of Nations qualification,2
Tunisia,Botswana,3,0,African Cup of Nations qualification,3
France,Republic of Ireland,2,0,UEFA Euro qualification,2
Netherlands,Greece,3,0,UEFA Euro qualification,3
Poland,Faroe Islands,2,0,UEFA Euro qualification,2
Denmark,San Marino,4,0,UEFA Euro qualification,4
Slovenia,Northern Ireland,4,2,UEFA Euro qualification,2
Dominican Republic,Nicaragua,0,2,CONCACAF Nations League,2
Uruguay,Chile,3,1,FIFA World Cup qualification,2
Brazil,Bolivia,5,1,FIFA World Cup qualification,4
Costa Rica,Saudi Arabia,3,1,Friendly,2
Indonesia,Turkmenistan,2,0,Friendly,2
Singapore,Tajikistan,0,2,Friendly,2
Mali,South Sudan,4,0,African Cup of Nations qualification,4
Georgia,Spain,1,7,UEFA Euro qualification,6
Cyprus,Scotland,0,3,UEFA Euro qualification,3
Croatia,Latvia,5,0,UEFA Euro qualification,5
Luxembourg,Iceland,3,1,UEFA Euro qualification,2
Antigua and Barbuda,Guyana,1,5,CONCACAF Nations League,4
Bahamas,Puerto Rico,1,6,CONCACAF Nations League,5
British Virgin Islands,Turks and Caicos Islands,3,1,CONCACAF Nations League,2
Germany,Japan,1,4,Friendly,3
United States,Uzbekistan,3,0,Friendly,3
DR Congo,Sudan,2,0,African Cup of Nations qualification,2
Estonia,Sweden,0,5,UEFA Euro qualification,5
Guadeloupe,Sint Maarten,4,0,CONCACAF Nations League,4
Saint Lucia,Saint Kitts and Nevis,2,0,CONCACAF Nations League,2
Nigeria,São Tomé and Príncipe,6,0,African Cup of Nations qualification,6
Greece,Gibraltar,5,0,UEFA Euro qualification,5
Albania,Poland,2,0,UEFA Euro qualification,2
Lithuania,Serbia,1,3,UEFA Euro qualification,2
San Marino,Slovenia,0,4,UEFA Euro qualification,4
Dominican Republic,Montserrat,3,0,CONCACAF Nations League,3
Nicaragua,Barbados,5,1,CONCACAF Nations League,4
Cambodia,Macau,4,0,Friendly,4
Hong Kong,Brunei,10,0,Friendly,10
Kuwait,Kyrgyzstan,1,3,Friendly,2
Vietnam,Palestine,2,0,Friendly,2
Latvia,Wales,0,2,UEFA Euro qualification,2
Portugal,Luxembourg,9,0,UEFA Euro qualification,9
Slovakia,Liechtenstein,3,0,UEFA Euro qualification,3
Honduras,Grenada,4,0,CONCACAF Nations League,4
French Guiana,Belize,0,2,CONCACAF Nations League,2
Puerto Rico,Antigua and Barbuda,5,0,CONCACAF Nations League,5
Turks and Caicos Islands,Dominica,0,3,CONCACAF Nations League,3
Bolivia,Argentina,0,3,FIFA World Cup qualification,3
Egypt,Tunisia,1,3,Friendly,2
Ghana,Liberia,3,1,Friendly,2
Iran,Angola,4,0,Friendly,4
Scotland,England,1,3,Friendly,2
Singapore,Taiwan,3,1,Friendly,2
United Arab Emirates,Costa Rica,4,1,Friendly,3
United States,Oman,4,0,Friendly,4
Cameroon,Burundi,3,0,African Cup of Nations qualification,3
Spain,Cyprus,6,0,UEFA Euro qualification,6
Malta,North Macedonia,0,2,UEFA Euro qualification,2
Belgium,Estonia,5,0,UEFA Euro qualification,5
Sweden,Austria,1,3,UEFA Euro qualification,2
Switzerland,Andorra,3,0,UEFA Euro qualification,3
Romania,Kosovo,2,0,UEFA Euro qualification,2
China PR,Vietnam,2,0,Friendly,2
Wales,Gibraltar,4,0,Friendly,4
Grenada,Jamaica,1,4,CONCACAF Nations League,3
Bonaire,Anguilla,2,0,CONCACAF Nations League,2
Chile,Peru,2,0,FIFA World Cup qualification,2
Taiwan,Timor-Leste,4,0,FIFA World Cup qualification,4
Hong Kong,Bhutan,4,0,FIFA World Cup qualification,4
Indonesia,Brunei,6,0,FIFA World Cup qualification,6
Myanmar,Macau,5,1,FIFA World Cup qualification,4
Yemen,Sri Lanka,3,0,FIFA World Cup qualification,3
Algeria,Cape Verde,5,1,Friendly,4
Bahrain,Kyrgyzstan,2,0,Friendly,2
Georgia,Thailand,8,0,Friendly,8
Sweden,Moldova,3,1,Friendly,2
Spain,Scotland,2,0,UEFA Euro qualification,2
Cyprus,Norway,0,4,UEFA Euro qualification,4
Latvia,Armenia,2,0,UEFA Euro qualification,2
Faroe Islands,Poland,0,2,UEFA Euro qualification,2
Albania,Czech Republic,3,0,UEFA Euro qualification,3
Andorra,Kosovo,0,3,UEFA Euro qualification,3
Montserrat,Nicaragua,0,3,CONCACAF Nations League,3
Barbados,Dominican Republic,0,5,CONCACAF Nations League,5
Saint Vincent and the Grenadines,French Guiana,1,4,CONCACAF Nations League,3
Japan,Canada,4,1,Friendly,3
South Korea,Tunisia,4,0,Friendly,4
Vietnam,Uzbekistan,0,2,Friendly,2
Republic of Ireland,Greece,0,2,UEFA Euro qualification,2
Estonia,Azerbaijan,0,2,UEFA Euro qualification,2
Liechtenstein,Bosnia and Herzegovina,0,2,UEFA Euro qualification,2
Puerto Rico,Guyana,1,3,CONCACAF Nations League,2
Bahamas,Antigua and Barbuda,1,4,CONCACAF Nations League,3
Aruba,United States Virgin Islands,3,1,CONCACAF Nations League,2
Mexico,Ghana,2,0,Friendly,2
Niger,Somalia,3,0,Friendly,3
United States,Germany,1,3,Friendly,2
Ukraine,North Macedonia,2,0,UEFA Euro qualification,2
Italy,Malta,4,0,UEFA Euro qualification,4
Bulgaria,Lithuania,0,2,UEFA Euro qualification,2
Northern Ireland,San Marino,3,0,UEFA Euro qualification,3
Slovenia,Finland,3,0,UEFA Euro qualification,3
Denmark,Kazakhstan,3,1,UEFA Euro qualification,2
Honduras,Cuba,4,0,CONCACAF Nations League,4
Suriname,Grenada,4,0,CONCACAF Nations League,4
Guadeloupe,Saint Lucia,2,0,CONCACAF Nations League,2
Georgia,Cyprus,4,0,UEFA Euro qualification,4
Turkey,Latvia,4,0,UEFA Euro qualification,4
Romania,Andorra,4,0,UEFA Euro qualification,4
Dominican Republic,Barbados,5,2,CONCACAF Nations League,3
Nicaragua,Montserrat,3,0,CONCACAF Nations League,3
Saint Martin,Anguilla,8,0,CONCACAF Nations League,8
Gibraltar,Republic of Ireland,0,4,UEFA Euro qualification,4
Iceland,Liechtenstein,4,0,UEFA Euro qualification,4
Bosnia and Herzegovina,Portugal,0,5,UEFA Euro qualification,5
Panama,Guatemala,3,0,CONCACAF Nations League,3
Curaçao,Trinidad and Tobago,5,3,CONCACAF Nations League,2
Guyana,Puerto Rico,3,1,CONCACAF Nations League,2
Venezuela,Chile,3,0,FIFA World Cup qualification,3
Peru,Argentina,0,2,FIFA World Cup qualification,2
Uruguay,Brazil,2,0,FIFA World Cup qualification,2
Bhutan,Hong Kong,2,0,FIFA World Cup qualification,2
Brunei,Indonesia,0,6,FIFA World Cup qualification,6
Taiwan,Timor-Leste,3,0,FIFA World Cup qualification,3
Albania,Bulgaria,2,0,Friendly,2
Australia,New Zealand,2,0,Friendly,2
France,Scotland,4,1,Friendly,3
South Korea,Vietnam,6,0,Friendly,6
Mali,Saudi Arabia,3,1,Friendly,2
North Macedonia,Armenia,3,1,Friendly,2
Somalia,Sierra Leone,0,2,Friendly,2
United States,Ghana,4,0,Friendly,4
Zambia,Uganda,3,0,Friendly,3
Morocco,Liberia,3,0,African Cup of Nations qualification,3
England,Italy,3,1,UEFA Euro qualification,2
Malta,Ukraine,1,3,UEFA Euro qualification,2
Serbia,Montenegro,3,1,UEFA Euro qualification,2
DR Congo,Mauritania,2,0,FIFA World Cup qualification,2
Sint Maarten,Guadeloupe,0,2,CONCACAF Nations League,2
United States Virgin Islands,Aruba,1,4,CONCACAF Nations League,3
Costa Rica,Panama,0,3,CONCACAF Nations League,3
United States,Trinidad and Tobago,3,0,CONCACAF Nations League,3
Bolivia,Peru,2,0,FIFA World Cup qualification,2
Argentina,Uruguay,0,2,FIFA World Cup qualification,2
Qatar,Afghanistan,8,1,FIFA World Cup qualification,7
Japan,Myanmar,5,0,FIFA World Cup qualification,5
South Korea,Singapore,5,0,FIFA World Cup qualification,5
Oman,Taiwan,3,0,FIFA World Cup qualification,3
Iran,Hong Kong,4,0,FIFA World Cup qualification,4
Turkmenistan,Uzbekistan,1,3,FIFA World Cup qualification,2
Iraq,Indonesia,5,1,FIFA World Cup qualification,4
Philippines,Vietnam,0,2,FIFA World Cup qualification,2
Saudi Arabia,Pakistan,4,0,FIFA World Cup qualification,4
United Arab Emirates,Nepal,4,0,FIFA World Cup qualification,4
Yemen,Bahrain,0,2,FIFA World Cup qualification,2
Australia,Bangladesh,7,0,FIFA World Cup qualification,7
Egypt,Djibouti,6,0,FIFA World Cup qualification,6
Algeria,Somalia,3,1,FIFA World Cup qualification,2
Norway,Faroe Islands,2,0,Friendly,2
Cyprus,Spain,1,3,UEFA Euro qualification,2
Estonia,Austria,0,2,UEFA Euro qualification,2
Azerbaijan,Sweden,3,0,UEFA Euro qualification,3
Montenegro,Lithuania,2,0,UEFA Euro qualification,2
Liechtenstein,Portugal,0,2,UEFA Euro qualification,2
Luxembourg,Bosnia and Herzegovina,4,1,UEFA Euro qualification,3
Slovakia,Iceland,4,2,UEFA Euro qualification,2
Barbados,Nicaragua,0,4,CONCACAF Nations League,4
Bermuda,Saint Vincent and the Grenadines,3,1,CONCACAF Nations League,2
Honduras,Mexico,2,0,CONCACAF Nations League,2
Cameroon,Mauritius,3,0,FIFA World Cup qualification,3
Zambia,Congo,4,2,FIFA World Cup qualification,2
Ivory Coast,Seychelles,9,0,FIFA World Cup qualification,9
Tunisia,São Tomé and Príncipe,4,0,FIFA World Cup qualification,4
Comoros,Central African Republic,4,2,FIFA World Cup qualification,2
Mali,Chad,3,1,FIFA World Cup qualification,2
Greece,New Zealand,2,0,Friendly,2
England,Malta,2,0,UEFA Euro qualification,2
Italy,North Macedonia,5,2,UEFA Euro qualification,3
Finland,Northern Ireland,4,0,UEFA Euro qualification,4
Kazakhstan,San Marino,3,1,UEFA Euro qualification,2
Anguilla,Bonaire,0,3,CONCACAF Nations League,3
Senegal,South Sudan,4,0,FIFA World Cup qualification,4
France,Gibraltar,14,0,UEFA Euro qualification,14
Latvia,Croatia,0,2,UEFA Euro qualification,2
Guadeloupe,Saint Kitts and Nevis,5,0,CONCACAF Nations League,5
Sierra Leone,Egypt,0,2,FIFA World Cup qualification,2
Mozambique,Algeria,0,2,FIFA World Cup qualification,2
Spain,Georgia,3,1,UEFA Euro qualification,2
Belgium,Azerbaijan,5,0,UEFA Euro qualification,5
Sweden,Estonia,2,0,UEFA Euro qualification,2
Hungary,Montenegro,3,1,UEFA Euro qualification,2
Portugal,Iceland,2,0,UEFA Euro qualification,2
Montserrat,Barbados,4,2,CONCACAF Nations League,2
Aruba,Cayman Islands,5,1,CONCACAF Nations League,4
Dominica,Turks and Caicos Islands,2,0,CONCACAF Nations League,2
Panama,Costa Rica,3,1,CONCACAF Nations League,2
Gambia,Ivory Coast,0,2,FIFA World Cup qualification,2
Seychelles,Kenya,0,5,FIFA World Cup qualification,5
Chad,Madagascar,0,3,FIFA World Cup qualification,3
Czech Republic,Moldova,3,0,UEFA Euro qualification,3
Northern Ireland,Denmark,2,0,UEFA Euro qualification,2
French Guiana,Bermuda,3,0,CONCACAF Nations League,3
Saint Vincent and the Grenadines,Belize,3,0,CONCACAF Nations League,3
Guyana,Antigua and Barbuda,6,0,CONCACAF Nations League,6
Puerto Rico,Bahamas,6,1,CONCACAF Nations League,5
Bonaire,Saint Martin,0,4,CONCACAF Nations League,4
Mexico,Honduras,2,0,CONCACAF Nations League,2
Uruguay,Bolivia,3,0,FIFA World Cup qualification,3
India,Qatar,0,3,FIFA World Cup qualification,3
Afghanistan,Kuwait,0,4,FIFA World Cup qualification,4
Myanmar,North Korea,1,6,FIFA World Cup qualification,5
Syria,Japan,0,5,FIFA World Cup qualification,5
China PR,South Korea,0,3,FIFA World Cup qualification,3
Singapore,Thailand,1,3,FIFA World Cup qualification,2
Pakistan,Tajikistan,1,6,FIFA World Cup qualification,5
Jordan,Saudi Arabia,0,2,FIFA World Cup qualification,2
Bahrain,United Arab Emirates,0,2,FIFA World Cup qualification,2
Nepal,Yemen,0,2,FIFA World Cup qualification,2
Ethiopia,Burkina Faso,0,3,FIFA World Cup qualification,3
Rwanda,South Africa,2,0,FIFA World Cup qualification,2
Eswatini,Cape Verde,0,2,FIFA World Cup qualification,2
Tanzania,Morocco,0,2,FIFA World Cup qualification,2
São Tomé and Príncipe,Namibia,0,2,FIFA World Cup qualification,2
Austria,Germany,2,0,Friendly,2
Poland,Latvia,2,0,Friendly,2
Gibraltar,Netherlands,0,6,UEFA Euro qualification,6
Andorra,Israel,0,2,UEFA Euro qualification,2
